Instance Name, Truck Speed, Drone Speed, Number of Nodes, TSP Sol Cost, Arcs in Gaux, Triples, Locality, Num Vert Loc > 1, Vertices labels / order / locality
doublecenter-1-n250.txt, 1, 0.5, 250, 3015.42, 529, 279, 2, 12,48 / 72 / 2, 71 / 76 / 2, 197 / 77 / 2, 201 / 98 / 2, 30 / 100 / 2, 36 / 117 / 2, 10 / 155 / 2, 235 / 162 / 2, 179 / 192 / 2, 181 / 197 / 2, 206 / 211 / 2, 202 / 214 / 2
doublecenter-1-n375.txt, 1, 0.5, 375, 3800.14, 816, 441, 3, 22,127 / 26 / 2, 357 / 30 / 2, 71 / 34 / 2, 72 / 39 / 3, 34 / 54 / 2, 204 / 80 / 2, 47 / 83 / 2, 85 / 125 / 2, 319 / 133 / 2, 326 / 168 / 2, 20 / 171 / 2, 372 / 179 / 2, 244 / 181 / 2, 210 / 184 / 2, 230 / 226 / 2, 108 / 231 / 2, 180 / 298 / 2, 83 / 303 / 2, 142 / 338 / 2, 345 / 342 / 2, 313 / 370 / 2, 68 / 372 / 2
doublecenter-1-n5.txt, 1, 0.5, 5, 519.298, 10, 5, 2, 1,1 / 4 / 2
doublecenter-10-n250.txt, 1, 0.5, 250, 2992.35, 572, 322, 4, 21,245 / 10 / 2, 153 / 14 / 2, 173 / 29 / 2, 21 / 62 / 2, 155 / 66 / 2, 88 / 85 / 2, 193 / 87 / 2, 244 / 92 / 2, 180 / 105 / 2, 183 / 129 / 2, 168 / 147 / 2, 19 / 151 / 4, 198 / 171 / 2, 66 / 185 / 2, 205 / 192 / 2, 34 / 199 / 2, 1 / 209 / 2, 225 / 224 / 2, 231 / 225 / 2, 166 / 235 / 2, 224 / 246 / 2
doublecenter-10-n5.txt, 1, 0.5, 5, 616.2, 12, 7, 5, 1,2 / 1 / 5
doublecenter-10-n500.txt, 1, 0.5, 500, 4802.12, 1079, 579, 4, 20,478 / 2 / 2, 482 / 59 / 3, 124 / 73 / 2, 50 / 111 / 2, 198 / 132 / 2, 375 / 165 / 2, 41 / 167 / 2, 495 / 218 / 4, 343 / 224 / 2, 60 / 230 / 2, 2 / 242 / 3, 475 / 277 / 2, 187 / 283 / 2, 103 / 302 / 2, 172 / 345 / 3, 43 / 379 / 2, 493 / 396 / 3, 108 / 411 / 2, 64 / 426 / 2, 78 / 486 / 2
doublecenter-100-n100.txt, 1, 0.5, 100, 2092.68, 212, 112, 3, 6,9 / 29 / 2, 95 / 37 / 2, 31 / 69 / 2, 67 / 76 / 2, 99 / 89 / 2, 22 / 99 / 3
doublecenter-101-n175.txt, 1, 0.5, 175, 2479.95, 390, 215, 4, 11,28 / 2 / 2, 44 / 52 / 2, 174 / 77 / 2, 71 / 84 / 2, 86 / 113 / 2, 128 / 122 / 2, 24 / 141 / 4, 88 / 145 / 3, 153 / 152 / 2, 99 / 158 / 2, 65 / 164 / 2
doublecenter-102-n175.txt, 1, 0.5, 175, 2531.66, 379, 204, 2, 11,107 / 33 / 2, 120 / 42 / 2, 166 / 66 / 2, 48 / 72 / 2, 110 / 90 / 2, 6 / 123 / 2, 44 / 129 / 2, 2 / 130 / 2, 67 / 141 / 2, 142 / 150 / 2, 75 / 154 / 2
doublecenter-103-n175.txt, 1, 0.5, 175, 2764.18, 377, 202, 2, 10,65 / 28 / 2, 162 / 39 / 2, 81 / 45 / 2, 26 / 70 / 2, 117 / 74 / 2, 42 / 82 / 2, 174 / 112 / 2, 24 / 127 / 2, 18 / 150 / 2, 56 / 173 / 2
doublecenter-104-n175.txt, 1, 0.5, 175, 2613.17, 413, 238, 4, 16,67 / 7 / 2, 156 / 17 / 2, 5 / 18 / 2, 43 / 33 / 2, 69 / 42 / 3, 27 / 45 / 2, 4 / 60 / 2, 21 / 69 / 2, 89 / 77 / 3, 78 / 81 / 2, 119 / 85 / 2, 171 / 103 / 2, 97 / 119 / 2, 90 / 138 / 2, 114 / 143 / 2, 169 / 151 / 4
doublecenter-105-n175.txt, 1, 0.5, 175, 2878.05, 419, 244, 3, 14,165 / 12 / 2, 87 / 20 / 2, 76 / 23 / 3, 26 / 54 / 2, 160 / 58 / 2, 149 / 63 / 2, 132 / 76 / 2, 29 / 78 / 2, 34 / 86 / 2, 11 / 94 / 2, 105 / 106 / 2, 30 / 113 / 3, 107 / 157 / 3, 35 / 168 / 2
doublecenter-106-n175.txt, 1, 0.5, 175, 2666.24, 378, 203, 2, 12,75 / 2 / 2, 58 / 5 / 2, 105 / 21 / 2, 170 / 39 / 2, 48 / 42 / 2, 115 / 46 / 2, 55 / 66 / 2, 134 / 73 / 2, 3 / 88 / 2, 157 / 104 / 2, 103 / 141 / 2, 119 / 149 / 2
doublecenter-107-n175.txt, 1, 0.5, 175, 2487.19, 393, 218, 4, 11,98 / 11 / 2, 120 / 21 / 2, 135 / 23 / 2, 143 / 31 / 2, 103 / 41 / 2, 99 / 56 / 4, 160 / 105 / 2, 73 / 110 / 2, 138 / 113 / 2, 157 / 123 / 2, 104 / 170 / 2
doublecenter-108-n175.txt, 1, 0.5, 175, 2479.09, 377, 202, 2, 9,10 / 5 / 2, 105 / 15 / 2, 153 / 51 / 2, 73 / 61 / 2, 47 / 83 / 2, 111 / 108 / 2, 113 / 123 / 2, 170 / 132 / 2, 101 / 163 / 2
doublecenter-109-n175.txt, 1, 0.5, 175, 2492.64, 365, 190, 4, 1,121 / 112 / 4
doublecenter-11-n375.txt, 1, 0.5, 375, 3550.45, 808, 433, 3, 23,259 / 5 / 2, 68 / 12 / 2, 196 / 26 / 2, 311 / 40 / 2, 291 / 67 / 2, 266 / 80 / 2, 313 / 83 / 2, 349 / 120 / 2, 187 / 125 / 2, 125 / 128 / 2, 250 / 167 / 2, 331 / 180 / 2, 29 / 206 / 2, 346 / 212 / 2, 323 / 221 / 2, 6 / 245 / 2, 200 / 250 / 2, 267 / 270 / 2, 255 / 285 / 3, 368 / 296 / 2, 51 / 310 / 2, 223 / 349 / 2, 114 / 374 / 3
doublecenter-11-n500.txt, 1, 0.5, 500, 4292.41, 1098, 598, 4, 29,366 / 29 / 2, 302 / 43 / 2, 160 / 52 / 2, 33 / 81 / 2, 184 / 92 / 2, 39 / 127 / 2, 189 / 133 / 2, 422 / 136 / 2, 406 / 141 / 2, 294 / 176 / 2, 235 / 180 / 2, 305 / 188 / 2, 187 / 220 / 2, 354 / 244 / 2, 74 / 299 / 2, 275 / 314 / 2, 123 / 334 / 2, 112 / 335 / 2, 437 / 343 / 2, 470 / 356 / 2, 169 / 364 / 2, 499 / 376 / 2, 109 / 380 / 2, 485 / 382 / 2, 333 / 399 / 2, 156 / 419 / 4, 313 / 429 / 2, 176 / 442 / 2, 114 / 470 / 2
doublecenter-11-n6.txt, 1, 0.5, 6, 523.236, 11, 5, 1, 0,
doublecenter-110-n175.txt, 1, 0.5, 175, 2705.95, 381, 206, 2, 15,167 / 2 / 2, 42 / 5 / 2, 101 / 12 / 2, 119 / 21 / 2, 153 / 54 / 2, 48 / 60 / 2, 31 / 71 / 2, 4 / 90 / 2, 75 / 109 / 2, 97 / 124 / 2, 95 / 125 / 2, 157 / 140 / 2, 34 / 150 / 2, 47 / 155 / 2, 29 / 159 / 2
doublecenter-111-n250.txt, 1, 0.5, 250, 3015.69, 509, 259, 2, 5,229 / 34 / 2, 157 / 56 / 2, 73 / 91 / 2, 182 / 218 / 2, 58 / 249 / 2
doublecenter-112-n250.txt, 1, 0.5, 250, 2879.68, 548, 298, 4, 9,152 / 43 / 3, 234 / 80 / 2, 51 / 103 / 2, 23 / 122 / 3, 44 / 132 / 2, 25 / 138 / 2, 213 / 210 / 2, 1 / 222 / 4, 84 / 244 / 2
doublecenter-113-n250.txt, 1, 0.5, 250, 2915, 524, 274, 3, 6,172 / 3 / 3, 226 / 25 / 2, 189 / 66 / 2, 247 / 82 / 2, 70 / 146 / 2, 60 / 186 / 3
doublecenter-114-n250.txt, 1, 0.5, 250, 2797.74, 520, 270, 2, 9,96 / 47 / 2, 93 / 57 / 2, 83 / 58 / 2, 249 / 59 / 2, 48 / 79 / 2, 59 / 147 / 2, 211 / 176 / 2, 181 / 189 / 2, 154 / 227 / 2
doublecenter-115-n250.txt, 1, 0.5, 250, 3147.01, 558, 308, 4, 12,114 / 18 / 2, 145 / 54 / 2, 38 / 63 / 4, 30 / 66 / 2, 172 / 131 / 3, 191 / 174 / 2, 120 / 183 / 2, 112 / 185 / 2, 70 / 193 / 2, 54 / 197 / 2, 98 / 208 / 2, 22 / 246 / 2
doublecenter-116-n250.txt, 1, 0.5, 250, 3000.53, 538, 288, 3, 12,97 / 12 / 2, 54 / 15 / 2, 188 / 39 / 3, 96 / 55 / 2, 209 / 76 / 2, 155 / 84 / 3, 125 / 96 / 2, 102 / 120 / 2, 160 / 137 / 2, 184 / 174 / 2, 131 / 195 / 2, 168 / 200 / 2
doublecenter-117-n250.txt, 1, 0.5, 250, 3076.27, 540, 290, 2, 15,131 / 4 / 2, 126 / 26 / 2, 107 / 62 / 2, 139 / 71 / 2, 17 / 83 / 2, 98 / 113 / 2, 195 / 152 / 2, 89 / 167 / 2, 130 / 170 / 2, 159 / 176 / 2, 208 / 193 / 2, 224 / 202 / 2, 152 / 223 / 2, 134 / 229 / 2, 174 / 241 / 2
doublecenter-118-n250.txt, 1, 0.5, 250, 2982.63, 542, 292, 3, 16,113 / 10 / 2, 199 / 15 / 2, 59 / 19 / 2, 3 / 22 / 2, 10 / 47 / 2, 96 / 66 / 2, 228 / 79 / 2, 91 / 105 / 2, 226 / 133 / 3, 243 / 150 / 2, 138 / 186 / 2, 220 / 195 / 2, 207 / 207 / 2, 150 / 225 / 2, 241 / 229 / 2, 13 / 244 / 2
doublecenter-119-n250.txt, 1, 0.5, 250, 3224.63, 533, 283, 2, 13,113 / 22 / 2, 2 / 33 / 2, 82 / 51 / 2, 249 / 73 / 2, 78 / 88 / 2, 214 / 113 / 2, 211 / 132 / 2, 131 / 138 / 2, 203 / 148 / 2, 15 / 155 / 2, 185 / 165 / 2, 8 / 204 / 2, 140 / 220 / 2
doublecenter-12-n375.txt, 1, 0.5, 375, 3831.55, 832, 457, 4, 26,283 / 4 / 2, 214 / 8 / 2, 368 / 19 / 2, 139 / 26 / 2, 138 / 52 / 2, 155 / 59 / 3, 1 / 64 / 2, 208 / 88 / 2, 188 / 111 / 2, 17 / 123 / 2, 97 / 127 / 3, 219 / 171 / 2, 318 / 175 / 4, 2 / 200 / 2, 132 / 218 / 2, 164 / 244 / 2, 163 / 256 / 2, 232 / 262 / 2, 124 / 273 / 2, 15 / 289 / 2, 99 / 320 / 2, 194 / 327 / 2, 288 / 329 / 2, 274 / 341 / 2, 62 / 349 / 2, 85 / 352 / 2
doublecenter-12-n500.txt, 1, 0.5, 500, 4697.72, 1059, 559, 3, 22,419 / 31 / 2, 177 / 72 / 2, 294 / 105 / 2, 278 / 145 / 2, 483 / 147 / 2, 426 / 174 / 2, 271 / 183 / 2, 316 / 210 / 3, 61 / 251 / 2, 484 / 288 / 2, 337 / 321 / 2, 286 / 336 / 2, 178 / 348 / 2, 132 / 357 / 2, 296 / 385 / 2, 478 / 400 / 2, 399 / 422 / 2, 25 / 435 / 2, 329 / 441 / 2, 250 / 469 / 2, 268 / 475 / 2, 191 / 490 / 2
doublecenter-12-n6.txt, 1, 0.5, 6, 538.185, 13, 7, 2, 1,4 / 3 / 2
doublecenter-120-n250.txt, 1, 0.5, 250, 3108.83, 551, 301, 3, 14,217 / 25 / 3, 162 / 60 / 2, 166 / 63 / 2, 122 / 67 / 2, 50 / 79 / 2, 106 / 121 / 3, 2 / 124 / 2, 148 / 129 / 2, 90 / 137 / 2, 248 / 151 / 2, 115 / 183 / 2, 96 / 188 / 2, 231 / 236 / 2, 109 / 249 / 2
doublecenter-13-n375.txt, 1, 0.5, 375, 3829.66, 810, 435, 3, 23,278 / 1 / 2, 52 / 3 / 2, 27 / 21 / 2, 170 / 26 / 2, 125 / 52 / 3, 62 / 96 / 2, 359 / 103 / 2, 162 / 114 / 2, 15 / 116 / 2, 191 / 123 / 2, 102 / 131 / 2, 327 / 169 / 2, 81 / 171 / 2, 365 / 175 / 2, 14 / 199 / 2, 186 / 216 / 2, 251 / 245 / 2, 82 / 259 / 2, 321 / 290 / 2, 72 / 299 / 2, 109 / 304 / 2, 205 / 320 / 2, 213 / 363 / 2
doublecenter-13-n500.txt, 1, 0.5, 500, 4288.96, 1066, 566, 3, 22,320 / 36 / 2, 218 / 38 / 2, 324 / 62 / 2, 101 / 112 / 2, 219 / 116 / 2, 490 / 127 / 2, 275 / 133 / 2, 342 / 138 / 2, 306 / 164 / 2, 472 / 170 / 2, 190 / 187 / 2, 255 / 192 / 2, 381 / 196 / 2, 311 / 262 / 2, 394 / 295 / 3, 352 / 337 / 2, 378 / 383 / 2, 384 / 416 / 2, 44 / 431 / 2, 462 / 476 / 2, 361 / 478 / 2, 376 / 485 / 2
doublecenter-13-n6.txt, 1, 0.5, 6, 697.375, 15, 9, 2, 1,3 / 2 / 2
doublecenter-14-n375.txt, 1, 0.5, 375, 4098.9, 827, 452, 4, 22,243 / 4 / 2, 16 / 10 / 2, 170 / 12 / 4, 128 / 33 / 3, 361 / 39 / 2, 197 / 88 / 2, 233 / 90 / 2, 250 / 96 / 2, 221 / 100 / 2, 30 / 164 / 2, 364 / 183 / 2, 127 / 186 / 2, 164 / 190 / 2, 187 / 207 / 2, 339 / 228 / 2, 146 / 237 / 2, 173 / 244 / 2, 41 / 267 / 2, 237 / 296 / 2, 144 / 299 / 2, 216 / 307 / 2, 329 / 362 / 2
doublecenter-14-n500.txt, 1, 0.5, 500, 4548.76, 1046, 546, 3, 17,320 / 31 / 2, 58 / 61 / 2, 331 / 76 / 2, 239 / 212 / 2, 8 / 269 / 2, 353 / 301 / 2, 333 / 317 / 3, 435 / 352 / 2, 175 / 370 / 2, 425 / 378 / 2, 274 / 380 / 2, 94 / 382 / 2, 327 / 404 / 2, 84 / 421 / 2, 249 / 430 / 2, 329 / 468 / 2, 311 / 476 / 2
doublecenter-14-n6.txt, 1, 0.5, 6, 702.591, 13, 7, 2, 1,2 / 2 / 2
doublecenter-15-n375.txt, 1, 0.5, 375, 3798.39, 850, 475, 5, 25,1 / 2 / 2, 49 / 5 / 2, 263 / 12 / 2, 81 / 26 / 2, 8 / 61 / 2, 155 / 79 / 2, 192 / 93 / 2, 368 / 135 / 2, 91 / 138 / 2, 219 / 146 / 2, 359 / 194 / 2, 125 / 197 / 2, 61 / 207 / 2, 334 / 212 / 2, 254 / 221 / 5, 304 / 259 / 2, 45 / 264 / 2, 335 / 275 / 2, 352 / 299 / 2, 115 / 311 / 3, 121 / 326 / 2, 201 / 330 / 2, 27 / 343 / 2, 253 / 347 / 2, 100 / 359 / 3
doublecenter-15-n6.txt, 1, 0.5, 6, 576.063, 11, 5, 1, 0,
doublecenter-16-n375.txt, 1, 0.5, 375, 3339.35, 787, 412, 2, 14,154 / 17 / 2, 253 / 23 / 2, 324 / 42 / 2, 8 / 52 / 2, 118 / 53 / 2, 54 / 68 / 2, 124 / 81 / 2, 180 / 92 / 2, 32 / 224 / 2, 94 / 266 / 2, 249 / 282 / 2, 263 / 287 / 2, 58 / 337 / 2, 81 / 357 / 2
doublecenter-16-n6.txt, 1, 0.5, 6, 592.712, 11, 5, 1, 0,
doublecenter-17-n375.txt, 1, 0.5, 375, 4043.03, 822, 447, 3, 23,234 / 80 / 2, 298 / 86 / 2, 187 / 92 / 2, 256 / 128 / 2, 271 / 145 / 2, 371 / 156 / 2, 31 / 169 / 3, 253 / 176 / 2, 138 / 179 / 2, 25 / 187 / 2, 168 / 201 / 2, 74 / 213 / 2, 346 / 219 / 2, 266 / 227 / 2, 57 / 233 / 2, 173 / 240 / 2, 129 / 243 / 2, 155 / 279 / 2, 67 / 285 / 2, 289 / 315 / 2, 56 / 322 / 2, 28 / 329 / 2, 32 / 368 / 3
doublecenter-17-n6.txt, 1, 0.5, 6, 621.071, 11, 5, 1, 0,
doublecenter-18-n375.txt, 1, 0.5, 375, 3599.97, 814, 439, 3, 20,299 / 26 / 2, 38 / 45 / 2, 373 / 58 / 2, 358 / 69 / 3, 333 / 75 / 2, 55 / 80 / 2, 323 / 87 / 2, 362 / 122 / 3, 150 / 136 / 2, 89 / 139 / 2, 75 / 143 / 2, 79 / 146 / 2, 17 / 166 / 2, 61 / 183 / 2, 73 / 186 / 2, 329 / 205 / 2, 165 / 217 / 2, 307 / 230 / 2, 177 / 273 / 2, 96 / 283 / 2
doublecenter-18-n6.txt, 1, 0.5, 6, 620.836, 11, 5, 1, 0,
doublecenter-19-n375.txt, 1, 0.5, 375, 4033.78, 804, 429, 3, 22,256 / 3 / 2, 86 / 9 / 2, 290 / 24 / 2, 361 / 87 / 2, 36 / 93 / 2, 67 / 101 / 2, 231 / 110 / 3, 267 / 158 / 2, 94 / 179 / 2, 211 / 185 / 2, 331 / 190 / 2, 365 / 202 / 2, 53 / 216 / 2, 264 / 249 / 2, 196 / 256 / 2, 26 / 271 / 2, 154 / 309 / 2, 291 / 325 / 2, 34 / 332 / 2, 355 / 359 / 2, 345 / 361 / 2, 350 / 373 / 2
doublecenter-19-n6.txt, 1, 0.5, 6, 516.415, 18, 12, 6, 1,4 / 2 / 6
doublecenter-2-n250.txt, 1, 0.5, 250, 2885.56, 548, 298, 2, 21,139 / 3 / 2, 176 / 13 / 2, 16 / 32 / 2, 67 / 45 / 2, 69 / 85 / 2, 64 / 89 / 2, 26 / 95 / 2, 127 / 131 / 2, 39 / 139 / 2, 116 / 146 / 2, 15 / 153 / 2, 177 / 156 / 2, 33 / 157 / 2, 145 / 173 / 2, 188 / 180 / 2, 196 / 183 / 2, 183 / 208 / 2, 119 / 224 / 2, 151 / 230 / 2, 203 / 238 / 2, 46 / 246 / 2
doublecenter-2-n375.txt, 1, 0.5, 375, 3710.65, 800, 425, 2, 21,120 / 6 / 2, 69 / 8 / 2, 179 / 31 / 2, 94 / 32 / 2, 127 / 148 / 2, 95 / 154 / 2, 349 / 166 / 2, 208 / 176 / 2, 61 / 198 / 2, 270 / 213 / 2, 222 / 226 / 2, 363 / 230 / 2, 278 / 236 / 2, 5 / 249 / 2, 163 / 255 / 2, 355 / 265 / 2, 225 / 267 / 2, 330 / 286 / 2, 198 / 311 / 2, 84 / 322 / 2, 14 / 360 / 2
doublecenter-2-n5.txt, 1, 0.5, 5, 459.018, 12, 7, 4, 1,2 / 4 / 4
doublecenter-20-n375.txt, 1, 0.5, 375, 3861.06, 799, 424, 3, 23,269 / 15 / 2, 150 / 29 / 2, 311 / 36 / 2, 343 / 97 / 3, 326 / 101 / 2, 180 / 106 / 2, 149 / 130 / 2, 163 / 134 / 2, 112 / 143 / 2, 104 / 161 / 2, 210 / 169 / 2, 77 / 189 / 2, 356 / 219 / 2, 63 / 224 / 2, 87 / 258 / 2, 366 / 272 / 2, 222 / 281 / 2, 113 / 295 / 2, 270 / 297 / 2, 69 / 340 / 2, 200 / 349 / 2, 368 / 352 / 2, 209 / 374 / 2
doublecenter-20-n6.txt, 1, 0.5, 6, 486.292, 11, 5, 1, 0,
doublecenter-21-n7.txt, 1, 0.5, 7, 704.97, 13, 6, 1, 0,
doublecenter-22-n7.txt, 1, 0.5, 7, 578.001, 13, 6, 1, 0,
doublecenter-23-n7.txt, 1, 0.5, 7, 637.229, 14, 7, 2, 1,5 / 1 / 2
doublecenter-24-n7.txt, 1, 0.5, 7, 616.903, 13, 6, 1, 0,
doublecenter-25-n7.txt, 1, 0.5, 7, 816.052, 13, 6, 1, 0,
doublecenter-26-n7.txt, 1, 0.5, 7, 536.169, 13, 6, 1, 0,
doublecenter-27-n7.txt, 1, 0.5, 7, 561.392, 19, 12, 2, 2,5 / 2 / 2, 4 / 5 / 2
doublecenter-28-n7.txt, 1, 0.5, 7, 654.919, 15, 8, 2, 1,5 / 2 / 2
doublecenter-29-n7.txt, 1, 0.5, 7, 597.927, 13, 6, 1, 0,
doublecenter-3-n250.txt, 1, 0.5, 250, 2938.26, 530, 280, 3, 12,5 / 9 / 2, 67 / 14 / 2, 90 / 27 / 2, 71 / 36 / 2, 123 / 100 / 2, 117 / 121 / 2, 130 / 156 / 2, 247 / 158 / 2, 115 / 173 / 2, 7 / 186 / 3, 237 / 238 / 2, 202 / 241 / 2
doublecenter-3-n375.txt, 1, 0.5, 375, 3740.92, 789, 414, 2, 16,308 / 13 / 2, 138 / 49 / 2, 72 / 78 / 2, 21 / 102 / 2, 86 / 156 / 2, 249 / 178 / 2, 284 / 202 / 2, 278 / 219 / 2, 364 / 238 / 2, 300 / 282 / 2, 107 / 300 / 2, 209 / 303 / 2, 124 / 337 / 2, 295 / 350 / 2, 109 / 359 / 2, 358 / 363 / 2
doublecenter-3-n5.txt, 1, 0.5, 5, 570.096, 14, 9, 4, 2,4 / 1 / 4, 3 / 4 / 3
doublecenter-30-n7.txt, 1, 0.5, 7, 693.396, 14, 7, 2, 1,3 / 1 / 2
doublecenter-31-n8.txt, 1, 0.5, 8, 671.781, 15, 7, 1, 0,
doublecenter-32-n8.txt, 1, 0.5, 8, 635.889, 15, 7, 1, 0,
doublecenter-33-n8.txt, 1, 0.5, 8, 605.728, 16, 8, 2, 1,2 / 1 / 2
doublecenter-34-n8.txt, 1, 0.5, 8, 942.362, 15, 7, 1, 0,
doublecenter-35-n8.txt, 1, 0.5, 8, 616.589, 17, 9, 2, 1,3 / 5 / 2
doublecenter-36-n8.txt, 1, 0.5, 8, 749.87, 15, 7, 1, 0,
doublecenter-37-n8.txt, 1, 0.5, 8, 531.222, 16, 8, 2, 1,5 / 7 / 2
doublecenter-38-n8.txt, 1, 0.5, 8, 754.847, 15, 7, 1, 0,
doublecenter-39-n8.txt, 1, 0.5, 8, 792.636, 17, 9, 2, 1,5 / 2 / 2
doublecenter-4-n250.txt, 1, 0.5, 250, 2952.16, 521, 271, 2, 10,83 / 10 / 2, 234 / 38 / 2, 126 / 71 / 2, 159 / 73 / 2, 182 / 92 / 2, 80 / 105 / 2, 40 / 176 / 2, 187 / 219 / 2, 240 / 228 / 2, 53 / 233 / 2
doublecenter-4-n375.txt, 1, 0.5, 375, 3941.63, 781, 406, 3, 13,108 / 8 / 2, 22 / 19 / 2, 295 / 57 / 2, 172 / 67 / 2, 328 / 109 / 2, 268 / 140 / 2, 40 / 190 / 2, 29 / 221 / 2, 12 / 262 / 2, 68 / 278 / 2, 148 / 288 / 2, 331 / 302 / 3, 200 / 361 / 2
doublecenter-4-n5.txt, 1, 0.5, 5, 461.76, 9, 4, 1, 0,
doublecenter-40-n8.txt, 1, 0.5, 8, 633.222, 17, 9, 2, 1,3 / 4 / 2
doublecenter-41-n9.txt, 1, 0.5, 9, 832.906, 17, 8, 1, 0,
doublecenter-42-n9.txt, 1, 0.5, 9, 839.407, 25, 16, 3, 1,3 / 6 / 3
doublecenter-43-n9.txt, 1, 0.5, 9, 649.623, 17, 8, 1, 0,
doublecenter-44-n9.txt, 1, 0.5, 9, 820.718, 20, 11, 2, 1,4 / 2 / 2
doublecenter-45-n9.txt, 1, 0.5, 9, 592.848, 20, 11, 2, 1,5 / 5 / 2
doublecenter-46-n9.txt, 1, 0.5, 9, 573.931, 17, 8, 1, 0,
doublecenter-47-n9.txt, 1, 0.5, 9, 725.929, 17, 8, 1, 0,
doublecenter-48-n9.txt, 1, 0.5, 9, 526.727, 21, 12, 2, 1,3 / 5 / 2
doublecenter-49-n9.txt, 1, 0.5, 9, 478.61, 25, 16, 4, 1,7 / 2 / 4
doublecenter-5-n250.txt, 1, 0.5, 250, 3166.47, 539, 289, 3, 13,77 / 58 / 2, 150 / 70 / 2, 169 / 88 / 2, 71 / 109 / 3, 52 / 133 / 2, 63 / 140 / 2, 195 / 152 / 2, 180 / 165 / 2, 140 / 189 / 2, 9 / 196 / 2, 66 / 212 / 2, 108 / 221 / 2, 54 / 232 / 2
doublecenter-5-n5.txt, 1, 0.5, 5, 563.296, 9, 4, 1, 0,
doublecenter-5-n500.txt, 1, 0.5, 500, 4345.43, 1062, 562, 2, 29,11 / 9 / 2, 337 / 31 / 2, 185 / 35 / 2, 117 / 101 / 2, 493 / 105 / 2, 107 / 128 / 2, 116 / 184 / 2, 437 / 188 / 2, 369 / 216 / 2, 253 / 218 / 2, 390 / 221 / 2, 418 / 234 / 2, 412 / 250 / 2, 224 / 253 / 2, 105 / 261 / 2, 136 / 279 / 2, 456 / 282 / 2, 320 / 319 / 2, 483 / 331 / 2, 265 / 344 / 2, 455 / 400 / 2, 63 / 415 / 2, 428 / 422 / 2, 490 / 441 / 2, 171 / 448 / 2, 388 / 456 / 2, 133 / 467 / 2, 197 / 476 / 2, 143 / 495 / 2
doublecenter-50-n9.txt, 1, 0.5, 9, 602.792, 20, 11, 2, 1,8 / 5 / 2
doublecenter-51-n10.txt, 1, 0.5, 10, 617.979, 23, 13, 2, 1,2 / 5 / 2
doublecenter-52-n10.txt, 1, 0.5, 10, 495.803, 20, 10, 2, 1,2 / 9 / 2
doublecenter-53-n10.txt, 1, 0.5, 10, 877.43, 21, 11, 2, 1,4 / 3 / 2
doublecenter-54-n10.txt, 1, 0.5, 10, 596.774, 24, 14, 4, 2,8 / 7 / 2, 6 / 9 / 4
doublecenter-55-n10.txt, 1, 0.5, 10, 953.958, 29, 19, 3, 2,5 / 2 / 2, 1 / 8 / 3
doublecenter-56-n10.txt, 1, 0.5, 10, 671.443, 21, 11, 2, 1,2 / 6 / 2
doublecenter-57-n10.txt, 1, 0.5, 10, 753.952, 21, 11, 2, 1,9 / 7 / 2
doublecenter-58-n10.txt, 1, 0.5, 10, 776.617, 19, 9, 1, 0,
doublecenter-59-n10.txt, 1, 0.5, 10, 842.195, 19, 9, 1, 0,
doublecenter-6-n250.txt, 1, 0.5, 250, 2918.76, 543, 293, 2, 17,192 / 13 / 2, 98 / 16 / 2, 30 / 49 / 2, 32 / 81 / 2, 89 / 92 / 2, 227 / 97 / 2, 52 / 101 / 2, 213 / 113 / 2, 61 / 131 / 2, 182 / 135 / 2, 60 / 165 / 2, 171 / 168 / 2, 5 / 179 / 2, 167 / 187 / 2, 133 / 194 / 2, 207 / 213 / 2, 70 / 233 / 2
doublecenter-6-n5.txt, 1, 0.5, 5, 459.872, 11, 6, 2, 1,4 / 3 / 2
doublecenter-6-n500.txt, 1, 0.5, 500, 4027.38, 1063, 563, 3, 24,81 / 20 / 2, 495 / 63 / 2, 75 / 177 / 2, 18 / 178 / 2, 457 / 187 / 2, 145 / 207 / 2, 228 / 225 / 2, 452 / 240 / 3, 300 / 261 / 2, 146 / 268 / 2, 194 / 283 / 2, 439 / 297 / 2, 374 / 304 / 2, 387 / 308 / 2, 93 / 336 / 2, 15 / 343 / 2, 405 / 351 / 2, 125 / 370 / 2, 184 / 385 / 2, 167 / 393 / 2, 460 / 415 / 2, 394 / 444 / 2, 271 / 481 / 2, 132 / 492 / 2
doublecenter-60-n10.txt, 1, 0.5, 10, 960.309, 21, 11, 2, 1,9 / 4 / 2
doublecenter-61-n20.txt, 1, 0.5, 20, 957.017, 44, 24, 2, 2,2 / 5 / 2, 9 / 7 / 2
doublecenter-62-n20.txt, 1, 0.5, 20, 879.294, 40, 20, 2, 1,15 / 1 / 2
doublecenter-63-n20.txt, 1, 0.5, 20, 1006.86, 48, 28, 3, 1,12 / 4 / 3
doublecenter-64-n20.txt, 1, 0.5, 20, 1246.99, 49, 29, 3, 2,16 / 3 / 3, 19 / 14 / 2
doublecenter-65-n20.txt, 1, 0.5, 20, 767.657, 43, 23, 2, 2,1 / 3 / 2, 14 / 16 / 2
doublecenter-66-n20.txt, 1, 0.5, 20, 756.625, 41, 21, 2, 1,2 / 8 / 2
doublecenter-67-n20.txt, 1, 0.5, 20, 804.032, 46, 26, 2, 3,17 / 5 / 2, 16 / 11 / 2, 12 / 17 / 2
doublecenter-68-n20.txt, 1, 0.5, 20, 777.888, 50, 30, 3, 3,18 / 10 / 3, 9 / 13 / 2, 17 / 19 / 3
doublecenter-69-n20.txt, 1, 0.5, 20, 773.729, 39, 19, 1, 0,
doublecenter-7-n250.txt, 1, 0.5, 250, 3106.27, 556, 306, 4, 13,132 / 7 / 2, 96 / 13 / 2, 127 / 28 / 2, 77 / 33 / 4, 7 / 65 / 2, 244 / 86 / 2, 61 / 93 / 2, 144 / 125 / 2, 137 / 180 / 2, 146 / 208 / 2, 204 / 213 / 2, 171 / 214 / 2, 108 / 219 / 3
doublecenter-7-n5.txt, 1, 0.5, 5, 541.405, 9, 4, 1, 0,
doublecenter-7-n500.txt, 1, 0.5, 500, 4495.43, 1082, 582, 3, 29,217 / 9 / 2, 332 / 27 / 2, 375 / 30 / 2, 228 / 38 / 2, 468 / 63 / 2, 333 / 71 / 3, 263 / 77 / 2, 105 / 88 / 2, 59 / 110 / 2, 58 / 114 / 2, 260 / 142 / 2, 429 / 176 / 2, 414 / 188 / 2, 123 / 217 / 2, 393 / 224 / 2, 223 / 270 / 2, 116 / 297 / 2, 485 / 301 / 2, 440 / 315 / 2, 456 / 326 / 2, 99 / 346 / 2, 302 / 352 / 2, 85 / 368 / 2, 493 / 380 / 2, 232 / 423 / 2, 417 / 448 / 3, 183 / 463 / 2, 33 / 482 / 2, 243 / 497 / 2
doublecenter-70-n20.txt, 1, 0.5, 20, 894.498, 42, 22, 4, 1,12 / 1 / 4
doublecenter-71-n50.txt, 1, 0.5, 50, 1481.89, 110, 60, 2, 3,10 / 17 / 2, 28 / 21 / 2, 22 / 35 / 2
doublecenter-72-n50.txt, 1, 0.5, 50, 1349.63, 109, 59, 2, 4,6 / 3 / 2, 32 / 7 / 2, 34 / 30 / 2, 22 / 46 / 2
doublecenter-73-n50.txt, 1, 0.5, 50, 1216.77, 109, 59, 2, 5,37 / 2 / 2, 7 / 12 / 2, 18 / 19 / 2, 26 / 26 / 2, 13 / 41 / 2
doublecenter-74-n50.txt, 1, 0.5, 50, 1182.16, 108, 58, 2, 3,8 / 8 / 2, 9 / 25 / 2, 7 / 28 / 2
doublecenter-75-n50.txt, 1, 0.5, 50, 1415.82, 109, 59, 3, 1,27 / 28 / 3
doublecenter-76-n50.txt, 1, 0.5, 50, 1410.06, 139, 89, 4, 5,31 / 9 / 3, 7 / 13 / 2, 30 / 21 / 3, 38 / 32 / 4, 48 / 35 / 2
doublecenter-77-n50.txt, 1, 0.5, 50, 1270.16, 110, 60, 2, 3,32 / 5 / 2, 22 / 30 / 2, 11 / 37 / 2
doublecenter-78-n50.txt, 1, 0.5, 50, 1557.35, 125, 75, 3, 7,15 / 6 / 2, 21 / 16 / 2, 10 / 27 / 2, 12 / 31 / 3, 14 / 35 / 2, 17 / 39 / 2, 43 / 43 / 2
doublecenter-79-n50.txt, 1, 0.5, 50, 1369.98, 123, 73, 3, 6,9 / 6 / 2, 30 / 10 / 2, 18 / 15 / 2, 38 / 28 / 3, 20 / 35 / 2, 47 / 46 / 2
doublecenter-8-n250.txt, 1, 0.5, 250, 2803.04, 522, 272, 3, 10,232 / 1 / 2, 32 / 63 / 2, 190 / 66 / 3, 84 / 137 / 2, 97 / 149 / 2, 122 / 166 / 2, 236 / 176 / 2, 107 / 211 / 2, 213 / 227 / 2, 235 / 229 / 2
doublecenter-8-n5.txt, 1, 0.5, 5, 710.08, 10, 5, 2, 1,2 / 4 / 2
doublecenter-8-n500.txt, 1, 0.5, 500, 4190.86, 1065, 565, 3, 22,487 / 79 / 2, 176 / 143 / 2, 241 / 153 / 2, 8 / 161 / 2, 381 / 178 / 2, 251 / 182 / 2, 50 / 195 / 2, 6 / 197 / 2, 188 / 204 / 2, 472 / 254 / 2, 226 / 283 / 2, 308 / 300 / 2, 337 / 312 / 3, 136 / 390 / 2, 159 / 398 / 2, 66 / 419 / 2, 416 / 437 / 2, 23 / 449 / 2, 101 / 476 / 2, 239 / 481 / 2, 34 / 488 / 2, 232 / 492 / 2
doublecenter-80-n50.txt, 1, 0.5, 50, 1373.43, 117, 67, 3, 5,49 / 5 / 2, 32 / 8 / 2, 40 / 26 / 2, 21 / 29 / 3, 35 / 37 / 2
doublecenter-81-n75.txt, 1, 0.5, 75, 1668.3, 161, 86, 4, 4,25 / 1 / 4, 71 / 33 / 2, 63 / 66 / 2, 47 / 71 / 2
doublecenter-82-n75.txt, 1, 0.5, 75, 1693.94, 155, 80, 2, 2,43 / 10 / 2, 59 / 53 / 2
doublecenter-83-n75.txt, 1, 0.5, 75, 1531.59, 173, 98, 3, 4,13 / 10 / 2, 74 / 27 / 2, 10 / 68 / 3, 67 / 74 / 2
doublecenter-84-n75.txt, 1, 0.5, 75, 1964.89, 156, 81, 2, 2,17 / 31 / 2, 63 / 58 / 2
doublecenter-85-n75.txt, 1, 0.5, 75, 1972.62, 178, 103, 4, 7,19 / 5 / 4, 8 / 27 / 2, 53 / 34 / 2, 56 / 40 / 2, 60 / 49 / 2, 6 / 58 / 2, 34 / 69 / 2
doublecenter-86-n75.txt, 1, 0.5, 75, 1633.68, 173, 98, 2, 8,13 / 1 / 2, 11 / 3 / 2, 31 / 6 / 2, 62 / 20 / 2, 7 / 52 / 2, 20 / 58 / 2, 49 / 69 / 2, 10 / 73 / 2
doublecenter-87-n75.txt, 1, 0.5, 75, 1663.67, 160, 85, 2, 4,60 / 5 / 2, 2 / 32 / 2, 56 / 51 / 2, 71 / 63 / 2
doublecenter-88-n75.txt, 1, 0.5, 75, 2027.86, 175, 100, 2, 6,49 / 15 / 2, 31 / 33 / 2, 55 / 43 / 2, 44 / 56 / 2, 61 / 57 / 2, 32 / 67 / 2
doublecenter-89-n75.txt, 1, 0.5, 75, 1586.33, 159, 84, 2, 4,29 / 15 / 2, 39 / 19 / 2, 63 / 38 / 2, 73 / 55 / 2
doublecenter-9-n250.txt, 1, 0.5, 250, 3309.12, 547, 297, 4, 11,223 / 5 / 2, 150 / 17 / 2, 154 / 46 / 2, 160 / 52 / 2, 111 / 88 / 4, 127 / 136 / 2, 107 / 151 / 2, 61 / 178 / 2, 167 / 196 / 2, 224 / 216 / 2, 50 / 232 / 2
doublecenter-9-n5.txt, 1, 0.5, 5, 627.554, 12, 7, 2, 1,2 / 3 / 2
doublecenter-9-n500.txt, 1, 0.5, 500, 4486.91, 1057, 557, 2, 22,499 / 26 / 2, 318 / 40 / 2, 492 / 75 / 2, 365 / 100 / 2, 321 / 113 / 2, 104 / 128 / 2, 274 / 148 / 2, 363 / 170 / 2, 344 / 189 / 2, 297 / 198 / 2, 127 / 206 / 2, 141 / 217 / 2, 351 / 224 / 2, 271 / 247 / 2, 383 / 315 / 2, 41 / 348 / 2, 417 / 374 / 2, 275 / 388 / 2, 223 / 400 / 2, 392 / 411 / 2, 82 / 443 / 2, 68 / 447 / 2
doublecenter-90-n75.txt, 1, 0.5, 75, 1526.4, 168, 93, 3, 6,27 / 20 / 2, 45 / 49 / 3, 60 / 55 / 2, 62 / 62 / 2, 59 / 67 / 2, 64 / 72 / 2
doublecenter-91-n100.txt, 1, 0.5, 100, 1782.59, 217, 117, 3, 4,74 / 25 / 3, 6 / 37 / 3, 76 / 85 / 2, 66 / 99 / 2
doublecenter-92-n100.txt, 1, 0.5, 100, 1831.95, 226, 126, 2, 9,29 / 5 / 2, 2 / 10 / 2, 81 / 13 / 2, 90 / 17 / 2, 57 / 34 / 2, 98 / 44 / 2, 82 / 46 / 2, 89 / 80 / 2, 60 / 98 / 2
doublecenter-93-n100.txt, 1, 0.5, 100, 1712.18, 224, 124, 3, 4,75 / 33 / 3, 89 / 51 / 2, 80 / 85 / 2, 73 / 96 / 2
doublecenter-94-n100.txt, 1, 0.5, 100, 1950.2, 216, 116, 2, 6,57 / 9 / 2, 8 / 13 / 2, 56 / 20 / 2, 24 / 31 / 2, 95 / 50 / 2, 43 / 61 / 2
doublecenter-95-n100.txt, 1, 0.5, 100, 2149.58, 220, 120, 3, 6,58 / 46 / 2, 77 / 51 / 2, 41 / 61 / 2, 96 / 68 / 2, 21 / 70 / 2, 72 / 77 / 3
doublecenter-96-n100.txt, 1, 0.5, 100, 2068.61, 212, 112, 3, 4,23 / 7 / 2, 2 / 52 / 2, 38 / 69 / 3, 61 / 73 / 2
doublecenter-97-n100.txt, 1, 0.5, 100, 2091.31, 242, 142, 3, 6,56 / 49 / 3, 39 / 71 / 2, 66 / 74 / 3, 35 / 78 / 3, 81 / 84 / 2, 91 / 97 / 2
doublecenter-98-n100.txt, 1, 0.5, 100, 1954.18, 235, 135, 4, 6,62 / 13 / 2, 13 / 19 / 4, 15 / 39 / 2, 49 / 51 / 2, 68 / 69 / 2, 52 / 73 / 3
doublecenter-99-n100.txt, 1, 0.5, 100, 1823.88, 219, 119, 2, 8,98 / 13 / 2, 59 / 15 / 2, 61 / 19 / 2, 56 / 29 / 2, 86 / 39 / 2, 94 / 59 / 2, 28 / 66 / 2, 1 / 94 / 2
doublecenter-alpha_1-1-n250.txt, 1, 1, 250, 3192.29, 1942, 1692, 7, 249,209 / 1 / 5, 41 / 2 / 2, 85 / 3 / 2, 204 / 4 / 2, 155 / 5 / 2, 27 / 6 / 4, 57 / 7 / 2, 102 / 8 / 2, 159 / 9 / 2, 117 / 10 / 2, 214 / 11 / 3, 14 / 12 / 2, 108 / 13 / 2, 192 / 14 / 2, 142 / 15 / 3, 12 / 16 / 2, 80 / 17 / 3, 137 / 18 / 2, 196 / 19 / 2, 2 / 20 / 2, 188 / 21 / 3, 19 / 22 / 2, 220 / 23 / 3, 49 / 24 / 2, 94 / 25 / 3, 199 / 26 / 2, 215 / 27 / 2, 134 / 28 / 2, 64 / 29 / 2, 240 / 30 / 4, 114 / 31 / 2, 97 / 32 / 2, 167 / 33 / 2, 160 / 34 / 2, 154 / 35 / 3, 70 / 36 / 2, 244 / 37 / 2, 35 / 38 / 4, 237 / 39 / 2, 110 / 40 / 3, 207 / 41 / 2, 138 / 42 / 2, 87 / 43 / 3, 127 / 44 / 2, 1 / 45 / 2, 58 / 46 / 2, 112 / 47 / 2, 146 / 48 / 3, 83 / 49 / 2, 98 / 50 / 3, 210 / 51 / 2, 226 / 52 / 2, 121 / 53 / 3, 239 / 54 / 2, 156 / 55 / 3, 202 / 56 / 2, 230 / 57 / 3, 185 / 58 / 2, 24 / 59 / 2, 69 / 60 / 2, 33 / 61 / 2, 25 / 62 / 2, 48 / 63 / 2, 151 / 64 / 2, 197 / 65 / 5, 20 / 66 / 2, 99 / 67 / 2, 51 / 68 / 2, 71 / 69 / 4, 29 / 70 / 2, 136 / 71 / 2, 241 / 72 / 2, 46 / 73 / 2, 223 / 74 / 2, 153 / 75 / 2, 242 / 76 / 3, 78 / 77 / 2, 3 / 78 / 3, 173 / 79 / 2, 81 / 80 / 3, 119 / 81 / 2, 168 / 82 / 2, 171 / 83 / 3, 232 / 84 / 2, 149 / 85 / 2, 89 / 86 / 3, 198 / 87 / 2, 9 / 88 / 2, 169 / 89 / 2, 233 / 90 / 2, 104 / 91 / 2, 28 / 92 / 2, 174 / 93 / 3, 79 / 94 / 2, 222 / 95 / 2, 18 / 96 / 2, 186 / 97 / 2, 216 / 98 / 2, 206 / 99 / 3, 101 / 100 / 2, 148 / 101 / 4, 246 / 102 / 2, 128 / 103 / 2, 42 / 104 / 2, 231 / 105 / 3, 47 / 106 / 2, 55 / 107 / 3, 7 / 108 / 2, 60 / 109 / 2, 181 / 110 / 4, 163 / 111 / 2, 166 / 112 / 2, 82 / 113 / 2, 56 / 114 / 2, 126 / 115 / 2, 88 / 116 / 3, 213 / 117 / 2, 179 / 118 / 2, 52 / 119 / 2, 115 / 120 / 2, 34 / 121 / 2, 93 / 122 / 2, 54 / 123 / 3, 105 / 124 / 2, 161 / 125 / 2, 72 / 126 / 3, 195 / 127 / 2, 189 / 128 / 2, 95 / 129 / 2, 139 / 130 / 2, 144 / 131 / 3, 133 / 132 / 2, 176 / 133 / 2, 92 / 134 / 3, 225 / 135 / 2, 106 / 136 / 2, 4 / 137 / 2, 65 / 138 / 2, 38 / 139 / 2, 238 / 140 / 2, 152 / 141 / 2, 32 / 142 / 3, 123 / 143 / 2, 141 / 144 / 3, 229 / 145 / 2, 11 / 146 / 3, 113 / 147 / 2, 234 / 148 / 5, 44 / 149 / 2, 100 / 150 / 2, 235 / 151 / 2, 96 / 152 / 3, 182 / 153 / 2, 247 / 154 / 3, 221 / 155 / 2, 26 / 156 / 2, 249 / 157 / 3, 31 / 158 / 2, 16 / 159 / 2, 50 / 160 / 3, 175 / 161 / 2, 73 / 162 / 2, 147 / 163 / 3, 135 / 164 / 2, 219 / 165 / 2, 212 / 166 / 2, 40 / 167 / 2, 217 / 168 / 3, 243 / 169 / 2, 76 / 170 / 2, 191 / 171 / 2, 129 / 172 / 2, 140 / 173 / 2, 183 / 174 / 3, 227 / 175 / 2, 36 / 176 / 7, 103 / 177 / 2, 178 / 178 / 2, 39 / 179 / 3, 30 / 180 / 2, 162 / 181 / 3, 68 / 182 / 2, 245 / 183 / 2, 84 / 184 / 2, 180 / 185 / 2, 184 / 186 / 2, 90 / 187 / 2, 77 / 188 / 3, 125 / 189 / 2, 43 / 190 / 3, 157 / 191 / 2, 120 / 192 / 3, 116 / 193 / 2, 86 / 194 / 3, 8 / 195 / 2, 13 / 196 / 2, 15 / 197 / 2, 150 / 198 / 6, 61 / 199 / 2, 45 / 200 / 2, 74 / 201 / 2, 218 / 202 / 2, 190 / 203 / 2, 122 / 204 / 2, 224 / 205 / 2, 201 / 206 / 2, 248 / 207 / 2, 165 / 208 / 3, 131 / 209 / 2, 53 / 210 / 2, 158 / 211 / 2, 75 / 212 / 2, 228 / 213 / 6, 111 / 214 / 2, 203 / 215 / 2, 118 / 216 / 2, 6 / 217 / 3, 17 / 218 / 2, 170 / 219 / 3, 205 / 220 / 2, 109 / 221 / 2, 145 / 222 / 2, 236 / 223 / 2, 10 / 224 / 2, 66 / 225 / 2, 172 / 226 / 2, 37 / 227 / 2, 193 / 228 / 2, 23 / 229 / 2, 91 / 230 / 2, 21 / 231 / 2, 164 / 232 / 4, 22 / 233 / 2, 107 / 234 / 2, 59 / 235 / 3, 63 / 236 / 2, 200 / 237 / 3, 177 / 238 / 2, 5 / 239 / 2, 67 / 240 / 6, 62 / 241 / 2, 130 / 242 / 3, 132 / 243 / 2, 124 / 244 / 2, 143 / 245 / 4, 187 / 246 / 2, 211 / 247 / 3, 194 / 248 / 2, 208 / 249 / 2
doublecenter-alpha_1-1-n375.txt, 1, 1, 375, 3706.28, 2868, 2493, 10, 374,103 / 1 / 4, 308 / 2 / 2, 175 / 3 / 2, 109 / 4 / 2, 44 / 5 / 3, 302 / 6 / 2, 55 / 7 / 2, 162 / 8 / 3, 130 / 9 / 2, 129 / 10 / 3, 81 / 11 / 2, 26 / 12 / 2, 73 / 13 / 6, 18 / 14 / 2, 114 / 15 / 2, 13 / 16 / 2, 242 / 17 / 2, 48 / 18 / 3, 19 / 19 / 2, 301 / 20 / 2, 97 / 21 / 2, 266 / 22 / 2, 6 / 23 / 2, 101 / 24 / 3, 224 / 25 / 2, 34 / 26 / 3, 340 / 27 / 2, 256 / 28 / 2, 166 / 29 / 2, 213 / 30 / 2, 216 / 31 / 3, 4 / 32 / 2, 72 / 33 / 2, 127 / 34 / 3, 42 / 35 / 2, 189 / 36 / 2, 209 / 37 / 2, 260 / 38 / 3, 25 / 39 / 2, 132 / 40 / 3, 357 / 41 / 2, 111 / 42 / 3, 269 / 43 / 2, 243 / 44 / 2, 187 / 45 / 2, 297 / 46 / 3, 353 / 47 / 2, 257 / 48 / 4, 71 / 49 / 2, 315 / 50 / 2, 167 / 51 / 2, 371 / 52 / 3, 251 / 53 / 2, 331 / 54 / 2, 343 / 55 / 2, 225 / 56 / 2, 300 / 57 / 3, 173 / 58 / 2, 186 / 59 / 3, 261 / 60 / 2, 265 / 61 / 2, 199 / 62 / 2, 341 / 63 / 4, 116 / 64 / 2, 102 / 65 / 2, 217 / 66 / 2, 87 / 67 / 2, 202 / 68 / 2, 139 / 69 / 2, 137 / 70 / 5, 161 / 71 / 2, 262 / 72 / 2, 74 / 73 / 2, 141 / 74 / 2, 5 / 75 / 6, 149 / 76 / 2, 89 / 77 / 2, 328 / 78 / 2, 10 / 79 / 3, 66 / 80 / 2, 305 / 81 / 2, 46 / 82 / 4, 250 / 83 / 2, 330 / 84 / 2, 21 / 85 / 2, 203 / 86 / 2, 165 / 87 / 3, 192 / 88 / 2, 334 / 89 / 3, 263 / 90 / 2, 280 / 91 / 3, 93 / 92 / 2, 59 / 93 / 2, 200 / 94 / 2, 176 / 95 / 4, 136 / 96 / 2, 231 / 97 / 2, 144 / 98 / 10, 123 / 99 / 2, 82 / 100 / 2, 351 / 101 / 2, 27 / 102 / 2, 7 / 103 / 2, 77 / 104 / 2, 193 / 105 / 2, 339 / 106 / 2, 106 / 107 / 3, 52 / 108 / 2, 294 / 109 / 2, 157 / 110 / 3, 63 / 111 / 2, 276 / 112 / 3, 88 / 113 / 2, 98 / 114 / 2, 212 / 115 / 2, 283 / 116 / 2, 47 / 117 / 2, 28 / 118 / 3, 204 / 119 / 2, 50 / 120 / 3, 164 / 121 / 2, 31 / 122 / 2, 338 / 123 / 4, 248 / 124 / 2, 9 / 125 / 2, 333 / 126 / 2, 358 / 127 / 2, 159 / 128 / 2, 49 / 129 / 2, 326 / 130 / 2, 40 / 131 / 3, 2 / 132 / 2, 99 / 133 / 2, 69 / 134 / 4, 285 / 135 / 2, 154 / 136 / 2, 278 / 137 / 2, 190 / 138 / 3, 304 / 139 / 2, 184 / 140 / 2, 296 / 141 / 2, 168 / 142 / 4, 361 / 143 / 2, 227 / 144 / 2, 329 / 145 / 2, 214 / 146 / 3, 41 / 147 / 2, 182 / 148 / 2, 244 / 149 / 2, 374 / 150 / 2, 153 / 151 / 2, 86 / 152 / 2, 210 / 153 / 3, 112 / 154 / 2, 254 / 155 / 2, 223 / 156 / 3, 104 / 157 / 2, 172 / 158 / 3, 337 / 159 / 2, 178 / 160 / 2, 299 / 161 / 6, 352 / 162 / 2, 65 / 163 / 2, 332 / 164 / 2, 317 / 165 / 3, 160 / 166 / 2, 222 / 167 / 2, 284 / 168 / 3, 237 / 169 / 2, 57 / 170 / 2, 350 / 171 / 2, 170 / 172 / 3, 286 / 173 / 2, 151 / 174 / 2, 314 / 175 / 2, 298 / 176 / 2, 113 / 177 / 2, 107 / 178 / 4, 135 / 179 / 2, 121 / 180 / 2, 293 / 181 / 2, 169 / 182 / 2, 259 / 183 / 3, 134 / 184 / 2, 211 / 185 / 3, 206 / 186 / 2, 171 / 187 / 2, 145 / 188 / 2, 45 / 189 / 5, 318 / 190 / 2, 197 / 191 / 2, 268 / 192 / 2, 194 / 193 / 2, 322 / 194 / 2, 32 / 195 / 2, 118 / 196 / 2, 320 / 197 / 3, 105 / 198 / 2, 23 / 199 / 2, 207 / 200 / 4, 275 / 201 / 2, 372 / 202 / 2, 174 / 203 / 3, 277 / 204 / 2, 115 / 205 / 2, 185 / 206 / 2, 198 / 207 / 2, 117 / 208 / 3, 188 / 209 / 2, 291 / 210 / 2, 281 / 211 / 2, 272 / 212 / 2, 236 / 213 / 3, 143 / 214 / 2, 312 / 215 / 2, 20 / 216 / 4, 218 / 217 / 2, 249 / 218 / 2, 274 / 219 / 2, 316 / 220 / 5, 183 / 221 / 2, 234 / 222 / 2, 38 / 223 / 2, 230 / 224 / 2, 247 / 225 / 4, 108 / 226 / 2, 91 / 227 / 2, 309 / 228 / 2, 289 / 229 / 2, 368 / 230 / 2, 195 / 231 / 2, 226 / 232 / 2, 15 / 233 / 2, 148 / 234 / 3, 258 / 235 / 2, 131 / 236 / 2, 324 / 237 / 3, 196 / 238 / 2, 367 / 239 / 4, 303 / 240 / 2, 348 / 241 / 2, 122 / 242 / 3, 163 / 243 / 2, 221 / 244 / 2, 201 / 245 / 2, 147 / 246 / 2, 311 / 247 / 3, 205 / 248 / 2, 246 / 249 / 2, 140 / 250 / 3, 295 / 251 / 2, 61 / 252 / 3, 288 / 253 / 2, 282 / 254 / 3, 22 / 255 / 2, 354 / 256 / 2, 252 / 257 / 5, 240 / 258 / 2, 126 / 259 / 2, 11 / 260 / 2, 270 / 261 / 4, 245 / 262 / 2, 319 / 263 / 2, 344 / 264 / 3, 232 / 265 / 2, 3 / 266 / 2, 310 / 267 / 3, 235 / 268 / 2, 208 / 269 / 2, 325 / 270 / 4, 36 / 271 / 2, 80 / 272 / 2, 14 / 273 / 3, 92 / 274 / 2, 100 / 275 / 2, 321 / 276 / 2, 1 / 277 / 4, 96 / 278 / 2, 267 / 279 / 2, 264 / 280 / 3, 152 / 281 / 2, 78 / 282 / 5, 239 / 283 / 2, 181 / 284 / 2, 30 / 285 / 2, 35 / 286 / 2, 53 / 287 / 2, 336 / 288 / 2, 290 / 289 / 2, 271 / 290 / 2, 95 / 291 / 3, 279 / 292 / 2, 24 / 293 / 3, 191 / 294 / 2, 253 / 295 / 3, 67 / 296 / 2, 70 / 297 / 3, 60 / 298 / 2, 233 / 299 / 3, 219 / 300 / 2, 370 / 301 / 2, 37 / 302 / 3, 363 / 303 / 2, 125 / 304 / 2, 373 / 305 / 3, 241 / 306 / 2, 335 / 307 / 4, 179 / 308 / 2, 292 / 309 / 2, 94 / 310 / 2, 83 / 311 / 3, 43 / 312 / 2, 362 / 313 / 3, 359 / 314 / 2, 238 / 315 / 2, 366 / 316 / 2, 323 / 317 / 2, 177 / 318 / 3, 327 / 319 / 2, 287 / 320 / 2, 360 / 321 / 2, 364 / 322 / 5, 133 / 323 / 2, 110 / 324 / 2, 155 / 325 / 3, 16 / 326 / 2, 79 / 327 / 3, 228 / 328 / 2, 54 / 329 / 2, 365 / 330 / 3, 138 / 331 / 2, 355 / 332 / 3, 51 / 333 / 2, 346 / 334 / 2, 85 / 335 / 3, 124 / 336 / 2, 273 / 337 / 2, 349 / 338 / 3, 146 / 339 / 2, 220 / 340 / 2, 84 / 341 / 2, 29 / 342 / 2, 39 / 343 / 2, 229 / 344 / 2, 180 / 345 / 3, 356 / 346 / 2, 150 / 347 / 3, 17 / 348 / 2, 307 / 349 / 2, 128 / 350 / 3, 347 / 351 / 2, 64 / 352 / 3, 158 / 353 / 2, 58 / 354 / 3, 255 / 355 / 2, 75 / 356 / 2, 142 / 357 / 4, 62 / 358 / 2, 215 / 359 / 3, 306 / 360 / 2, 345 / 361 / 5, 90 / 362 / 2, 156 / 363 / 2, 342 / 364 / 4, 12 / 365 / 2, 33 / 366 / 2, 76 / 367 / 3, 369 / 368 / 2, 120 / 369 / 4, 313 / 370 / 2, 56 / 371 / 2, 68 / 372 / 4, 8 / 373 / 2, 119 / 374 / 3
doublecenter-alpha_1-1-n5.txt, 1, 1, 5, 519.298, 20, 15, 4, 4,4 / 1 / 4, 2 / 2 / 2, 3 / 3 / 2, 1 / 4 / 4
doublecenter-alpha_1-10-n250.txt, 1, 1, 250, 3112.31, 2028, 1778, 12, 249,49 / 1 / 2, 41 / 2 / 3, 129 / 3 / 2, 72 / 4 / 4, 179 / 5 / 2, 125 / 6 / 3, 99 / 7 / 2, 97 / 8 / 2, 166 / 9 / 2, 224 / 10 / 3, 76 / 11 / 2, 135 / 12 / 3, 240 / 13 / 2, 180 / 14 / 3, 4 / 15 / 2, 62 / 16 / 2, 119 / 17 / 3, 101 / 18 / 2, 227 / 19 / 2, 31 / 20 / 3, 212 / 21 / 2, 245 / 22 / 3, 44 / 23 / 2, 132 / 24 / 2, 203 / 25 / 3, 238 / 26 / 2, 84 / 27 / 3, 81 / 28 / 2, 17 / 29 / 4, 54 / 30 / 2, 244 / 31 / 2, 153 / 32 / 2, 104 / 33 / 3, 83 / 34 / 2, 56 / 35 / 2, 94 / 36 / 2, 147 / 37 / 2, 133 / 38 / 2, 223 / 39 / 2, 217 / 40 / 2, 23 / 41 / 2, 246 / 42 / 2, 208 / 43 / 2, 145 / 44 / 2, 93 / 45 / 2, 222 / 46 / 2, 152 / 47 / 3, 61 / 48 / 2, 89 / 49 / 3, 106 / 50 / 2, 185 / 51 / 3, 63 / 52 / 2, 158 / 53 / 2, 25 / 54 / 3, 110 / 55 / 2, 70 / 56 / 4, 28 / 57 / 2, 12 / 58 / 2, 169 / 59 / 2, 95 / 60 / 2, 14 / 61 / 2, 6 / 62 / 2, 51 / 63 / 2, 58 / 64 / 2, 86 / 65 / 2, 109 / 66 / 2, 146 / 67 / 3, 176 / 68 / 2, 8 / 69 / 2, 216 / 70 / 2, 207 / 71 / 2, 123 / 72 / 2, 211 / 73 / 5, 148 / 74 / 2, 120 / 75 / 2, 43 / 76 / 2, 30 / 77 / 3, 36 / 78 / 2, 46 / 79 / 2, 231 / 80 / 3, 225 / 81 / 2, 143 / 82 / 2, 42 / 83 / 2, 39 / 84 / 5, 15 / 85 / 2, 75 / 86 / 3, 74 / 87 / 2, 218 / 88 / 2, 170 / 89 / 2, 91 / 90 / 3, 221 / 91 / 2, 9 / 92 / 2, 105 / 93 / 2, 202 / 94 / 2, 183 / 95 / 3, 174 / 96 / 2, 108 / 97 / 3, 214 / 98 / 2, 186 / 99 / 2, 141 / 100 / 3, 116 / 101 / 2, 191 / 102 / 3, 233 / 103 / 2, 154 / 104 / 3, 92 / 105 / 2, 35 / 106 / 2, 157 / 107 / 2, 239 / 108 / 3, 151 / 109 / 2, 205 / 110 / 4, 90 / 111 / 2, 139 / 112 / 2, 156 / 113 / 3, 243 / 114 / 2, 66 / 115 / 2, 160 / 116 / 3, 164 / 117 / 2, 34 / 118 / 2, 236 / 119 / 4, 80 / 120 / 2, 181 / 121 / 2, 52 / 122 / 2, 67 / 123 / 2, 189 / 124 / 4, 20 / 125 / 2, 197 / 126 / 2, 1 / 127 / 2, 11 / 128 / 4, 40 / 129 / 2, 111 / 130 / 2, 178 / 131 / 2, 102 / 132 / 2, 53 / 133 / 3, 165 / 134 / 2, 60 / 135 / 3, 78 / 136 / 2, 47 / 137 / 2, 144 / 138 / 2, 16 / 139 / 3, 198 / 140 / 2, 59 / 141 / 3, 68 / 142 / 2, 171 / 143 / 2, 19 / 144 / 3, 100 / 145 / 2, 192 / 146 / 2, 128 / 147 / 2, 206 / 148 / 2, 168 / 149 / 2, 159 / 150 / 3, 64 / 151 / 2, 167 / 152 / 3, 163 / 153 / 2, 77 / 154 / 3, 161 / 155 / 2, 114 / 156 / 3, 18 / 157 / 2, 22 / 158 / 2, 124 / 159 / 3, 79 / 160 / 2, 215 / 161 / 4, 122 / 162 / 2, 201 / 163 / 2, 98 / 164 / 3, 71 / 165 / 2, 134 / 166 / 3, 87 / 167 / 2, 138 / 168 / 2, 229 / 169 / 3, 196 / 170 / 2, 204 / 171 / 3, 57 / 172 / 2, 235 / 173 / 3, 234 / 174 / 2, 37 / 175 / 2, 85 / 176 / 2, 149 / 177 / 5, 112 / 178 / 2, 230 / 179 / 3, 48 / 180 / 2, 190 / 181 / 2, 237 / 182 / 2, 118 / 183 / 3, 184 / 184 / 2, 126 / 185 / 4, 177 / 186 / 2, 182 / 187 / 3, 130 / 188 / 2, 3 / 189 / 2, 38 / 190 / 4, 213 / 191 / 2, 2 / 192 / 2, 247 / 193 / 3, 162 / 194 / 2, 226 / 195 / 3, 232 / 196 / 2, 155 / 197 / 2, 219 / 198 / 3, 150 / 199 / 2, 140 / 200 / 3, 241 / 201 / 2, 199 / 202 / 3, 228 / 203 / 2, 24 / 204 / 2, 96 / 205 / 4, 242 / 206 / 2, 121 / 207 / 2, 82 / 208 / 3, 113 / 209 / 2, 21 / 210 / 3, 249 / 211 / 2, 131 / 212 / 3, 50 / 213 / 2, 65 / 214 / 3, 209 / 215 / 2, 32 / 216 / 2, 13 / 217 / 2, 107 / 218 / 2, 45 / 219 / 2, 33 / 220 / 3, 5 / 221 / 2, 193 / 222 / 12, 136 / 223 / 2, 200 / 224 / 2, 88 / 225 / 2, 26 / 226 / 3, 127 / 227 / 2, 29 / 228 / 2, 195 / 229 / 2, 175 / 230 / 2, 69 / 231 / 2, 137 / 232 / 2, 73 / 233 / 2, 172 / 234 / 3, 173 / 235 / 2, 117 / 236 / 3, 10 / 237 / 2, 220 / 238 / 2, 55 / 239 / 3, 115 / 240 / 2, 194 / 241 / 3, 142 / 242 / 2, 187 / 243 / 3, 188 / 244 / 2, 103 / 245 / 2, 27 / 246 / 2, 248 / 247 / 2, 210 / 248 / 3, 7 / 249 / 2
doublecenter-alpha_1-10-n5.txt, 1, 1, 5, 616.2, 19, 14, 5, 4,2 / 1 / 5, 1 / 2 / 2, 4 / 3 / 2, 3 / 4 / 3
doublecenter-alpha_1-10-n500.txt, 1, 1, 500, 5010.15, 4137, 3637, 10, 499,142 / 1 / 8, 201 / 2 / 2, 241 / 3 / 2, 457 / 4 / 2, 180 / 5 / 2, 44 / 6 / 2, 454 / 7 / 3, 447 / 8 / 2, 386 / 9 / 2, 46 / 10 / 2, 413 / 11 / 2, 496 / 12 / 2, 296 / 13 / 4, 40 / 14 / 2, 113 / 15 / 2, 367 / 16 / 4, 286 / 17 / 2, 291 / 18 / 2, 376 / 19 / 3, 304 / 20 / 2, 152 / 21 / 3, 218 / 22 / 2, 344 / 23 / 2, 15 / 24 / 2, 221 / 25 / 2, 97 / 26 / 4, 429 / 27 / 2, 35 / 28 / 2, 1 / 29 / 2, 56 / 30 / 3, 88 / 31 / 2, 480 / 32 / 2, 311 / 33 / 3, 170 / 34 / 2, 308 / 35 / 3, 254 / 36 / 2, 456 / 37 / 6, 23 / 38 / 2, 10 / 39 / 3, 112 / 40 / 2, 75 / 41 / 2, 451 / 42 / 3, 225 / 43 / 2, 371 / 44 / 2, 463 / 45 / 2, 6 / 46 / 2, 366 / 47 / 4, 39 / 48 / 2, 81 / 49 / 2, 243 / 50 / 2, 25 / 51 / 2, 276 / 52 / 2, 353 / 53 / 3, 265 / 54 / 2, 132 / 55 / 2, 404 / 56 / 3, 274 / 57 / 2, 177 / 58 / 3, 51 / 59 / 2, 131 / 60 / 2, 189 / 61 / 3, 378 / 62 / 2, 355 / 63 / 2, 118 / 64 / 2, 73 / 65 / 3, 464 / 66 / 2, 26 / 67 / 2, 3 / 68 / 3, 84 / 69 / 2, 160 / 70 / 2, 331 / 71 / 2, 182 / 72 / 2, 357 / 73 / 2, 32 / 74 / 2, 193 / 75 / 2, 354 / 76 / 2, 18 / 77 / 3, 83 / 78 / 2, 494 / 79 / 2, 270 / 80 / 3, 236 / 81 / 2, 288 / 82 / 3, 165 / 83 / 2, 244 / 84 / 2, 223 / 85 / 2, 477 / 86 / 3, 306 / 87 / 2, 484 / 88 / 3, 261 / 89 / 2, 153 / 90 / 3, 410 / 91 / 2, 111 / 92 / 3, 467 / 93 / 2, 269 / 94 / 2, 38 / 95 / 4, 109 / 96 / 2, 248 / 97 / 2, 400 / 98 / 2, 42 / 99 / 2, 377 / 100 / 4, 468 / 101 / 2, 94 / 102 / 2, 476 / 103 / 3, 417 / 104 / 2, 93 / 105 / 2, 258 / 106 / 2, 374 / 107 / 4, 341 / 108 / 2, 250 / 109 / 2, 71 / 110 / 4, 175 / 111 / 2, 272 / 112 / 2, 327 / 113 / 2, 21 / 114 / 2, 53 / 115 / 2, 48 / 116 / 2, 489 / 117 / 3, 17 / 118 / 2, 217 / 119 / 2, 406 / 120 / 2, 449 / 121 / 3, 324 / 122 / 2, 257 / 123 / 2, 289 / 124 / 3, 123 / 125 / 2, 171 / 126 / 3, 95 / 127 / 2, 310 / 128 / 3, 389 / 129 / 2, 167 / 130 / 3, 197 / 131 / 2, 184 / 132 / 2, 390 / 133 / 2, 209 / 134 / 2, 187 / 135 / 2, 11 / 136 / 2, 13 / 137 / 3, 491 / 138 / 2, 208 / 139 / 3, 154 / 140 / 2, 408 / 141 / 3, 360 / 142 / 2, 129 / 143 / 2, 255 / 144 / 2, 246 / 145 / 2, 475 / 146 / 5, 303 / 147 / 2, 116 / 148 / 2, 319 / 149 / 2, 230 / 150 / 3, 492 / 151 / 2, 332 / 152 / 2, 338 / 153 / 2, 151 / 154 / 2, 245 / 155 / 2, 472 / 156 / 2, 487 / 157 / 3, 29 / 158 / 2, 485 / 159 / 2, 314 / 160 / 4, 352 / 161 / 2, 380 / 162 / 3, 282 / 163 / 2, 103 / 164 / 4, 234 / 165 / 2, 325 / 166 / 2, 202 / 167 / 2, 33 / 168 / 2, 309 / 169 / 5, 196 / 170 / 2, 339 / 171 / 3, 414 / 172 / 2, 128 / 173 / 2, 161 / 174 / 2, 117 / 175 / 3, 318 / 176 / 2, 293 / 177 / 3, 127 / 178 / 2, 493 / 179 / 10, 62 / 180 / 2, 98 / 181 / 2, 498 / 182 / 2, 96 / 183 / 2, 155 / 184 / 2, 281 / 185 / 4, 110 / 186 / 2, 473 / 187 / 2, 157 / 188 / 2, 253 / 189 / 3, 297 / 190 / 2, 440 / 191 / 3, 115 / 192 / 2, 317 / 193 / 2, 445 / 194 / 2, 330 / 195 / 4, 299 / 196 / 2, 471 / 197 / 2, 240 / 198 / 3, 252 / 199 / 2, 37 / 200 / 3, 401 / 201 / 2, 144 / 202 / 2, 315 / 203 / 3, 102 / 204 / 2, 302 / 205 / 2, 424 / 206 / 2, 108 / 207 / 6, 148 / 208 / 2, 351 / 209 / 3, 295 / 210 / 2, 173 / 211 / 2, 425 / 212 / 4, 458 / 213 / 2, 190 / 214 / 2, 396 / 215 / 5, 359 / 216 / 2, 188 / 217 / 2, 210 / 218 / 2, 421 / 219 / 3, 121 / 220 / 2, 266 / 221 / 2, 441 / 222 / 3, 285 / 223 / 2, 76 / 224 / 3, 335 / 225 / 2, 57 / 226 / 3, 407 / 227 / 2, 126 / 228 / 5, 430 / 229 / 2, 431 / 230 / 3, 405 / 231 / 2, 20 / 232 / 3, 80 / 233 / 2, 342 / 234 / 3, 460 / 235 / 2, 368 / 236 / 2, 30 / 237 / 3, 101 / 238 / 2, 149 / 239 / 2, 47 / 240 / 2, 141 / 241 / 2, 64 / 242 / 3, 158 / 243 / 2, 130 / 244 / 3, 172 / 245 / 2, 384 / 246 / 2, 191 / 247 / 2, 470 / 248 / 2, 388 / 249 / 2, 284 / 250 / 3, 14 / 251 / 2, 402 / 252 / 2, 479 / 253 / 4, 67 / 254 / 2, 428 / 255 / 2, 349 / 256 / 3, 49 / 257 / 2, 138 / 258 / 2, 420 / 259 / 2, 8 / 260 / 5, 183 / 261 / 2, 90 / 262 / 2, 397 / 263 / 2, 22 / 264 / 2, 169 / 265 / 3, 326 / 266 / 2, 179 / 267 / 2, 455 / 268 / 2, 43 / 269 / 5, 462 / 270 / 2, 28 / 271 / 2, 78 / 272 / 3, 85 / 273 / 2, 277 / 274 / 2, 422 / 275 / 3, 68 / 276 / 2, 446 / 277 / 2, 133 / 278 / 4, 251 / 279 / 2, 77 / 280 / 2, 395 / 281 / 2, 89 / 282 / 3, 181 / 283 / 2, 481 / 284 / 3, 146 / 285 / 2, 362 / 286 / 3, 497 / 287 / 2, 192 / 288 / 2, 125 / 289 / 3, 298 / 290 / 2, 203 / 291 / 2, 69 / 292 / 2, 323 / 293 / 2, 135 / 294 / 4, 41 / 295 / 2, 379 / 296 / 3, 316 / 297 / 2, 139 / 298 / 3, 313 / 299 / 2, 247 / 300 / 2, 207 / 301 / 2, 461 / 302 / 4, 434 / 303 / 2, 194 / 304 / 2, 104 / 305 / 2, 312 / 306 / 2, 294 / 307 / 3, 418 / 308 / 2, 228 / 309 / 2, 63 / 310 / 2, 364 / 311 / 2, 348 / 312 / 2, 105 / 313 / 2, 438 / 314 / 2, 381 / 315 / 2, 337 / 316 / 2, 333 / 317 / 2, 444 / 318 / 2, 448 / 319 / 2, 60 / 320 / 3, 87 / 321 / 2, 436 / 322 / 2, 106 / 323 / 2, 426 / 324 / 2, 70 / 325 / 2, 375 / 326 / 4, 278 / 327 / 2, 215 / 328 / 2, 416 / 329 / 2, 204 / 330 / 2, 79 / 331 / 2, 31 / 332 / 2, 213 / 333 / 2, 200 / 334 / 2, 2 / 335 / 7, 66 / 336 / 2, 65 / 337 / 2, 34 / 338 / 2, 59 / 339 / 2, 336 / 340 / 2, 45 / 341 / 3, 320 / 342 / 2, 229 / 343 / 2, 156 / 344 / 3, 307 / 345 / 2, 12 / 346 / 3, 273 / 347 / 2, 82 / 348 / 2, 392 / 349 / 3, 398 / 350 / 2, 163 / 351 / 3, 370 / 352 / 2, 465 / 353 / 2, 329 / 354 / 3, 486 / 355 / 2, 107 / 356 / 5, 19 / 357 / 2, 119 / 358 / 2, 358 / 359 / 2, 347 / 360 / 3, 237 / 361 / 2, 195 / 362 / 2, 224 / 363 / 3, 264 / 364 / 2, 61 / 365 / 2, 143 / 366 / 2, 150 / 367 / 2, 365 / 368 / 2, 226 / 369 / 3, 409 / 370 / 2, 443 / 371 / 2, 27 / 372 / 4, 222 / 373 / 2, 369 / 374 / 3, 415 / 375 / 2, 361 / 376 / 2, 383 / 377 / 4, 219 / 378 / 2, 185 / 379 / 3, 36 / 380 / 2, 16 / 381 / 2, 433 / 382 / 3, 174 / 383 / 2, 292 / 384 / 2, 50 / 385 / 2, 176 / 386 / 2, 54 / 387 / 2, 231 / 388 / 2, 419 / 389 / 5, 403 / 390 / 2, 99 / 391 / 2, 227 / 392 / 2, 92 / 393 / 4, 9 / 394 / 2, 495 / 395 / 3, 499 / 396 / 2, 242 / 397 / 2, 435 / 398 / 3, 490 / 399 / 2, 238 / 400 / 2, 256 / 401 / 6, 166 / 402 / 2, 350 / 403 / 3, 283 / 404 / 2, 340 / 405 / 3, 162 / 406 / 2, 466 / 407 / 2, 214 / 408 / 4, 343 / 409 / 2, 186 / 410 / 3, 220 / 411 / 2, 235 / 412 / 3, 91 / 413 / 2, 122 / 414 / 2, 267 / 415 / 3, 198 / 416 / 2, 199 / 417 / 2, 382 / 418 / 2, 52 / 419 / 2, 399 / 420 / 3, 373 / 421 / 2, 442 / 422 / 2, 114 / 423 / 3, 334 / 424 / 2, 453 / 425 / 2, 322 / 426 / 3, 488 / 427 / 2, 260 / 428 / 2, 100 / 429 / 5, 372 / 430 / 2, 321 / 431 / 2, 483 / 432 / 2, 136 / 433 / 4, 58 / 434 / 2, 206 / 435 / 2, 427 / 436 / 5, 290 / 437 / 2, 287 / 438 / 2, 72 / 439 / 2, 145 / 440 / 2, 328 / 441 / 3, 432 / 442 / 2, 212 / 443 / 2, 393 / 444 / 2, 391 / 445 / 3, 159 / 446 / 2, 280 / 447 / 2, 137 / 448 / 2, 74 / 449 / 3, 300 / 450 / 2, 259 / 451 / 5, 120 / 452 / 2, 168 / 453 / 2, 437 / 454 / 2, 7 / 455 / 3, 271 / 456 / 2, 24 / 457 / 2, 301 / 458 / 3, 346 / 459 / 2, 211 / 460 / 2, 412 / 461 / 3, 305 / 462 / 2, 239 / 463 / 3, 233 / 464 / 2, 345 / 465 / 2, 178 / 466 / 2, 164 / 467 / 2, 385 / 468 / 2, 124 / 469 / 3, 4 / 470 / 2, 147 / 471 / 2, 394 / 472 / 3, 423 / 473 / 2, 452 / 474 / 3, 411 / 475 / 2, 356 / 476 / 3, 55 / 477 / 2, 5 / 478 / 3, 86 / 479 / 2, 216 / 480 / 4, 275 / 481 / 2, 459 / 482 / 2, 268 / 483 / 4, 450 / 484 / 2, 387 / 485 / 2, 262 / 486 / 2, 263 / 487 / 2, 439 / 488 / 2, 205 / 489 / 4, 363 / 490 / 2, 482 / 491 / 2, 232 / 492 / 2, 249 / 493 / 3, 279 / 494 / 2, 469 / 495 / 3, 134 / 496 / 2, 140 / 497 / 2, 478 / 498 / 4, 474 / 499 / 2
doublecenter-alpha_1-100-n100.txt, 1, 1, 100, 1993.14, 1117, 1017, 16, 99,72 / 1 / 2, 22 / 2 / 2, 57 / 3 / 2, 84 / 4 / 2, 17 / 5 / 2, 86 / 6 / 3, 47 / 7 / 2, 90 / 8 / 2, 7 / 9 / 2, 59 / 10 / 2, 29 / 11 / 2, 53 / 12 / 12, 30 / 13 / 2, 54 / 14 / 2, 52 / 15 / 2, 33 / 16 / 2, 10 / 17 / 2, 15 / 18 / 2, 4 / 19 / 4, 87 / 20 / 2, 92 / 21 / 2, 31 / 22 / 7, 91 / 23 / 2, 89 / 24 / 2, 97 / 25 / 2, 23 / 26 / 3, 19 / 27 / 2, 55 / 28 / 3, 45 / 29 / 2, 20 / 30 / 2, 80 / 31 / 2, 39 / 32 / 4, 3 / 33 / 2, 14 / 34 / 2, 67 / 35 / 4, 71 / 36 / 2, 63 / 37 / 2, 16 / 38 / 2, 88 / 39 / 2, 18 / 40 / 2, 43 / 41 / 2, 70 / 42 / 2, 99 / 43 / 8, 50 / 44 / 2, 5 / 45 / 2, 37 / 46 / 2, 58 / 47 / 2, 41 / 48 / 2, 61 / 49 / 4, 48 / 50 / 2, 12 / 51 / 3, 79 / 52 / 2, 21 / 53 / 2, 13 / 54 / 2, 51 / 55 / 2, 94 / 56 / 2, 36 / 57 / 3, 32 / 58 / 2, 68 / 59 / 3, 96 / 60 / 2, 38 / 61 / 2, 42 / 62 / 2, 69 / 63 / 3, 93 / 64 / 2, 98 / 65 / 2, 82 / 66 / 3, 78 / 67 / 2, 9 / 68 / 3, 49 / 69 / 2, 85 / 70 / 3, 95 / 71 / 2, 60 / 72 / 3, 64 / 73 / 2, 83 / 74 / 2, 40 / 75 / 3, 35 / 76 / 2, 66 / 77 / 3, 26 / 78 / 2, 11 / 79 / 2, 76 / 80 / 2, 56 / 81 / 6, 74 / 82 / 2, 46 / 83 / 2, 65 / 84 / 2, 27 / 85 / 2, 28 / 86 / 2, 77 / 87 / 2, 81 / 88 / 2, 25 / 89 / 2, 1 / 90 / 2, 44 / 91 / 2, 6 / 92 / 2, 73 / 93 / 2, 24 / 94 / 2, 8 / 95 / 2, 62 / 96 / 16, 2 / 97 / 2, 34 / 98 / 2, 75 / 99 / 3
doublecenter-alpha_1-101-n175.txt, 1, 1, 175, 2293.81, 1333, 1158, 8, 174,3 / 1 / 3, 49 / 2 / 2, 142 / 3 / 2, 17 / 4 / 2, 103 / 5 / 2, 123 / 6 / 3, 165 / 7 / 2, 47 / 8 / 3, 39 / 9 / 2, 36 / 10 / 2, 65 / 11 / 5, 148 / 12 / 2, 72 / 13 / 2, 54 / 14 / 2, 4 / 15 / 2, 76 / 16 / 2, 95 / 17 / 2, 99 / 18 / 3, 51 / 19 / 2, 139 / 20 / 2, 50 / 21 / 2, 149 / 22 / 2, 66 / 23 / 2, 70 / 24 / 2, 146 / 25 / 4, 43 / 26 / 2, 116 / 27 / 2, 83 / 28 / 2, 171 / 29 / 2, 37 / 30 / 2, 119 / 31 / 2, 120 / 32 / 2, 124 / 33 / 3, 153 / 34 / 2, 77 / 35 / 3, 91 / 36 / 2, 11 / 37 / 2, 169 / 38 / 2, 41 / 39 / 2, 87 / 40 / 2, 68 / 41 / 3, 131 / 42 / 2, 156 / 43 / 6, 94 / 44 / 2, 42 / 45 / 2, 8 / 46 / 2, 45 / 47 / 2, 85 / 48 / 2, 67 / 49 / 5, 2 / 50 / 2, 115 / 51 / 3, 84 / 52 / 2, 33 / 53 / 2, 114 / 54 / 3, 96 / 55 / 2, 13 / 56 / 2, 113 / 57 / 2, 162 / 58 / 2, 31 / 59 / 3, 154 / 60 / 2, 15 / 61 / 4, 55 / 62 / 2, 22 / 63 / 2, 107 / 64 / 2, 132 / 65 / 3, 108 / 66 / 2, 82 / 67 / 3, 104 / 68 / 2, 135 / 69 / 2, 1 / 70 / 2, 168 / 71 / 2, 20 / 72 / 5, 122 / 73 / 2, 27 / 74 / 2, 80 / 75 / 3, 57 / 76 / 2, 88 / 77 / 4, 129 / 78 / 2, 127 / 79 / 2, 170 / 80 / 2, 23 / 81 / 2, 24 / 82 / 4, 18 / 83 / 2, 26 / 84 / 2, 75 / 85 / 2, 128 / 86 / 4, 160 / 87 / 2, 86 / 88 / 2, 74 / 89 / 2, 48 / 90 / 3, 157 / 91 / 2, 12 / 92 / 2, 73 / 93 / 3, 35 / 94 / 2, 19 / 95 / 3, 89 / 96 / 2, 6 / 97 / 2, 106 / 98 / 5, 7 / 99 / 2, 158 / 100 / 3, 78 / 101 / 2, 167 / 102 / 2, 151 / 103 / 4, 121 / 104 / 2, 144 / 105 / 2, 145 / 106 / 2, 172 / 107 / 3, 34 / 108 / 2, 30 / 109 / 2, 136 / 110 / 2, 137 / 111 / 5, 150 / 112 / 2, 152 / 113 / 3, 10 / 114 / 2, 53 / 115 / 3, 105 / 116 / 2, 110 / 117 / 2, 111 / 118 / 2, 130 / 119 / 2, 5 / 120 / 2, 25 / 121 / 2, 81 / 122 / 4, 163 / 123 / 2, 155 / 124 / 2, 117 / 125 / 2, 174 / 126 / 5, 97 / 127 / 2, 16 / 128 / 2, 141 / 129 / 2, 161 / 130 / 2, 71 / 131 / 2, 79 / 132 / 2, 46 / 133 / 2, 125 / 134 / 2, 159 / 135 / 2, 166 / 136 / 2, 98 / 137 / 3, 126 / 138 / 2, 64 / 139 / 3, 58 / 140 / 2, 60 / 141 / 2, 59 / 142 / 2, 147 / 143 / 3, 90 / 144 / 2, 118 / 145 / 2, 52 / 146 / 3, 164 / 147 / 2, 100 / 148 / 3, 93 / 149 / 2, 112 / 150 / 2, 61 / 151 / 2, 44 / 152 / 2, 38 / 153 / 2, 40 / 154 / 2, 32 / 155 / 2, 21 / 156 / 2, 140 / 157 / 2, 62 / 158 / 2, 92 / 159 / 3, 63 / 160 / 2, 109 / 161 / 2, 102 / 162 / 3, 138 / 163 / 2, 56 / 164 / 3, 9 / 165 / 2, 101 / 166 / 3, 134 / 167 / 2, 14 / 168 / 3, 173 / 169 / 2, 143 / 170 / 2, 69 / 171 / 2, 29 / 172 / 2, 28 / 173 / 8, 133 / 174 / 2
doublecenter-alpha_1-102-n175.txt, 1, 1, 175, 2638.29, 1446, 1271, 10, 174,169 / 1 / 6, 41 / 2 / 2, 52 / 3 / 2, 164 / 4 / 4, 16 / 5 / 2, 167 / 6 / 2, 159 / 7 / 4, 22 / 8 / 2, 34 / 9 / 2, 6 / 10 / 4, 128 / 11 / 2, 119 / 12 / 3, 50 / 13 / 2, 136 / 14 / 2, 148 / 15 / 2, 33 / 16 / 2, 2 / 17 / 4, 44 / 18 / 2, 117 / 19 / 2, 172 / 20 / 4, 56 / 21 / 2, 133 / 22 / 2, 63 / 23 / 3, 91 / 24 / 2, 126 / 25 / 3, 3 / 26 / 2, 106 / 27 / 2, 132 / 28 / 3, 102 / 29 / 2, 141 / 30 / 3, 74 / 31 / 2, 99 / 32 / 2, 103 / 33 / 2, 115 / 34 / 2, 80 / 35 / 3, 71 / 36 / 2, 173 / 37 / 5, 59 / 38 / 2, 32 / 39 / 2, 143 / 40 / 2, 13 / 41 / 4, 84 / 42 / 2, 39 / 43 / 2, 110 / 44 / 6, 111 / 45 / 2, 138 / 46 / 2, 69 / 47 / 2, 8 / 48 / 2, 123 / 49 / 3, 51 / 50 / 2, 47 / 51 / 2, 62 / 52 / 3, 147 / 53 / 2, 37 / 54 / 4, 131 / 55 / 2, 1 / 56 / 2, 174 / 57 / 4, 130 / 58 / 2, 38 / 59 / 2, 29 / 60 / 2, 19 / 61 / 2, 5 / 62 / 3, 121 / 63 / 2, 144 / 64 / 2, 42 / 65 / 3, 11 / 66 / 2, 149 / 67 / 2, 96 / 68 / 3, 137 / 69 / 2, 58 / 70 / 3, 86 / 71 / 2, 104 / 72 / 2, 12 / 73 / 3, 46 / 74 / 2, 9 / 75 / 2, 24 / 76 / 2, 156 / 77 / 3, 171 / 78 / 2, 28 / 79 / 5, 85 / 80 / 2, 76 / 81 / 2, 72 / 82 / 2, 107 / 83 / 5, 27 / 84 / 2, 79 / 85 / 2, 65 / 86 / 2, 125 / 87 / 2, 61 / 88 / 4, 7 / 89 / 2, 97 / 90 / 2, 163 / 91 / 2, 120 / 92 / 10, 155 / 93 / 2, 31 / 94 / 2, 161 / 95 / 2, 108 / 96 / 3, 64 / 97 / 2, 30 / 98 / 3, 135 / 99 / 2, 77 / 100 / 2, 81 / 101 / 2, 152 / 102 / 2, 158 / 103 / 4, 90 / 104 / 2, 116 / 105 / 3, 93 / 106 / 2, 166 / 107 / 3, 134 / 108 / 2, 122 / 109 / 3, 17 / 110 / 2, 55 / 111 / 3, 127 / 112 / 2, 146 / 113 / 2, 40 / 114 / 4, 60 / 115 / 2, 73 / 116 / 2, 10 / 117 / 3, 151 / 118 / 2, 100 / 119 / 2, 35 / 120 / 4, 170 / 121 / 2, 112 / 122 / 2, 48 / 123 / 2, 94 / 124 / 3, 36 / 125 / 2, 105 / 126 / 3, 98 / 127 / 2, 101 / 128 / 2, 82 / 129 / 2, 53 / 130 / 3, 21 / 131 / 2, 92 / 132 / 2, 168 / 133 / 2, 78 / 134 / 2, 18 / 135 / 2, 88 / 136 / 3, 70 / 137 / 2, 15 / 138 / 2, 43 / 139 / 2, 129 / 140 / 3, 160 / 141 / 2, 4 / 142 / 3, 139 / 143 / 2, 154 / 144 / 2, 26 / 145 / 4, 14 / 146 / 2, 57 / 147 / 2, 157 / 148 / 3, 145 / 149 / 2, 67 / 150 / 2, 49 / 151 / 2, 140 / 152 / 2, 87 / 153 / 3, 124 / 154 / 2, 113 / 155 / 2, 83 / 156 / 3, 66 / 157 / 2, 165 / 158 / 3, 95 / 159 / 2, 109 / 160 / 2, 75 / 161 / 2, 25 / 162 / 4, 89 / 163 / 2, 45 / 164 / 3, 20 / 165 / 2, 162 / 166 / 3, 23 / 167 / 2, 68 / 168 / 3, 114 / 169 / 2, 153 / 170 / 4, 54 / 171 / 2, 118 / 172 / 2, 150 / 173 / 2, 142 / 174 / 5
doublecenter-alpha_1-103-n175.txt, 1, 1, 175, 2551.86, 1366, 1191, 7, 174,15 / 1 / 2, 109 / 2 / 3, 143 / 3 / 2, 135 / 4 / 2, 152 / 5 / 3, 73 / 6 / 2, 150 / 7 / 2, 121 / 8 / 4, 136 / 9 / 2, 114 / 10 / 2, 7 / 11 / 2, 3 / 12 / 3, 163 / 13 / 2, 129 / 14 / 5, 38 / 15 / 2, 83 / 16 / 2, 145 / 17 / 2, 130 / 18 / 2, 137 / 19 / 3, 147 / 20 / 2, 59 / 21 / 2, 76 / 22 / 2, 26 / 23 / 2, 35 / 24 / 2, 99 / 25 / 2, 74 / 26 / 2, 43 / 27 / 2, 117 / 28 / 3, 169 / 29 / 2, 171 / 30 / 3, 49 / 31 / 2, 14 / 32 / 3, 84 / 33 / 2, 69 / 34 / 3, 93 / 35 / 2, 44 / 36 / 2, 81 / 37 / 3, 2 / 38 / 2, 103 / 39 / 3, 77 / 40 / 2, 80 / 41 / 2, 63 / 42 / 2, 13 / 43 / 2, 90 / 44 / 4, 118 / 45 / 2, 168 / 46 / 2, 29 / 47 / 3, 154 / 48 / 2, 30 / 49 / 2, 131 / 50 / 3, 36 / 51 / 2, 173 / 52 / 2, 92 / 53 / 3, 5 / 54 / 2, 64 / 55 / 2, 41 / 56 / 2, 39 / 57 / 3, 167 / 58 / 2, 104 / 59 / 2, 28 / 60 / 3, 72 / 61 / 2, 32 / 62 / 2, 162 / 63 / 4, 115 / 64 / 2, 85 / 65 / 2, 21 / 66 / 4, 110 / 67 / 2, 159 / 68 / 2, 65 / 69 / 2, 47 / 70 / 2, 133 / 71 / 2, 138 / 72 / 2, 40 / 73 / 2, 142 / 74 / 2, 9 / 75 / 3, 111 / 76 / 2, 79 / 77 / 3, 45 / 78 / 2, 20 / 79 / 3, 23 / 80 / 2, 22 / 81 / 3, 126 / 82 / 2, 17 / 83 / 3, 151 / 84 / 2, 122 / 85 / 3, 66 / 86 / 2, 134 / 87 / 2, 82 / 88 / 2, 58 / 89 / 2, 19 / 90 / 2, 116 / 91 / 2, 96 / 92 / 3, 55 / 93 / 2, 102 / 94 / 2, 25 / 95 / 2, 75 / 96 / 3, 157 / 97 / 2, 89 / 98 / 7, 141 / 99 / 2, 60 / 100 / 2, 119 / 101 / 2, 140 / 102 / 2, 100 / 103 / 2, 18 / 104 / 2, 170 / 105 / 2, 37 / 106 / 2, 10 / 107 / 2, 27 / 108 / 2, 139 / 109 / 2, 48 / 110 / 6, 87 / 111 / 2, 94 / 112 / 2, 1 / 113 / 3, 11 / 114 / 2, 146 / 115 / 2, 53 / 116 / 2, 70 / 117 / 2, 68 / 118 / 2, 33 / 119 / 2, 88 / 120 / 2, 52 / 121 / 3, 46 / 122 / 2, 112 / 123 / 2, 107 / 124 / 2, 71 / 125 / 2, 31 / 126 / 2, 105 / 127 / 4, 164 / 128 / 2, 97 / 129 / 2, 144 / 130 / 2, 156 / 131 / 2, 125 / 132 / 2, 16 / 133 / 3, 51 / 134 / 2, 78 / 135 / 3, 91 / 136 / 2, 6 / 137 / 2, 24 / 138 / 5, 4 / 139 / 2, 57 / 140 / 3, 54 / 141 / 2, 67 / 142 / 2, 132 / 143 / 4, 127 / 144 / 2, 153 / 145 / 3, 172 / 146 / 2, 124 / 147 / 3, 12 / 148 / 2, 34 / 149 / 2, 148 / 150 / 2, 8 / 151 / 2, 98 / 152 / 2, 174 / 153 / 4, 95 / 154 / 2, 158 / 155 / 2, 155 / 156 / 4, 160 / 157 / 2, 165 / 158 / 2, 128 / 159 / 4, 149 / 160 / 2, 161 / 161 / 2, 42 / 162 / 6, 101 / 163 / 2, 61 / 164 / 2, 86 / 165 / 2, 62 / 166 / 2, 113 / 167 / 2, 50 / 168 / 2, 106 / 169 / 2, 166 / 170 / 3, 120 / 171 / 2, 108 / 172 / 2, 56 / 173 / 4, 123 / 174 / 2
doublecenter-alpha_1-104-n175.txt, 1, 1, 175, 2517.16, 1478, 1303, 7, 174,77 / 1 / 2, 87 / 2 / 2, 24 / 3 / 4, 75 / 4 / 2, 3 / 5 / 2, 95 / 6 / 2, 67 / 7 / 5, 8 / 8 / 2, 44 / 9 / 2, 15 / 10 / 3, 93 / 11 / 2, 22 / 12 / 2, 164 / 13 / 2, 83 / 14 / 2, 156 / 15 / 4, 5 / 16 / 2, 100 / 17 / 2, 34 / 18 / 3, 49 / 19 / 2, 135 / 20 / 2, 17 / 21 / 7, 14 / 22 / 2, 153 / 23 / 3, 35 / 24 / 2, 96 / 25 / 2, 113 / 26 / 3, 57 / 27 / 2, 63 / 28 / 3, 29 / 29 / 2, 2 / 30 / 2, 97 / 31 / 3, 71 / 32 / 2, 129 / 33 / 2, 147 / 34 / 2, 38 / 35 / 2, 69 / 36 / 5, 105 / 37 / 2, 27 / 38 / 3, 106 / 39 / 2, 142 / 40 / 3, 94 / 41 / 2, 10 / 42 / 2, 12 / 43 / 2, 125 / 44 / 2, 88 / 45 / 3, 30 / 46 / 2, 25 / 47 / 3, 136 / 48 / 2, 144 / 49 / 2, 131 / 50 / 2, 39 / 51 / 2, 43 / 52 / 2, 157 / 53 / 3, 85 / 54 / 2, 53 / 55 / 3, 146 / 56 / 2, 52 / 57 / 3, 79 / 58 / 2, 149 / 59 / 3, 154 / 60 / 2, 66 / 61 / 2, 102 / 62 / 2, 55 / 63 / 2, 161 / 64 / 2, 78 / 65 / 2, 159 / 66 / 2, 119 / 67 / 3, 86 / 68 / 2, 82 / 69 / 2, 89 / 70 / 6, 32 / 71 / 2, 61 / 72 / 2, 121 / 73 / 2, 11 / 74 / 2, 58 / 75 / 2, 122 / 76 / 2, 158 / 77 / 2, 21 / 78 / 2, 50 / 79 / 2, 155 / 80 / 3, 92 / 81 / 2, 4 / 82 / 3, 108 / 83 / 2, 62 / 84 / 2, 26 / 85 / 2, 112 / 86 / 3, 99 / 87 / 2, 45 / 88 / 2, 109 / 89 / 2, 124 / 90 / 2, 141 / 91 / 2, 116 / 92 / 2, 72 / 93 / 2, 9 / 94 / 2, 46 / 95 / 2, 139 / 96 / 2, 81 / 97 / 2, 70 / 98 / 5, 68 / 99 / 2, 103 / 100 / 2, 128 / 101 / 2, 134 / 102 / 3, 13 / 103 / 2, 33 / 104 / 3, 40 / 105 / 2, 171 / 106 / 2, 115 / 107 / 2, 23 / 108 / 4, 117 / 109 / 2, 138 / 110 / 2, 64 / 111 / 2, 7 / 112 / 2, 162 / 113 / 2, 150 / 114 / 2, 47 / 115 / 2, 56 / 116 / 2, 167 / 117 / 2, 84 / 118 / 2, 31 / 119 / 2, 73 / 120 / 2, 168 / 121 / 2, 90 / 122 / 4, 104 / 123 / 2, 148 / 124 / 3, 123 / 125 / 2, 54 / 126 / 2, 41 / 127 / 4, 1 / 128 / 2, 152 / 129 / 2, 165 / 130 / 2, 42 / 131 / 2, 140 / 132 / 2, 127 / 133 / 3, 132 / 134 / 2, 130 / 135 / 3, 160 / 136 / 2, 145 / 137 / 3, 137 / 138 / 2, 110 / 139 / 3, 20 / 140 / 2, 80 / 141 / 2, 76 / 142 / 3, 60 / 143 / 2, 166 / 144 / 2, 174 / 145 / 2, 133 / 146 / 2, 74 / 147 / 2, 98 / 148 / 2, 6 / 149 / 3, 36 / 150 / 2, 16 / 151 / 2, 126 / 152 / 2, 65 / 153 / 3, 170 / 154 / 2, 114 / 155 / 2, 173 / 156 / 3, 59 / 157 / 2, 48 / 158 / 2, 169 / 159 / 6, 91 / 160 / 2, 172 / 161 / 2, 19 / 162 / 2, 120 / 163 / 2, 37 / 164 / 2, 107 / 165 / 2, 101 / 166 / 2, 143 / 167 / 2, 151 / 168 / 2, 51 / 169 / 2, 163 / 170 / 2, 28 / 171 / 2, 118 / 172 / 3, 18 / 173 / 2, 111 / 174 / 5
doublecenter-alpha_1-105-n175.txt, 1, 1, 175, 2713.17, 1433, 1258, 6, 174,118 / 1 / 2, 1 / 2 / 3, 169 / 3 / 2, 10 / 4 / 3, 150 / 5 / 2, 72 / 6 / 2, 93 / 7 / 4, 101 / 8 / 2, 80 / 9 / 2, 47 / 10 / 3, 67 / 11 / 2, 62 / 12 / 2, 120 / 13 / 2, 149 / 14 / 5, 21 / 15 / 2, 59 / 16 / 2, 58 / 17 / 2, 113 / 18 / 3, 40 / 19 / 2, 3 / 20 / 2, 134 / 21 / 4, 77 / 22 / 2, 37 / 23 / 2, 121 / 24 / 3, 82 / 25 / 2, 132 / 26 / 2, 29 / 27 / 5, 174 / 28 / 2, 164 / 29 / 2, 81 / 30 / 2, 162 / 31 / 5, 97 / 32 / 2, 171 / 33 / 2, 15 / 34 / 3, 114 / 35 / 2, 172 / 36 / 3, 91 / 37 / 2, 153 / 38 / 5, 14 / 39 / 2, 94 / 40 / 2, 38 / 41 / 3, 92 / 42 / 2, 135 / 43 / 2, 43 / 44 / 2, 119 / 45 / 2, 154 / 46 / 2, 33 / 47 / 2, 26 / 48 / 2, 146 / 49 / 4, 166 / 50 / 2, 157 / 51 / 2, 8 / 52 / 2, 49 / 53 / 2, 63 / 54 / 2, 137 / 55 / 2, 140 / 56 / 2, 76 / 57 / 3, 165 / 58 / 2, 125 / 59 / 2, 71 / 60 / 3, 60 / 61 / 2, 41 / 62 / 2, 45 / 63 / 3, 90 / 64 / 2, 42 / 65 / 6, 31 / 66 / 2, 79 / 67 / 2, 110 / 68 / 3, 141 / 69 / 2, 104 / 70 / 4, 51 / 71 / 2, 102 / 72 / 2, 69 / 73 / 2, 16 / 74 / 3, 98 / 75 / 2, 32 / 76 / 3, 54 / 77 / 2, 87 / 78 / 2, 103 / 79 / 2, 168 / 80 / 2, 4 / 81 / 2, 129 / 82 / 2, 143 / 83 / 3, 160 / 84 / 2, 126 / 85 / 3, 18 / 86 / 2, 2 / 87 / 2, 88 / 88 / 2, 136 / 89 / 2, 57 / 90 / 2, 109 / 91 / 2, 34 / 92 / 2, 159 / 93 / 3, 151 / 94 / 2, 30 / 95 / 4, 128 / 96 / 2, 161 / 97 / 2, 148 / 98 / 3, 167 / 99 / 2, 85 / 100 / 2, 89 / 101 / 3, 23 / 102 / 2, 144 / 103 / 2, 9 / 104 / 3, 46 / 105 / 2, 75 / 106 / 2, 64 / 107 / 3, 100 / 108 / 2, 111 / 109 / 2, 24 / 110 / 2, 20 / 111 / 2, 66 / 112 / 3, 17 / 113 / 2, 39 / 114 / 2, 123 / 115 / 2, 95 / 116 / 3, 19 / 117 / 2, 107 / 118 / 6, 50 / 119 / 2, 156 / 120 / 3, 133 / 121 / 2, 27 / 122 / 3, 173 / 123 / 2, 170 / 124 / 3, 112 / 125 / 2, 7 / 126 / 2, 122 / 127 / 5, 11 / 128 / 2, 22 / 129 / 3, 56 / 130 / 2, 44 / 131 / 2, 78 / 132 / 3, 163 / 133 / 2, 115 / 134 / 3, 108 / 135 / 2, 6 / 136 / 3, 13 / 137 / 2, 68 / 138 / 2, 147 / 139 / 2, 70 / 140 / 2, 36 / 141 / 4, 96 / 142 / 2, 155 / 143 / 2, 25 / 144 / 2, 83 / 145 / 2, 127 / 146 / 4, 152 / 147 / 2, 73 / 148 / 2, 86 / 149 / 2, 84 / 150 / 2, 61 / 151 / 2, 74 / 152 / 2, 5 / 153 / 4, 116 / 154 / 2, 48 / 155 / 3, 53 / 156 / 2, 130 / 157 / 2, 105 / 158 / 4, 106 / 159 / 2, 145 / 160 / 2, 131 / 161 / 2, 138 / 162 / 2, 12 / 163 / 2, 124 / 164 / 2, 65 / 165 / 3, 99 / 166 / 2, 52 / 167 / 2, 55 / 168 / 2, 117 / 169 / 2, 139 / 170 / 3, 158 / 171 / 2, 35 / 172 / 2, 28 / 173 / 2, 142 / 174 / 4
doublecenter-alpha_1-106-n175.txt, 1, 1, 175, 2942.75, 1373, 1198, 6, 174,58 / 1 / 2, 166 / 2 / 4, 109 / 3 / 2, 44 / 4 / 2, 75 / 5 / 2, 132 / 6 / 2, 41 / 7 / 2, 22 / 8 / 2, 136 / 9 / 2, 18 / 10 / 3, 117 / 11 / 2, 102 / 12 / 3, 96 / 13 / 2, 87 / 14 / 2, 25 / 15 / 5, 95 / 16 / 2, 129 / 17 / 2, 110 / 18 / 2, 169 / 19 / 3, 68 / 20 / 2, 93 / 21 / 4, 81 / 22 / 2, 78 / 23 / 3, 28 / 24 / 2, 39 / 25 / 2, 115 / 26 / 4, 35 / 27 / 2, 26 / 28 / 2, 59 / 29 / 2, 48 / 30 / 2, 160 / 31 / 3, 170 / 32 / 2, 5 / 33 / 6, 121 / 34 / 2, 172 / 35 / 2, 84 / 36 / 2, 40 / 37 / 2, 89 / 38 / 2, 167 / 39 / 2, 16 / 40 / 3, 46 / 41 / 2, 138 / 42 / 4, 148 / 43 / 2, 34 / 44 / 2, 72 / 45 / 3, 80 / 46 / 2, 38 / 47 / 2, 137 / 48 / 2, 105 / 49 / 6, 2 / 50 / 2, 69 / 51 / 2, 98 / 52 / 3, 162 / 53 / 2, 36 / 54 / 2, 60 / 55 / 4, 114 / 56 / 2, 173 / 57 / 2, 23 / 58 / 4, 116 / 59 / 2, 82 / 60 / 2, 14 / 61 / 2, 99 / 62 / 2, 24 / 63 / 2, 142 / 64 / 2, 124 / 65 / 2, 111 / 66 / 2, 32 / 67 / 5, 1 / 68 / 2, 56 / 69 / 3, 90 / 70 / 2, 97 / 71 / 2, 103 / 72 / 2, 119 / 73 / 2, 77 / 74 / 2, 145 / 75 / 3, 6 / 76 / 2, 153 / 77 / 2, 94 / 78 / 4, 130 / 79 / 2, 20 / 80 / 2, 57 / 81 / 2, 139 / 82 / 2, 85 / 83 / 4, 112 / 84 / 2, 150 / 85 / 2, 118 / 86 / 2, 62 / 87 / 2, 100 / 88 / 2, 33 / 89 / 3, 27 / 90 / 2, 61 / 91 / 3, 123 / 92 / 2, 7 / 93 / 4, 30 / 94 / 2, 141 / 95 / 2, 63 / 96 / 2, 122 / 97 / 3, 83 / 98 / 2, 12 / 99 / 2, 135 / 100 / 6, 47 / 101 / 2, 3 / 102 / 3, 144 / 103 / 2, 53 / 104 / 2, 155 / 105 / 3, 74 / 106 / 2, 126 / 107 / 2, 88 / 108 / 2, 131 / 109 / 4, 65 / 110 / 2, 52 / 111 / 2, 125 / 112 / 3, 42 / 113 / 2, 171 / 114 / 2, 15 / 115 / 2, 143 / 116 / 4, 86 / 117 / 2, 107 / 118 / 2, 71 / 119 / 4, 101 / 120 / 2, 70 / 121 / 3, 120 / 122 / 2, 157 / 123 / 2, 13 / 124 / 2, 146 / 125 / 2, 10 / 126 / 4, 21 / 127 / 2, 11 / 128 / 2, 133 / 129 / 2, 9 / 130 / 3, 50 / 131 / 2, 51 / 132 / 2, 134 / 133 / 3, 127 / 134 / 2, 67 / 135 / 2, 79 / 136 / 2, 165 / 137 / 2, 174 / 138 / 2, 156 / 139 / 2, 55 / 140 / 3, 159 / 141 / 2, 163 / 142 / 2, 168 / 143 / 2, 92 / 144 / 3, 164 / 145 / 2, 37 / 146 / 3, 54 / 147 / 2, 158 / 148 / 3, 64 / 149 / 2, 29 / 150 / 2, 128 / 151 / 2, 91 / 152 / 2, 76 / 153 / 3, 147 / 154 / 2, 45 / 155 / 3, 152 / 156 / 2, 108 / 157 / 2, 19 / 158 / 2, 8 / 159 / 2, 106 / 160 / 5, 151 / 161 / 2, 31 / 162 / 2, 140 / 163 / 2, 4 / 164 / 4, 113 / 165 / 2, 66 / 166 / 3, 154 / 167 / 2, 17 / 168 / 2, 149 / 169 / 3, 104 / 170 / 2, 43 / 171 / 2, 49 / 172 / 2, 161 / 173 / 2, 73 / 174 / 3
doublecenter-alpha_1-107-n175.txt, 1, 1, 175, 2656.05, 1552, 1377, 10, 174,2 / 1 / 4, 50 / 2 / 2, 83 / 3 / 3, 129 / 4 / 2, 97 / 5 / 2, 166 / 6 / 4, 108 / 7 / 2, 136 / 8 / 2, 164 / 9 / 2, 159 / 10 / 2, 71 / 11 / 2, 91 / 12 / 4, 115 / 13 / 2, 163 / 14 / 2, 145 / 15 / 2, 142 / 16 / 2, 63 / 17 / 2, 33 / 18 / 2, 148 / 19 / 3, 96 / 20 / 2, 102 / 21 / 2, 99 / 22 / 3, 74 / 23 / 2, 64 / 24 / 2, 56 / 25 / 3, 122 / 26 / 2, 16 / 27 / 4, 12 / 28 / 2, 9 / 29 / 2, 116 / 30 / 3, 174 / 31 / 2, 14 / 32 / 2, 32 / 33 / 3, 78 / 34 / 2, 117 / 35 / 2, 143 / 36 / 5, 22 / 37 / 2, 48 / 38 / 2, 25 / 39 / 3, 100 / 40 / 2, 149 / 41 / 5, 121 / 42 / 2, 42 / 43 / 3, 43 / 44 / 2, 124 / 45 / 3, 170 / 46 / 2, 70 / 47 / 2, 141 / 48 / 2, 53 / 49 / 2, 173 / 50 / 2, 144 / 51 / 2, 62 / 52 / 2, 7 / 53 / 3, 133 / 54 / 2, 37 / 55 / 2, 21 / 56 / 3, 39 / 57 / 2, 167 / 58 / 2, 67 / 59 / 3, 162 / 60 / 2, 172 / 61 / 3, 154 / 62 / 2, 84 / 63 / 2, 147 / 64 / 2, 130 / 65 / 6, 90 / 66 / 2, 165 / 67 / 2, 68 / 68 / 2, 15 / 69 / 2, 73 / 70 / 2, 138 / 71 / 2, 113 / 72 / 5, 146 / 73 / 2, 13 / 74 / 2, 44 / 75 / 2, 3 / 76 / 3, 81 / 77 / 2, 59 / 78 / 3, 76 / 79 / 2, 158 / 80 / 2, 65 / 81 / 3, 47 / 82 / 2, 105 / 83 / 2, 85 / 84 / 2, 171 / 85 / 2, 20 / 86 / 3, 51 / 87 / 2, 77 / 88 / 2, 150 / 89 / 2, 168 / 90 / 3, 79 / 91 / 2, 82 / 92 / 3, 132 / 93 / 2, 31 / 94 / 2, 57 / 95 / 3, 30 / 96 / 2, 18 / 97 / 2, 86 / 98 / 4, 45 / 99 / 2, 137 / 100 / 2, 88 / 101 / 2, 29 / 102 / 4, 40 / 103 / 2, 156 / 104 / 2, 26 / 105 / 4, 54 / 106 / 2, 118 / 107 / 2, 35 / 108 / 2, 27 / 109 / 4, 46 / 110 / 2, 161 / 111 / 2, 66 / 112 / 2, 10 / 113 / 2, 80 / 114 / 2, 41 / 115 / 2, 153 / 116 / 3, 60 / 117 / 2, 1 / 118 / 2, 92 / 119 / 2, 157 / 120 / 10, 23 / 121 / 2, 119 / 122 / 3, 169 / 123 / 2, 24 / 124 / 3, 58 / 125 / 2, 152 / 126 / 4, 114 / 127 / 2, 4 / 128 / 2, 112 / 129 / 2, 160 / 130 / 4, 101 / 131 / 2, 93 / 132 / 2, 36 / 133 / 6, 61 / 134 / 2, 111 / 135 / 2, 128 / 136 / 2, 28 / 137 / 2, 87 / 138 / 2, 126 / 139 / 4, 95 / 140 / 2, 11 / 141 / 2, 134 / 142 / 2, 131 / 143 / 3, 135 / 144 / 2, 69 / 145 / 3, 19 / 146 / 2, 120 / 147 / 3, 109 / 148 / 2, 106 / 149 / 3, 34 / 150 / 2, 94 / 151 / 3, 107 / 152 / 2, 125 / 153 / 2, 6 / 154 / 3, 89 / 155 / 2, 98 / 156 / 4, 139 / 157 / 2, 151 / 158 / 2, 17 / 159 / 2, 49 / 160 / 3, 75 / 161 / 2, 127 / 162 / 3, 110 / 163 / 2, 38 / 164 / 2, 52 / 165 / 2, 140 / 166 / 3, 155 / 167 / 2, 104 / 168 / 4, 5 / 169 / 2, 8 / 170 / 3, 55 / 171 / 2, 103 / 172 / 5, 72 / 173 / 2, 123 / 174 / 2
doublecenter-alpha_1-108-n175.txt, 1, 1, 175, 2528.05, 1508, 1333, 9, 174,10 / 1 / 2, 140 / 2 / 3, 58 / 3 / 2, 81 / 4 / 2, 118 / 5 / 2, 17 / 6 / 2, 6 / 7 / 3, 72 / 8 / 2, 93 / 9 / 2, 31 / 10 / 2, 1 / 11 / 2, 94 / 12 / 2, 151 / 13 / 2, 14 / 14 / 4, 3 / 15 / 2, 129 / 16 / 2, 61 / 17 / 2, 80 / 18 / 2, 126 / 19 / 2, 134 / 20 / 2, 57 / 21 / 2, 50 / 22 / 2, 163 / 23 / 3, 52 / 24 / 2, 174 / 25 / 4, 135 / 26 / 2, 86 / 27 / 2, 149 / 28 / 2, 101 / 29 / 3, 161 / 30 / 2, 137 / 31 / 3, 154 / 32 / 2, 124 / 33 / 2, 116 / 34 / 2, 150 / 35 / 3, 103 / 36 / 2, 160 / 37 / 3, 35 / 38 / 2, 173 / 39 / 2, 55 / 40 / 2, 59 / 41 / 2, 49 / 42 / 2, 20 / 43 / 2, 51 / 44 / 2, 22 / 45 / 2, 144 / 46 / 4, 99 / 47 / 2, 69 / 48 / 2, 19 / 49 / 4, 127 / 50 / 2, 13 / 51 / 2, 45 / 52 / 2, 25 / 53 / 2, 148 / 54 / 3, 76 / 55 / 2, 77 / 56 / 2, 117 / 57 / 2, 43 / 58 / 2, 47 / 59 / 2, 164 / 60 / 2, 168 / 61 / 2, 91 / 62 / 2, 62 / 63 / 2, 90 / 64 / 2, 12 / 65 / 6, 158 / 66 / 2, 92 / 67 / 2, 27 / 68 / 3, 37 / 69 / 2, 71 / 70 / 3, 110 / 71 / 2, 115 / 72 / 2, 96 / 73 / 2, 98 / 74 / 3, 2 / 75 / 2, 104 / 76 / 3, 152 / 77 / 2, 123 / 78 / 2, 87 / 79 / 3, 89 / 80 / 2, 9 / 81 / 3, 108 / 82 / 2, 167 / 83 / 2, 42 / 84 / 5, 145 / 85 / 2, 165 / 86 / 2, 136 / 87 / 2, 170 / 88 / 9, 5 / 89 / 2, 16 / 90 / 2, 11 / 91 / 2, 146 / 92 / 2, 171 / 93 / 3, 111 / 94 / 2, 121 / 95 / 3, 138 / 96 / 2, 32 / 97 / 3, 23 / 98 / 2, 102 / 99 / 3, 40 / 100 / 2, 38 / 101 / 3, 125 / 102 / 2, 75 / 103 / 3, 48 / 104 / 2, 83 / 105 / 4, 122 / 106 / 2, 166 / 107 / 2, 172 / 108 / 2, 78 / 109 / 2, 130 / 110 / 3, 28 / 111 / 2, 4 / 112 / 2, 113 / 113 / 3, 100 / 114 / 2, 64 / 115 / 2, 54 / 116 / 2, 153 / 117 / 2, 18 / 118 / 2, 24 / 119 / 2, 147 / 120 / 2, 85 / 121 / 3, 157 / 122 / 2, 39 / 123 / 2, 56 / 124 / 4, 155 / 125 / 2, 36 / 126 / 2, 73 / 127 / 4, 46 / 128 / 2, 119 / 129 / 3, 15 / 130 / 2, 29 / 131 / 2, 141 / 132 / 6, 8 / 133 / 2, 107 / 134 / 2, 65 / 135 / 2, 114 / 136 / 2, 162 / 137 / 3, 112 / 138 / 2, 34 / 139 / 5, 60 / 140 / 2, 97 / 141 / 2, 70 / 142 / 2, 21 / 143 / 3, 128 / 144 / 2, 63 / 145 / 2, 66 / 146 / 2, 156 / 147 / 2, 132 / 148 / 2, 139 / 149 / 2, 41 / 150 / 2, 67 / 151 / 2, 169 / 152 / 2, 105 / 153 / 2, 68 / 154 / 5, 33 / 155 / 2, 26 / 156 / 3, 82 / 157 / 2, 30 / 158 / 4, 74 / 159 / 2, 133 / 160 / 2, 7 / 161 / 2, 131 / 162 / 2, 79 / 163 / 2, 143 / 164 / 2, 88 / 165 / 2, 95 / 166 / 2, 84 / 167 / 3, 142 / 168 / 2, 44 / 169 / 3, 109 / 170 / 2, 106 / 171 / 2, 159 / 172 / 3, 120 / 173 / 2, 53 / 174 / 2
doublecenter-alpha_1-109-n175.txt, 1, 1, 175, 2545.52, 1225, 1050, 4, 174,95 / 1 / 3, 168 / 2 / 2, 158 / 3 / 3, 46 / 4 / 2, 120 / 5 / 2, 53 / 6 / 2, 79 / 7 / 3, 105 / 8 / 2, 43 / 9 / 2, 71 / 10 / 4, 38 / 11 / 2, 63 / 12 / 3, 57 / 13 / 2, 19 / 14 / 2, 44 / 15 / 2, 164 / 16 / 2, 62 / 17 / 2, 108 / 18 / 2, 60 / 19 / 2, 23 / 20 / 2, 50 / 21 / 3, 90 / 22 / 2, 114 / 23 / 3, 146 / 24 / 2, 83 / 25 / 2, 141 / 26 / 3, 151 / 27 / 2, 28 / 28 / 2, 68 / 29 / 3, 113 / 30 / 2, 94 / 31 / 4, 29 / 32 / 2, 133 / 33 / 2, 137 / 34 / 3, 102 / 35 / 2, 128 / 36 / 3, 64 / 37 / 2, 157 / 38 / 3, 54 / 39 / 2, 78 / 40 / 2, 32 / 41 / 2, 124 / 42 / 2, 174 / 43 / 3, 149 / 44 / 2, 143 / 45 / 4, 126 / 46 / 2, 84 / 47 / 2, 144 / 48 / 2, 109 / 49 / 2, 110 / 50 / 2, 142 / 51 / 3, 61 / 52 / 2, 85 / 53 / 3, 75 / 54 / 2, 172 / 55 / 3, 169 / 56 / 2, 74 / 57 / 2, 100 / 58 / 4, 96 / 59 / 2, 36 / 60 / 3, 139 / 61 / 2, 92 / 62 / 2, 170 / 63 / 2, 153 / 64 / 3, 171 / 65 / 2, 58 / 66 / 3, 156 / 67 / 2, 14 / 68 / 2, 77 / 69 / 2, 20 / 70 / 2, 27 / 71 / 4, 112 / 72 / 2, 88 / 73 / 3, 45 / 74 / 2, 117 / 75 / 3, 76 / 76 / 2, 155 / 77 / 2, 65 / 78 / 2, 104 / 79 / 2, 99 / 80 / 2, 111 / 81 / 2, 125 / 82 / 2, 26 / 83 / 2, 150 / 84 / 2, 49 / 85 / 2, 33 / 86 / 2, 129 / 87 / 2, 52 / 88 / 4, 3 / 89 / 2, 161 / 90 / 2, 1 / 91 / 2, 8 / 92 / 2, 152 / 93 / 3, 5 / 94 / 2, 41 / 95 / 3, 72 / 96 / 2, 40 / 97 / 3, 11 / 98 / 2, 9 / 99 / 2, 16 / 100 / 2, 82 / 101 / 2, 135 / 102 / 4, 13 / 103 / 2, 67 / 104 / 2, 132 / 105 / 2, 89 / 106 / 2, 6 / 107 / 4, 86 / 108 / 2, 56 / 109 / 2, 15 / 110 / 2, 4 / 111 / 4, 35 / 112 / 2, 160 / 113 / 3, 165 / 114 / 2, 140 / 115 / 2, 34 / 116 / 2, 97 / 117 / 2, 10 / 118 / 2, 18 / 119 / 3, 48 / 120 / 2, 147 / 121 / 3, 134 / 122 / 2, 122 / 123 / 3, 106 / 124 / 2, 21 / 125 / 2, 154 / 126 / 3, 167 / 127 / 2, 69 / 128 / 2, 127 / 129 / 2, 107 / 130 / 2, 103 / 131 / 3, 115 / 132 / 2, 166 / 133 / 4, 81 / 134 / 2, 116 / 135 / 3, 39 / 136 / 2, 145 / 137 / 4, 80 / 138 / 2, 163 / 139 / 2, 173 / 140 / 2, 30 / 141 / 2, 22 / 142 / 2, 130 / 143 / 3, 162 / 144 / 2, 119 / 145 / 2, 59 / 146 / 3, 37 / 147 / 2, 51 / 148 / 3, 66 / 149 / 2, 2 / 150 / 2, 47 / 151 / 3, 121 / 152 / 2, 7 / 153 / 2, 55 / 154 / 2, 12 / 155 / 4, 101 / 156 / 2, 98 / 157 / 3, 87 / 158 / 2, 136 / 159 / 3, 24 / 160 / 2, 42 / 161 / 2, 93 / 162 / 3, 25 / 163 / 2, 138 / 164 / 2, 91 / 165 / 4, 118 / 166 / 2, 131 / 167 / 2, 17 / 168 / 2, 31 / 169 / 2, 148 / 170 / 2, 123 / 171 / 4, 159 / 172 / 2, 73 / 173 / 2, 70 / 174 / 4
doublecenter-alpha_1-11-n375.txt, 1, 1, 375, 3642.51, 2895, 2520, 7, 374,73 / 1 / 2, 127 / 2 / 2, 331 / 3 / 6, 333 / 4 / 2, 312 / 5 / 2, 33 / 6 / 2, 78 / 7 / 2, 126 / 8 / 2, 100 / 9 / 2, 213 / 10 / 2, 59 / 11 / 3, 160 / 12 / 2, 361 / 13 / 2, 297 / 14 / 2, 254 / 15 / 4, 80 / 16 / 2, 235 / 17 / 2, 64 / 18 / 2, 63 / 19 / 2, 67 / 20 / 2, 287 / 21 / 3, 165 / 22 / 2, 322 / 23 / 2, 369 / 24 / 2, 295 / 25 / 4, 186 / 26 / 2, 224 / 27 / 2, 290 / 28 / 3, 363 / 29 / 2, 141 / 30 / 3, 343 / 31 / 2, 110 / 32 / 2, 267 / 33 / 4, 336 / 34 / 2, 374 / 35 / 2, 201 / 36 / 4, 306 / 37 / 2, 246 / 38 / 2, 195 / 39 / 2, 176 / 40 / 5, 106 / 41 / 2, 242 / 42 / 2, 91 / 43 / 2, 273 / 44 / 2, 368 / 45 / 6, 187 / 46 / 2, 89 / 47 / 3, 203 / 48 / 2, 196 / 49 / 3, 282 / 50 / 2, 148 / 51 / 2, 257 / 52 / 2, 70 / 53 / 3, 262 / 54 / 2, 307 / 55 / 2, 65 / 56 / 3, 180 / 57 / 2, 46 / 58 / 3, 318 / 59 / 2, 168 / 60 / 3, 252 / 61 / 2, 264 / 62 / 2, 340 / 63 / 2, 44 / 64 / 2, 263 / 65 / 2, 356 / 66 / 2, 371 / 67 / 2, 133 / 68 / 3, 13 / 69 / 2, 108 / 70 / 3, 293 / 71 / 2, 313 / 72 / 5, 14 / 73 / 2, 60 / 74 / 3, 329 / 75 / 2, 266 / 76 / 2, 85 / 77 / 3, 179 / 78 / 2, 247 / 79 / 2, 192 / 80 / 3, 339 / 81 / 2, 171 / 82 / 3, 197 / 83 / 2, 335 / 84 / 2, 166 / 85 / 2, 105 / 86 / 2, 249 / 87 / 3, 276 / 88 / 2, 311 / 89 / 2, 355 / 90 / 3, 256 / 91 / 2, 159 / 92 / 3, 219 / 93 / 2, 143 / 94 / 2, 34 / 95 / 2, 291 / 96 / 4, 286 / 97 / 2, 300 / 98 / 2, 82 / 99 / 2, 62 / 100 / 3, 308 / 101 / 2, 325 / 102 / 2, 158 / 103 / 3, 162 / 104 / 2, 177 / 105 / 3, 175 / 106 / 2, 2 / 107 / 2, 25 / 108 / 2, 53 / 109 / 2, 163 / 110 / 2, 280 / 111 / 2, 42 / 112 / 4, 271 / 113 / 2, 269 / 114 / 2, 188 / 115 / 2, 337 / 116 / 3, 90 / 117 / 2, 330 / 118 / 2, 93 / 119 / 4, 94 / 120 / 2, 320 / 121 / 2, 253 / 122 / 2, 281 / 123 / 2, 87 / 124 / 2, 155 / 125 / 3, 260 / 126 / 2, 212 / 127 / 2, 18 / 128 / 2, 277 / 129 / 2, 68 / 130 / 4, 239 / 131 / 2, 248 / 132 / 2, 364 / 133 / 2, 8 / 134 / 2, 151 / 135 / 4, 81 / 136 / 2, 55 / 137 / 2, 259 / 138 / 3, 102 / 139 / 2, 147 / 140 / 2, 193 / 141 / 2, 75 / 142 / 2, 113 / 143 / 2, 365 / 144 / 2, 302 / 145 / 2, 191 / 146 / 2, 101 / 147 / 2, 15 / 148 / 2, 3 / 149 / 2, 207 / 150 / 2, 285 / 151 / 2, 245 / 152 / 2, 279 / 153 / 2, 96 / 154 / 2, 17 / 155 / 2, 185 / 156 / 4, 268 / 157 / 2, 135 / 158 / 2, 229 / 159 / 2, 345 / 160 / 3, 130 / 161 / 2, 194 / 162 / 3, 116 / 163 / 2, 231 / 164 / 3, 137 / 165 / 2, 208 / 166 / 2, 129 / 167 / 2, 97 / 168 / 3, 362 / 169 / 2, 121 / 170 / 2, 314 / 171 / 4, 145 / 172 / 2, 209 / 173 / 2, 45 / 174 / 3, 184 / 175 / 2, 170 / 176 / 4, 161 / 177 / 2, 22 / 178 / 2, 210 / 179 / 4, 288 / 180 / 2, 230 / 181 / 2, 37 / 182 / 2, 153 / 183 / 5, 294 / 184 / 2, 233 / 185 / 3, 146 / 186 / 2, 222 / 187 / 2, 125 / 188 / 3, 327 / 189 / 2, 367 / 190 / 2, 157 / 191 / 2, 227 / 192 / 2, 349 / 193 / 3, 240 / 194 / 2, 72 / 195 / 2, 122 / 196 / 3, 119 / 197 / 2, 216 / 198 / 3, 244 / 199 / 2, 289 / 200 / 3, 4 / 201 / 2, 95 / 202 / 2, 142 / 203 / 2, 360 / 204 / 3, 215 / 205 / 2, 205 / 206 / 2, 310 / 207 / 2, 150 / 208 / 3, 5 / 209 / 2, 86 / 210 / 2, 370 / 211 / 3, 305 / 212 / 2, 358 / 213 / 3, 232 / 214 / 2, 112 / 215 / 3, 250 / 216 / 2, 99 / 217 / 2, 31 / 218 / 2, 217 / 219 / 2, 309 / 220 / 3, 79 / 221 / 2, 167 / 222 / 3, 149 / 223 / 2, 226 / 224 / 2, 317 / 225 / 3, 272 / 226 / 2, 183 / 227 / 2, 47 / 228 / 2, 270 / 229 / 3, 32 / 230 / 2, 16 / 231 / 2, 178 / 232 / 2, 132 / 233 / 2, 51 / 234 / 5, 117 / 235 / 2, 373 / 236 / 2, 278 / 237 / 3, 120 / 238 / 2, 12 / 239 / 2, 19 / 240 / 2, 1 / 241 / 2, 103 / 242 / 3, 23 / 243 / 2, 139 / 244 / 3, 346 / 245 / 2, 350 / 246 / 3, 83 / 247 / 2, 36 / 248 / 2, 77 / 249 / 3, 351 / 250 / 2, 30 / 251 / 2, 221 / 252 / 7, 104 / 253 / 2, 61 / 254 / 3, 172 / 255 / 2, 299 / 256 / 3, 334 / 257 / 2, 58 / 258 / 2, 84 / 259 / 4, 26 / 260 / 2, 324 / 261 / 2, 228 / 262 / 4, 98 / 263 / 2, 24 / 264 / 2, 298 / 265 / 3, 359 / 266 / 2, 123 / 267 / 3, 341 / 268 / 2, 241 / 269 / 2, 136 / 270 / 3, 57 / 271 / 2, 199 / 272 / 2, 243 / 273 / 2, 316 / 274 / 2, 328 / 275 / 2, 6 / 276 / 2, 156 / 277 / 3, 372 / 278 / 2, 118 / 279 / 2, 265 / 280 / 3, 66 / 281 / 2, 20 / 282 / 2, 74 / 283 / 3, 56 / 284 / 2, 200 / 285 / 2, 164 / 286 / 2, 258 / 287 / 5, 88 / 288 / 2, 206 / 289 / 2, 27 / 290 / 3, 214 / 291 / 2, 21 / 292 / 3, 323 / 293 / 2, 332 / 294 / 3, 348 / 295 / 2, 9 / 296 / 2, 169 / 297 / 3, 7 / 298 / 2, 144 / 299 / 2, 29 / 300 / 2, 140 / 301 / 2, 352 / 302 / 2, 131 / 303 / 2, 173 / 304 / 2, 38 / 305 / 2, 342 / 306 / 2, 301 / 307 / 2, 107 / 308 / 2, 251 / 309 / 5, 39 / 310 / 2, 284 / 311 / 3, 225 / 312 / 2, 315 / 313 / 2, 128 / 314 / 2, 28 / 315 / 3, 274 / 316 / 2, 275 / 317 / 3, 326 / 318 / 2, 198 / 319 / 4, 304 / 320 / 2, 218 / 321 / 2, 255 / 322 / 4, 111 / 323 / 2, 41 / 324 / 2, 11 / 325 / 2, 181 / 326 / 3, 344 / 327 / 2, 321 / 328 / 2, 223 / 329 / 3, 211 / 330 / 2, 237 / 331 / 3, 10 / 332 / 2, 347 / 333 / 2, 109 / 334 / 5, 174 / 335 / 2, 283 / 336 / 3, 296 / 337 / 2, 124 / 338 / 2, 220 / 339 / 2, 357 / 340 / 5, 152 / 341 / 2, 76 / 342 / 2, 154 / 343 / 3, 189 / 344 / 2, 49 / 345 / 2, 35 / 346 / 2, 353 / 347 / 3, 115 / 348 / 2, 54 / 349 / 3, 338 / 350 / 2, 354 / 351 / 2, 204 / 352 / 4, 40 / 353 / 2, 234 / 354 / 2, 48 / 355 / 4, 303 / 356 / 2, 138 / 357 / 3, 236 / 358 / 2, 238 / 359 / 2, 134 / 360 / 2, 261 / 361 / 2, 43 / 362 / 3, 52 / 363 / 2, 182 / 364 / 5, 50 / 365 / 2, 202 / 366 / 2, 92 / 367 / 2, 366 / 368 / 2, 69 / 369 / 3, 292 / 370 / 2, 319 / 371 / 5, 71 / 372 / 2, 190 / 373 / 2, 114 / 374 / 4
doublecenter-alpha_1-11-n500.txt, 1, 1, 500, 4279.73, 4411, 3911, 13, 499,480 / 1 / 5, 199 / 2 / 2, 241 / 3 / 2, 103 / 4 / 2, 219 / 5 / 3, 457 / 6 / 2, 42 / 7 / 3, 118 / 8 / 2, 211 / 9 / 2, 75 / 10 / 2, 425 / 11 / 3, 22 / 12 / 2, 2 / 13 / 2, 179 / 14 / 2, 260 / 15 / 2, 283 / 16 / 2, 244 / 17 / 2, 409 / 18 / 2, 70 / 19 / 2, 398 / 20 / 5, 201 / 21 / 2, 148 / 22 / 2, 323 / 23 / 2, 14 / 24 / 3, 462 / 25 / 2, 76 / 26 / 2, 429 / 27 / 3, 196 / 28 / 2, 173 / 29 / 2, 395 / 30 / 2, 52 / 31 / 3, 383 / 32 / 2, 363 / 33 / 3, 67 / 34 / 2, 385 / 35 / 2, 370 / 36 / 4, 279 / 37 / 2, 164 / 38 / 2, 24 / 39 / 2, 442 / 40 / 3, 92 / 41 / 2, 350 / 42 / 2, 226 / 43 / 3, 162 / 44 / 2, 193 / 45 / 3, 50 / 46 / 2, 403 / 47 / 2, 114 / 48 / 3, 73 / 49 / 2, 195 / 50 / 2, 31 / 51 / 2, 360 / 52 / 2, 471 / 53 / 3, 184 / 54 / 2, 281 / 55 / 2, 165 / 56 / 3, 147 / 57 / 2, 492 / 58 / 2, 108 / 59 / 4, 309 / 60 / 2, 386 / 61 / 2, 314 / 62 / 3, 79 / 63 / 2, 154 / 64 / 2, 105 / 65 / 2, 258 / 66 / 2, 224 / 67 / 3, 187 / 68 / 2, 25 / 69 / 4, 441 / 70 / 2, 300 / 71 / 2, 459 / 72 / 2, 329 / 73 / 3, 298 / 74 / 2, 484 / 75 / 2, 16 / 76 / 2, 421 / 77 / 4, 355 / 78 / 2, 367 / 79 / 2, 38 / 80 / 2, 354 / 81 / 6, 356 / 82 / 2, 1 / 83 / 2, 418 / 84 / 2, 41 / 85 / 2, 496 / 86 / 3, 172 / 87 / 2, 53 / 88 / 2, 274 / 89 / 3, 276 / 90 / 2, 420 / 91 / 2, 82 / 92 / 3, 390 / 93 / 2, 155 / 94 / 3, 138 / 95 / 2, 335 / 96 / 4, 218 / 97 / 2, 177 / 98 / 2, 36 / 99 / 3, 89 / 100 / 2, 482 / 101 / 2, 375 / 102 / 2, 372 / 103 / 2, 209 / 104 / 2, 378 / 105 / 3, 401 / 106 / 2, 5 / 107 / 2, 318 / 108 / 4, 140 / 109 / 2, 202 / 110 / 3, 249 / 111 / 2, 213 / 112 / 2, 336 / 113 / 2, 444 / 114 / 2, 371 / 115 / 3, 85 / 116 / 2, 426 / 117 / 2, 321 / 118 / 2, 324 / 119 / 2, 499 / 120 / 4, 485 / 121 / 2, 376 / 122 / 2, 262 / 123 / 3, 247 / 124 / 2, 122 / 125 / 3, 277 / 126 / 2, 464 / 127 / 2, 330 / 128 / 2, 102 / 129 / 3, 491 / 130 / 2, 490 / 131 / 2, 410 / 132 / 3, 217 / 133 / 2, 353 / 134 / 2, 352 / 135 / 2, 333 / 136 / 3, 477 / 137 / 2, 210 / 138 / 2, 240 / 139 / 3, 344 / 140 / 2, 100 / 141 / 4, 284 / 142 / 2, 171 / 143 / 2, 176 / 144 / 9, 49 / 145 / 2, 434 / 146 / 2, 66 / 147 / 4, 280 / 148 / 2, 98 / 149 / 2, 128 / 150 / 2, 55 / 151 / 2, 458 / 152 / 2, 293 / 153 / 2, 468 / 154 / 5, 263 / 155 / 2, 96 / 156 / 3, 286 / 157 / 2, 256 / 158 / 4, 402 / 159 / 2, 345 / 160 / 2, 109 / 161 / 4, 127 / 162 / 2, 445 / 163 / 2, 450 / 164 / 3, 465 / 165 / 2, 469 / 166 / 2, 51 / 167 / 3, 334 / 168 / 2, 137 / 169 / 2, 290 / 170 / 3, 268 / 171 / 2, 56 / 172 / 2, 296 / 173 / 4, 454 / 174 / 2, 271 / 175 / 2, 110 / 176 / 2, 74 / 177 / 2, 486 / 178 / 4, 95 / 179 / 2, 397 / 180 / 2, 347 / 181 / 2, 463 / 182 / 2, 470 / 183 / 2, 136 / 184 / 2, 239 / 185 / 2, 45 / 186 / 3, 396 / 187 / 2, 264 / 188 / 3, 423 / 189 / 2, 382 / 190 / 2, 142 / 191 / 3, 312 / 192 / 2, 282 / 193 / 4, 116 / 194 / 2, 488 / 195 / 2, 203 / 196 / 2, 191 / 197 / 4, 275 / 198 / 2, 242 / 199 / 2, 80 / 200 / 4, 188 / 201 / 2, 487 / 202 / 2, 427 / 203 / 3, 254 / 204 / 2, 455 / 205 / 2, 167 / 206 / 3, 88 / 207 / 2, 394 / 208 / 2, 255 / 209 / 3, 229 / 210 / 2, 9 / 211 / 2, 327 / 212 / 3, 28 / 213 / 2, 227 / 214 / 2, 111 / 215 / 2, 69 / 216 / 3, 48 / 217 / 2, 223 / 218 / 2, 433 / 219 / 2, 169 / 220 / 2, 132 / 221 / 2, 97 / 222 / 2, 60 / 223 / 4, 115 / 224 / 2, 20 / 225 / 2, 182 / 226 / 3, 117 / 227 / 2, 221 / 228 / 2, 313 / 229 / 5, 467 / 230 / 2, 120 / 231 / 2, 145 / 232 / 2, 163 / 233 / 3, 8 / 234 / 2, 159 / 235 / 10, 34 / 236 / 2, 311 / 237 / 2, 30 / 238 / 3, 252 / 239 / 2, 348 / 240 / 3, 273 / 241 / 2, 57 / 242 / 2, 325 / 243 / 3, 408 / 244 / 2, 185 / 245 / 3, 10 / 246 / 2, 156 / 247 / 13, 303 / 248 / 2, 134 / 249 / 2, 359 / 250 / 2, 35 / 251 / 3, 307 / 252 / 2, 54 / 253 / 2, 123 / 254 / 2, 374 / 255 / 4, 12 / 256 / 2, 37 / 257 / 2, 93 / 258 / 3, 417 / 259 / 2, 112 / 260 / 4, 63 / 261 / 2, 175 / 262 / 2, 460 / 263 / 3, 437 / 264 / 2, 443 / 265 / 2, 481 / 266 / 5, 446 / 267 / 2, 234 / 268 / 3, 81 / 269 / 2, 461 / 270 / 4, 452 / 271 / 2, 494 / 272 / 2, 400 / 273 / 3, 393 / 274 / 2, 292 / 275 / 2, 233 / 276 / 3, 337 / 277 / 2, 68 / 278 / 3, 228 / 279 / 2, 259 / 280 / 3, 432 / 281 / 2, 106 / 282 / 5, 43 / 283 / 2, 13 / 284 / 3, 483 / 285 / 2, 27 / 286 / 2, 72 / 287 / 3, 295 / 288 / 2, 339 / 289 / 3, 413 / 290 / 2, 183 / 291 / 3, 124 / 292 / 2, 266 / 293 / 3, 308 / 294 / 2, 267 / 295 / 3, 340 / 296 / 2, 243 / 297 / 3, 133 / 298 / 2, 343 / 299 / 2, 387 / 300 / 3, 212 / 301 / 2, 416 / 302 / 2, 125 / 303 / 5, 497 / 304 / 2, 151 / 305 / 2, 399 / 306 / 2, 6 / 307 / 2, 428 / 308 / 2, 178 / 309 / 2, 61 / 310 / 2, 141 / 311 / 2, 476 / 312 / 3, 119 / 313 / 2, 270 / 314 / 4, 489 / 315 / 2, 341 / 316 / 2, 474 / 317 / 3, 251 / 318 / 2, 129 / 319 / 6, 261 / 320 / 2, 456 / 321 / 2, 419 / 322 / 2, 453 / 323 / 2, 245 / 324 / 2, 451 / 325 / 2, 250 / 326 / 2, 77 / 327 / 2, 285 / 328 / 4, 94 / 329 / 2, 144 / 330 / 2, 346 / 331 / 3, 236 / 332 / 2, 231 / 333 / 3, 86 / 334 / 2, 238 / 335 / 2, 265 / 336 / 2, 32 / 337 / 2, 158 / 338 / 3, 26 / 339 / 2, 305 / 340 / 3, 448 / 341 / 2, 440 / 342 / 2, 338 / 343 / 4, 220 / 344 / 2, 18 / 345 / 2, 39 / 346 / 7, 365 / 347 / 2, 222 / 348 / 3, 379 / 349 / 2, 153 / 350 / 2, 438 / 351 / 2, 59 / 352 / 2, 189 / 353 / 2, 424 / 354 / 2, 3 / 355 / 3, 299 / 356 / 2, 406 / 357 / 2, 475 / 358 / 2, 205 / 359 / 3, 392 / 360 / 2, 174 / 361 / 2, 83 / 362 / 2, 422 / 363 / 2, 186 / 364 / 3, 294 / 365 / 2, 44 / 366 / 4, 170 / 367 / 2, 322 / 368 / 2, 235 / 369 / 4, 351 / 370 / 2, 29 / 371 / 2, 364 / 372 / 2, 46 / 373 / 2, 317 / 374 / 3, 391 / 375 / 2, 237 / 376 / 2, 358 / 377 / 2, 248 / 378 / 3, 380 / 379 / 2, 139 / 380 / 2, 99 / 381 / 2, 214 / 382 / 2, 449 / 383 / 3, 225 / 384 / 2, 215 / 385 / 2, 315 / 386 / 2, 349 / 387 / 4, 87 / 388 / 2, 291 / 389 / 2, 478 / 390 / 2, 272 / 391 / 4, 319 / 392 / 2, 23 / 393 / 2, 149 / 394 / 4, 377 / 395 / 2, 388 / 396 / 3, 301 / 397 / 2, 161 / 398 / 3, 17 / 399 / 2, 84 / 400 / 2, 326 / 401 / 3, 21 / 402 / 2, 297 / 403 / 3, 253 / 404 / 2, 121 / 405 / 3, 381 / 406 / 2, 431 / 407 / 2, 466 / 408 / 3, 257 / 409 / 2, 180 / 410 / 2, 230 / 411 / 2, 232 / 412 / 2, 479 / 413 / 3, 306 / 414 / 2, 197 / 415 / 3, 368 / 416 / 2, 143 / 417 / 2, 131 / 418 / 2, 328 / 419 / 3, 384 / 420 / 2, 90 / 421 / 2, 342 / 422 / 2, 369 / 423 / 2, 411 / 424 / 2, 389 / 425 / 2, 316 / 426 / 3, 200 / 427 / 2, 181 / 428 / 2, 436 / 429 / 4, 366 / 430 / 2, 130 / 431 / 2, 362 / 432 / 3, 166 / 433 / 2, 430 / 434 / 2, 404 / 435 / 3, 190 / 436 / 2, 146 / 437 / 2, 157 / 438 / 2, 19 / 439 / 2, 439 / 440 / 2, 407 / 441 / 2, 373 / 442 / 3, 310 / 443 / 2, 302 / 444 / 5, 216 / 445 / 2, 4 / 446 / 3, 194 / 447 / 2, 152 / 448 / 2, 498 / 449 / 2, 289 / 450 / 2, 287 / 451 / 2, 107 / 452 / 3, 40 / 453 / 2, 198 / 454 / 3, 91 / 455 / 2, 472 / 456 / 2, 192 / 457 / 4, 15 / 458 / 2, 412 / 459 / 2, 160 / 460 / 4, 126 / 461 / 2, 278 / 462 / 2, 304 / 463 / 4, 208 / 464 / 2, 104 / 465 / 2, 62 / 466 / 3, 207 / 467 / 2, 206 / 468 / 2, 7 / 469 / 2, 320 / 470 / 2, 447 / 471 / 2, 47 / 472 / 2, 269 / 473 / 2, 33 / 474 / 2, 415 / 475 / 2, 331 / 476 / 2, 361 / 477 / 2, 493 / 478 / 3, 204 / 479 / 2, 405 / 480 / 3, 288 / 481 / 2, 135 / 482 / 3, 332 / 483 / 2, 168 / 484 / 4, 414 / 485 / 2, 64 / 486 / 3, 11 / 487 / 2, 65 / 488 / 2, 150 / 489 / 3, 473 / 490 / 2, 101 / 491 / 2, 58 / 492 / 2, 495 / 493 / 2, 357 / 494 / 3, 113 / 495 / 2, 246 / 496 / 2, 71 / 497 / 4, 435 / 498 / 2, 78 / 499 / 3
doublecenter-alpha_1-11-n6.txt, 1, 1, 6, 523.236, 25, 19, 4, 5,2 / 1 / 2, 5 / 2 / 4, 3 / 3 / 2, 4 / 4 / 2, 1 / 5 / 2
doublecenter-alpha_1-110-n175.txt, 1, 1, 175, 2569.78, 1265, 1090, 6, 174,117 / 1 / 3, 63 / 2 / 2, 116 / 3 / 2, 57 / 4 / 2, 127 / 5 / 2, 107 / 6 / 2, 104 / 7 / 2, 14 / 8 / 2, 53 / 9 / 2, 50 / 10 / 2, 161 / 11 / 2, 8 / 12 / 6, 70 / 13 / 2, 83 / 14 / 2, 46 / 15 / 3, 115 / 16 / 2, 58 / 17 / 2, 152 / 18 / 3, 94 / 19 / 2, 150 / 20 / 2, 134 / 21 / 2, 97 / 22 / 3, 95 / 23 / 2, 132 / 24 / 2, 17 / 25 / 2, 84 / 26 / 2, 52 / 27 / 3, 99 / 28 / 2, 59 / 29 / 2, 147 / 30 / 3, 96 / 31 / 2, 62 / 32 / 2, 32 / 33 / 2, 154 / 34 / 3, 138 / 35 / 2, 142 / 36 / 2, 38 / 37 / 2, 128 / 38 / 2, 110 / 39 / 2, 90 / 40 / 2, 4 / 41 / 2, 25 / 42 / 2, 145 / 43 / 2, 44 / 44 / 2, 41 / 45 / 4, 18 / 46 / 2, 120 / 47 / 2, 37 / 48 / 4, 137 / 49 / 2, 54 / 50 / 2, 67 / 51 / 2, 56 / 52 / 3, 12 / 53 / 2, 164 / 54 / 3, 174 / 55 / 2, 16 / 56 / 2, 19 / 57 / 3, 118 / 58 / 2, 33 / 59 / 3, 79 / 60 / 2, 109 / 61 / 2, 45 / 62 / 2, 30 / 63 / 2, 92 / 64 / 2, 136 / 65 / 3, 114 / 66 / 2, 43 / 67 / 2, 108 / 68 / 2, 10 / 69 / 3, 129 / 70 / 2, 2 / 71 / 2, 144 / 72 / 3, 65 / 73 / 2, 61 / 74 / 2, 162 / 75 / 2, 72 / 76 / 2, 28 / 77 / 3, 3 / 78 / 2, 35 / 79 / 3, 78 / 80 / 2, 71 / 81 / 2, 55 / 82 / 2, 124 / 83 / 2, 48 / 84 / 2, 91 / 85 / 3, 82 / 86 / 2, 103 / 87 / 2, 26 / 88 / 2, 31 / 89 / 3, 155 / 90 / 2, 69 / 91 / 2, 172 / 92 / 2, 66 / 93 / 3, 173 / 94 / 2, 6 / 95 / 3, 22 / 96 / 2, 68 / 97 / 2, 146 / 98 / 3, 75 / 99 / 2, 165 / 100 / 3, 168 / 101 / 2, 169 / 102 / 2, 121 / 103 / 2, 27 / 104 / 2, 139 / 105 / 2, 64 / 106 / 3, 111 / 107 / 2, 100 / 108 / 2, 163 / 109 / 3, 40 / 110 / 2, 153 / 111 / 2, 60 / 112 / 2, 76 / 113 / 2, 49 / 114 / 2, 166 / 115 / 2, 131 / 116 / 2, 158 / 117 / 2, 148 / 118 / 2, 9 / 119 / 2, 135 / 120 / 2, 7 / 121 / 3, 160 / 122 / 2, 122 / 123 / 3, 23 / 124 / 2, 98 / 125 / 2, 20 / 126 / 3, 141 / 127 / 2, 36 / 128 / 2, 34 / 129 / 3, 1 / 130 / 2, 157 / 131 / 3, 102 / 132 / 2, 126 / 133 / 2, 47 / 134 / 3, 77 / 135 / 2, 81 / 136 / 2, 105 / 137 / 2, 39 / 138 / 3, 133 / 139 / 2, 51 / 140 / 5, 159 / 141 / 2, 11 / 142 / 2, 74 / 143 / 2, 112 / 144 / 3, 13 / 145 / 2, 88 / 146 / 2, 21 / 147 / 4, 125 / 148 / 2, 171 / 149 / 3, 5 / 150 / 2, 87 / 151 / 2, 170 / 152 / 3, 151 / 153 / 2, 143 / 154 / 2, 73 / 155 / 2, 149 / 156 / 5, 156 / 157 / 2, 24 / 158 / 2, 123 / 159 / 2, 93 / 160 / 2, 130 / 161 / 3, 15 / 162 / 2, 140 / 163 / 3, 119 / 164 / 2, 86 / 165 / 3, 89 / 166 / 2, 113 / 167 / 3, 106 / 168 / 2, 101 / 169 / 4, 80 / 170 / 2, 85 / 171 / 2, 42 / 172 / 2, 29 / 173 / 2, 167 / 174 / 2
doublecenter-alpha_1-111-n250.txt, 1, 1, 250, 3142.77, 2016, 1766, 7, 249,150 / 1 / 2, 204 / 2 / 2, 102 / 3 / 2, 217 / 4 / 2, 110 / 5 / 2, 186 / 6 / 2, 173 / 7 / 2, 151 / 8 / 5, 205 / 9 / 2, 39 / 10 / 2, 162 / 11 / 2, 155 / 12 / 2, 240 / 13 / 3, 49 / 14 / 2, 1 / 15 / 2, 141 / 16 / 2, 194 / 17 / 2, 92 / 18 / 3, 91 / 19 / 2, 123 / 20 / 2, 115 / 21 / 2, 231 / 22 / 4, 93 / 23 / 2, 111 / 24 / 2, 188 / 25 / 2, 15 / 26 / 2, 206 / 27 / 2, 106 / 28 / 4, 241 / 29 / 2, 142 / 30 / 2, 45 / 31 / 2, 132 / 32 / 2, 219 / 33 / 3, 81 / 34 / 2, 57 / 35 / 2, 29 / 36 / 2, 47 / 37 / 2, 11 / 38 / 2, 33 / 39 / 2, 235 / 40 / 5, 16 / 41 / 2, 48 / 42 / 2, 66 / 43 / 2, 191 / 44 / 2, 169 / 45 / 2, 171 / 46 / 4, 242 / 47 / 2, 152 / 48 / 3, 172 / 49 / 2, 189 / 50 / 2, 63 / 51 / 3, 83 / 52 / 2, 131 / 53 / 3, 227 / 54 / 2, 5 / 55 / 2, 44 / 56 / 2, 32 / 57 / 4, 199 / 58 / 2, 168 / 59 / 3, 9 / 60 / 2, 124 / 61 / 2, 4 / 62 / 2, 237 / 63 / 4, 116 / 64 / 2, 21 / 65 / 2, 3 / 66 / 4, 183 / 67 / 2, 28 / 68 / 2, 86 / 69 / 2, 30 / 70 / 5, 225 / 71 / 2, 202 / 72 / 2, 243 / 73 / 2, 233 / 74 / 2, 210 / 75 / 2, 167 / 76 / 3, 46 / 77 / 2, 154 / 78 / 3, 87 / 79 / 2, 23 / 80 / 3, 117 / 81 / 2, 67 / 82 / 3, 214 / 83 / 2, 220 / 84 / 3, 101 / 85 / 2, 197 / 86 / 3, 72 / 87 / 2, 17 / 88 / 2, 236 / 89 / 2, 153 / 90 / 3, 133 / 91 / 2, 109 / 92 / 2, 96 / 93 / 4, 187 / 94 / 2, 190 / 95 / 2, 120 / 96 / 2, 112 / 97 / 7, 26 / 98 / 2, 7 / 99 / 3, 100 / 100 / 2, 13 / 101 / 3, 6 / 102 / 2, 10 / 103 / 2, 164 / 104 / 2, 104 / 105 / 2, 239 / 106 / 2, 19 / 107 / 2, 245 / 108 / 2, 42 / 109 / 3, 85 / 110 / 2, 244 / 111 / 3, 73 / 112 / 2, 90 / 113 / 2, 208 / 114 / 2, 193 / 115 / 2, 60 / 116 / 2, 181 / 117 / 2, 238 / 118 / 3, 156 / 119 / 2, 175 / 120 / 4, 25 / 121 / 2, 209 / 122 / 2, 213 / 123 / 2, 201 / 124 / 2, 203 / 125 / 2, 140 / 126 / 2, 38 / 127 / 2, 80 / 128 / 2, 107 / 129 / 5, 36 / 130 / 2, 135 / 131 / 3, 163 / 132 / 2, 143 / 133 / 3, 226 / 134 / 2, 159 / 135 / 2, 82 / 136 / 3, 165 / 137 / 2, 192 / 138 / 3, 247 / 139 / 2, 108 / 140 / 2, 130 / 141 / 4, 40 / 142 / 2, 76 / 143 / 3, 52 / 144 / 2, 114 / 145 / 3, 31 / 146 / 2, 12 / 147 / 2, 79 / 148 / 2, 65 / 149 / 2, 74 / 150 / 7, 185 / 151 / 2, 144 / 152 / 2, 8 / 153 / 2, 138 / 154 / 2, 179 / 155 / 2, 71 / 156 / 2, 41 / 157 / 3, 249 / 158 / 2, 119 / 159 / 4, 174 / 160 / 2, 212 / 161 / 2, 161 / 162 / 2, 51 / 163 / 3, 178 / 164 / 2, 14 / 165 / 5, 77 / 166 / 2, 157 / 167 / 2, 64 / 168 / 4, 146 / 169 / 2, 56 / 170 / 2, 27 / 171 / 2, 223 / 172 / 2, 122 / 173 / 4, 54 / 174 / 2, 59 / 175 / 2, 84 / 176 / 3, 2 / 177 / 2, 230 / 178 / 3, 118 / 179 / 2, 126 / 180 / 2, 216 / 181 / 3, 34 / 182 / 2, 78 / 183 / 3, 198 / 184 / 2, 24 / 185 / 2, 94 / 186 / 4, 234 / 187 / 2, 147 / 188 / 2, 50 / 189 / 3, 196 / 190 / 2, 70 / 191 / 2, 177 / 192 / 2, 136 / 193 / 2, 20 / 194 / 2, 149 / 195 / 2, 211 / 196 / 3, 95 / 197 / 2, 176 / 198 / 3, 88 / 199 / 2, 182 / 200 / 2, 105 / 201 / 3, 128 / 202 / 2, 200 / 203 / 2, 158 / 204 / 2, 170 / 205 / 2, 68 / 206 / 2, 99 / 207 / 2, 139 / 208 / 2, 125 / 209 / 2, 180 / 210 / 2, 18 / 211 / 4, 53 / 212 / 2, 98 / 213 / 2, 229 / 214 / 3, 22 / 215 / 2, 35 / 216 / 2, 127 / 217 / 3, 148 / 218 / 2, 75 / 219 / 3, 166 / 220 / 2, 55 / 221 / 2, 113 / 222 / 4, 248 / 223 / 2, 97 / 224 / 2, 129 / 225 / 3, 62 / 226 / 2, 228 / 227 / 3, 232 / 228 / 2, 218 / 229 / 3, 145 / 230 / 2, 61 / 231 / 3, 224 / 232 / 2, 43 / 233 / 2, 103 / 234 / 3, 137 / 235 / 2, 195 / 236 / 3, 37 / 237 / 2, 222 / 238 / 2, 215 / 239 / 3, 184 / 240 / 2, 134 / 241 / 2, 89 / 242 / 4, 246 / 243 / 2, 221 / 244 / 2, 69 / 245 / 2, 160 / 246 / 3, 121 / 247 / 2, 207 / 248 / 2, 58 / 249 / 4
doublecenter-alpha_1-112-n250.txt, 1, 1, 250, 3008.84, 2097, 1847, 8, 249,142 / 1 / 6, 116 / 2 / 2, 109 / 3 / 2, 64 / 4 / 3, 157 / 5 / 2, 143 / 6 / 2, 248 / 7 / 2, 2 / 8 / 2, 229 / 9 / 2, 106 / 10 / 3, 72 / 11 / 2, 181 / 12 / 3, 86 / 13 / 2, 180 / 14 / 2, 14 / 15 / 3, 71 / 16 / 2, 114 / 17 / 3, 124 / 18 / 2, 78 / 19 / 2, 128 / 20 / 3, 59 / 21 / 2, 104 / 22 / 2, 108 / 23 / 4, 159 / 24 / 2, 101 / 25 / 2, 149 / 26 / 2, 207 / 27 / 6, 58 / 28 / 2, 31 / 29 / 2, 65 / 30 / 3, 105 / 31 / 2, 84 / 32 / 2, 221 / 33 / 4, 12 / 34 / 2, 40 / 35 / 3, 69 / 36 / 2, 165 / 37 / 2, 232 / 38 / 3, 113 / 39 / 2, 205 / 40 / 3, 91 / 41 / 2, 6 / 42 / 6, 74 / 43 / 2, 237 / 44 / 2, 239 / 45 / 2, 129 / 46 / 3, 185 / 47 / 2, 169 / 48 / 3, 245 / 49 / 2, 171 / 50 / 5, 153 / 51 / 2, 112 / 52 / 3, 218 / 53 / 2, 82 / 54 / 2, 200 / 55 / 2, 34 / 56 / 5, 160 / 57 / 2, 60 / 58 / 2, 83 / 59 / 2, 115 / 60 / 3, 27 / 61 / 2, 117 / 62 / 2, 42 / 63 / 2, 203 / 64 / 2, 177 / 65 / 3, 217 / 66 / 2, 235 / 67 / 2, 97 / 68 / 4, 182 / 69 / 2, 240 / 70 / 2, 246 / 71 / 3, 247 / 72 / 2, 90 / 73 / 3, 110 / 74 / 2, 67 / 75 / 2, 119 / 76 / 2, 85 / 77 / 2, 135 / 78 / 2, 158 / 79 / 2, 29 / 80 / 4, 212 / 81 / 2, 238 / 82 / 3, 62 / 83 / 2, 63 / 84 / 2, 87 / 85 / 2, 26 / 86 / 2, 1 / 87 / 5, 243 / 88 / 2, 41 / 89 / 2, 96 / 90 / 4, 161 / 91 / 2, 5 / 92 / 2, 9 / 93 / 2, 21 / 94 / 3, 122 / 95 / 2, 111 / 96 / 2, 213 / 97 / 5, 190 / 98 / 2, 22 / 99 / 3, 137 / 100 / 2, 134 / 101 / 2, 68 / 102 / 2, 187 / 103 / 2, 39 / 104 / 2, 25 / 105 / 3, 233 / 106 / 2, 227 / 107 / 2, 146 / 108 / 2, 107 / 109 / 3, 151 / 110 / 2, 215 / 111 / 3, 216 / 112 / 2, 118 / 113 / 2, 17 / 114 / 2, 94 / 115 / 2, 224 / 116 / 2, 174 / 117 / 2, 44 / 118 / 4, 81 / 119 / 2, 197 / 120 / 3, 225 / 121 / 2, 23 / 122 / 2, 79 / 123 / 2, 132 / 124 / 3, 163 / 125 / 2, 193 / 126 / 3, 127 / 127 / 2, 148 / 128 / 3, 33 / 129 / 2, 195 / 130 / 2, 176 / 131 / 2, 50 / 132 / 2, 201 / 133 / 2, 61 / 134 / 2, 162 / 135 / 2, 220 / 136 / 2, 18 / 137 / 2, 144 / 138 / 2, 244 / 139 / 2, 95 / 140 / 2, 66 / 141 / 3, 76 / 142 / 2, 138 / 143 / 2, 136 / 144 / 3, 156 / 145 / 2, 231 / 146 / 2, 20 / 147 / 3, 19 / 148 / 2, 48 / 149 / 3, 13 / 150 / 2, 183 / 151 / 2, 154 / 152 / 2, 234 / 153 / 2, 202 / 154 / 3, 3 / 155 / 2, 145 / 156 / 2, 102 / 157 / 3, 139 / 158 / 2, 125 / 159 / 2, 57 / 160 / 4, 206 / 161 / 2, 164 / 162 / 2, 32 / 163 / 2, 198 / 164 / 4, 147 / 165 / 2, 36 / 166 / 2, 70 / 167 / 2, 99 / 168 / 2, 219 / 169 / 3, 133 / 170 / 2, 179 / 171 / 3, 103 / 172 / 2, 16 / 173 / 2, 130 / 174 / 3, 30 / 175 / 2, 7 / 176 / 2, 192 / 177 / 2, 236 / 178 / 3, 167 / 179 / 2, 210 / 180 / 2, 49 / 181 / 2, 46 / 182 / 3, 11 / 183 / 2, 152 / 184 / 4, 168 / 185 / 2, 150 / 186 / 2, 166 / 187 / 4, 211 / 188 / 2, 93 / 189 / 2, 100 / 190 / 2, 89 / 191 / 3, 123 / 192 / 2, 141 / 193 / 2, 126 / 194 / 3, 51 / 195 / 2, 204 / 196 / 3, 191 / 197 / 2, 35 / 198 / 3, 188 / 199 / 2, 155 / 200 / 3, 230 / 201 / 2, 131 / 202 / 2, 214 / 203 / 2, 77 / 204 / 8, 54 / 205 / 2, 196 / 206 / 2, 56 / 207 / 2, 37 / 208 / 2, 92 / 209 / 2, 173 / 210 / 2, 75 / 211 / 2, 120 / 212 / 7, 228 / 213 / 2, 98 / 214 / 2, 241 / 215 / 3, 184 / 216 / 2, 172 / 217 / 2, 140 / 218 / 2, 178 / 219 / 2, 28 / 220 / 3, 52 / 221 / 2, 53 / 222 / 2, 24 / 223 / 3, 15 / 224 / 2, 4 / 225 / 3, 73 / 226 / 2, 249 / 227 / 5, 199 / 228 / 2, 55 / 229 / 2, 121 / 230 / 2, 186 / 231 / 2, 208 / 232 / 3, 209 / 233 / 2, 223 / 234 / 3, 38 / 235 / 2, 47 / 236 / 3, 226 / 237 / 2, 194 / 238 / 2, 43 / 239 / 3, 45 / 240 / 2, 222 / 241 / 2, 80 / 242 / 2, 242 / 243 / 3, 175 / 244 / 2, 170 / 245 / 7, 88 / 246 / 2, 8 / 247 / 2, 189 / 248 / 2, 10 / 249 / 5
doublecenter-alpha_1-113-n250.txt, 1, 1, 250, 2794.25, 2089, 1839, 8, 249,171 / 1 / 2, 132 / 2 / 5, 246 / 3 / 2, 218 / 4 / 2, 100 / 5 / 2, 185 / 6 / 3, 38 / 7 / 2, 187 / 8 / 4, 216 / 9 / 2, 195 / 10 / 2, 111 / 11 / 2, 131 / 12 / 3, 18 / 13 / 2, 12 / 14 / 2, 102 / 15 / 4, 36 / 16 / 2, 41 / 17 / 2, 242 / 18 / 2, 217 / 19 / 5, 82 / 20 / 2, 9 / 21 / 2, 161 / 22 / 2, 156 / 23 / 3, 51 / 24 / 2, 199 / 25 / 2, 115 / 26 / 3, 31 / 27 / 2, 212 / 28 / 3, 204 / 29 / 2, 113 / 30 / 2, 80 / 31 / 2, 241 / 32 / 4, 124 / 33 / 2, 140 / 34 / 2, 93 / 35 / 2, 165 / 36 / 3, 207 / 37 / 2, 163 / 38 / 3, 240 / 39 / 2, 95 / 40 / 3, 180 / 41 / 2, 6 / 42 / 3, 54 / 43 / 2, 39 / 44 / 3, 46 / 45 / 2, 32 / 46 / 3, 79 / 47 / 2, 209 / 48 / 2, 29 / 49 / 2, 197 / 50 / 2, 50 / 51 / 3, 13 / 52 / 2, 43 / 53 / 5, 142 / 54 / 2, 145 / 55 / 2, 108 / 56 / 2, 191 / 57 / 4, 91 / 58 / 2, 198 / 59 / 2, 85 / 60 / 2, 206 / 61 / 3, 178 / 62 / 2, 170 / 63 / 3, 114 / 64 / 2, 64 / 65 / 3, 211 / 66 / 2, 106 / 67 / 2, 150 / 68 / 2, 214 / 69 / 3, 224 / 70 / 2, 158 / 71 / 2, 35 / 72 / 3, 128 / 73 / 2, 67 / 74 / 3, 174 / 75 / 2, 23 / 76 / 2, 21 / 77 / 3, 118 / 78 / 2, 245 / 79 / 2, 11 / 80 / 2, 109 / 81 / 2, 75 / 82 / 2, 117 / 83 / 3, 97 / 84 / 2, 3 / 85 / 2, 28 / 86 / 3, 138 / 87 / 2, 17 / 88 / 2, 40 / 89 / 4, 83 / 90 / 2, 157 / 91 / 2, 59 / 92 / 2, 58 / 93 / 3, 42 / 94 / 2, 239 / 95 / 2, 112 / 96 / 4, 215 / 97 / 2, 53 / 98 / 3, 15 / 99 / 2, 65 / 100 / 3, 116 / 101 / 2, 7 / 102 / 2, 219 / 103 / 4, 167 / 104 / 2, 152 / 105 / 2, 243 / 106 / 2, 90 / 107 / 3, 76 / 108 / 2, 166 / 109 / 2, 225 / 110 / 2, 37 / 111 / 2, 98 / 112 / 2, 143 / 113 / 2, 120 / 114 / 2, 104 / 115 / 6, 177 / 116 / 2, 5 / 117 / 2, 68 / 118 / 2, 154 / 119 / 2, 26 / 120 / 3, 147 / 121 / 2, 184 / 122 / 2, 229 / 123 / 3, 16 / 124 / 2, 84 / 125 / 2, 34 / 126 / 3, 24 / 127 / 2, 201 / 128 / 2, 231 / 129 / 3, 236 / 130 / 2, 233 / 131 / 2, 62 / 132 / 2, 89 / 133 / 4, 20 / 134 / 2, 164 / 135 / 3, 72 / 136 / 2, 237 / 137 / 2, 151 / 138 / 2, 238 / 139 / 3, 77 / 140 / 2, 232 / 141 / 2, 78 / 142 / 2, 159 / 143 / 3, 149 / 144 / 2, 110 / 145 / 2, 129 / 146 / 2, 123 / 147 / 2, 70 / 148 / 2, 14 / 149 / 3, 222 / 150 / 2, 173 / 151 / 2, 125 / 152 / 6, 137 / 153 / 2, 220 / 154 / 2, 127 / 155 / 3, 186 / 156 / 2, 48 / 157 / 3, 160 / 158 / 2, 60 / 159 / 8, 141 / 160 / 2, 22 / 161 / 2, 205 / 162 / 3, 210 / 163 / 2, 92 / 164 / 3, 87 / 165 / 2, 61 / 166 / 3, 30 / 167 / 2, 66 / 168 / 2, 134 / 169 / 3, 101 / 170 / 2, 4 / 171 / 2, 119 / 172 / 3, 86 / 173 / 2, 74 / 174 / 2, 193 / 175 / 3, 55 / 176 / 2, 227 / 177 / 3, 190 / 178 / 2, 228 / 179 / 3, 213 / 180 / 2, 8 / 181 / 2, 249 / 182 / 2, 47 / 183 / 2, 33 / 184 / 3, 162 / 185 / 2, 1 / 186 / 3, 94 / 187 / 2, 19 / 188 / 2, 135 / 189 / 2, 63 / 190 / 3, 88 / 191 / 2, 96 / 192 / 3, 130 / 193 / 2, 221 / 194 / 2, 175 / 195 / 7, 148 / 196 / 2, 188 / 197 / 3, 189 / 198 / 2, 81 / 199 / 2, 192 / 200 / 2, 182 / 201 / 3, 153 / 202 / 2, 234 / 203 / 3, 107 / 204 / 2, 146 / 205 / 2, 126 / 206 / 2, 10 / 207 / 2, 136 / 208 / 3, 223 / 209 / 2, 44 / 210 / 2, 57 / 211 / 2, 202 / 212 / 2, 179 / 213 / 2, 200 / 214 / 2, 196 / 215 / 5, 69 / 216 / 2, 203 / 217 / 2, 144 / 218 / 3, 169 / 219 / 2, 52 / 220 / 2, 105 / 221 / 3, 103 / 222 / 2, 208 / 223 / 3, 176 / 224 / 2, 181 / 225 / 2, 226 / 226 / 2, 49 / 227 / 4, 122 / 228 / 2, 99 / 229 / 2, 25 / 230 / 2, 194 / 231 / 4, 121 / 232 / 2, 244 / 233 / 3, 27 / 234 / 2, 73 / 235 / 3, 71 / 236 / 2, 139 / 237 / 2, 45 / 238 / 2, 2 / 239 / 3, 168 / 240 / 2, 247 / 241 / 7, 230 / 242 / 2, 155 / 243 / 3, 56 / 244 / 2, 248 / 245 / 2, 235 / 246 / 2, 183 / 247 / 4, 172 / 248 / 2, 133 / 249 / 3
doublecenter-alpha_1-114-n250.txt, 1, 1, 250, 2879.72, 2005, 1755, 11, 249,145 / 1 / 2, 58 / 2 / 2, 160 / 3 / 3, 233 / 4 / 2, 16 / 5 / 3, 206 / 6 / 2, 23 / 7 / 3, 230 / 8 / 2, 88 / 9 / 5, 96 / 10 / 2, 164 / 11 / 2, 73 / 12 / 2, 165 / 13 / 2, 151 / 14 / 2, 232 / 15 / 2, 166 / 16 / 2, 204 / 17 / 2, 181 / 18 / 4, 158 / 19 / 2, 112 / 20 / 2, 86 / 21 / 4, 36 / 22 / 2, 207 / 23 / 2, 221 / 24 / 2, 211 / 25 / 3, 195 / 26 / 2, 22 / 27 / 3, 231 / 28 / 2, 41 / 29 / 2, 107 / 30 / 2, 76 / 31 / 2, 177 / 32 / 2, 234 / 33 / 2, 223 / 34 / 2, 227 / 35 / 3, 69 / 36 / 2, 49 / 37 / 3, 173 / 38 / 2, 29 / 39 / 2, 30 / 40 / 3, 15 / 41 / 2, 130 / 42 / 4, 102 / 43 / 2, 246 / 44 / 2, 3 / 45 / 2, 200 / 46 / 2, 97 / 47 / 3, 94 / 48 / 2, 178 / 49 / 2, 120 / 50 / 3, 68 / 51 / 2, 4 / 52 / 2, 218 / 53 / 3, 213 / 54 / 2, 201 / 55 / 2, 172 / 56 / 4, 61 / 57 / 2, 31 / 58 / 2, 186 / 59 / 2, 197 / 60 / 2, 20 / 61 / 2, 28 / 62 / 2, 188 / 63 / 3, 236 / 64 / 2, 191 / 65 / 3, 189 / 66 / 2, 129 / 67 / 3, 196 / 68 / 2, 140 / 69 / 3, 87 / 70 / 2, 245 / 71 / 4, 60 / 72 / 2, 184 / 73 / 2, 150 / 74 / 2, 149 / 75 / 2, 59 / 76 / 11, 202 / 77 / 2, 24 / 78 / 3, 131 / 79 / 2, 193 / 80 / 5, 229 / 81 / 2, 142 / 82 / 2, 32 / 83 / 2, 66 / 84 / 2, 182 / 85 / 2, 40 / 86 / 2, 212 / 87 / 3, 147 / 88 / 2, 162 / 89 / 3, 90 / 90 / 2, 117 / 91 / 2, 109 / 92 / 2, 47 / 93 / 2, 85 / 94 / 2, 163 / 95 / 3, 216 / 96 / 2, 228 / 97 / 2, 105 / 98 / 2, 46 / 99 / 2, 134 / 100 / 2, 2 / 101 / 4, 54 / 102 / 2, 143 / 103 / 2, 43 / 104 / 4, 51 / 105 / 2, 126 / 106 / 2, 48 / 107 / 4, 110 / 108 / 2, 123 / 109 / 2, 127 / 110 / 2, 6 / 111 / 4, 155 / 112 / 2, 12 / 113 / 2, 98 / 114 / 3, 144 / 115 / 2, 242 / 116 / 2, 187 / 117 / 3, 63 / 118 / 2, 220 / 119 / 2, 161 / 120 / 2, 17 / 121 / 2, 210 / 122 / 2, 222 / 123 / 3, 119 / 124 / 2, 21 / 125 / 3, 137 / 126 / 2, 198 / 127 / 2, 113 / 128 / 2, 124 / 129 / 3, 208 / 130 / 2, 203 / 131 / 3, 111 / 132 / 2, 239 / 133 / 3, 157 / 134 / 2, 95 / 135 / 5, 241 / 136 / 2, 78 / 137 / 2, 77 / 138 / 3, 183 / 139 / 2, 133 / 140 / 2, 125 / 141 / 3, 27 / 142 / 2, 13 / 143 / 3, 214 / 144 / 2, 194 / 145 / 2, 141 / 146 / 2, 35 / 147 / 2, 50 / 148 / 4, 248 / 149 / 2, 18 / 150 / 2, 235 / 151 / 2, 5 / 152 / 2, 67 / 153 / 4, 37 / 154 / 2, 243 / 155 / 2, 81 / 156 / 2, 108 / 157 / 2, 34 / 158 / 2, 65 / 159 / 3, 209 / 160 / 2, 39 / 161 / 3, 170 / 162 / 2, 240 / 163 / 2, 83 / 164 / 3, 38 / 165 / 2, 249 / 166 / 2, 171 / 167 / 2, 93 / 168 / 2, 152 / 169 / 3, 56 / 170 / 2, 42 / 171 / 3, 57 / 172 / 2, 33 / 173 / 3, 244 / 174 / 2, 153 / 175 / 3, 238 / 176 / 2, 122 / 177 / 2, 91 / 178 / 3, 75 / 179 / 2, 84 / 180 / 3, 226 / 181 / 2, 52 / 182 / 2, 176 / 183 / 2, 180 / 184 / 2, 138 / 185 / 2, 100 / 186 / 2, 14 / 187 / 3, 219 / 188 / 2, 1 / 189 / 2, 70 / 190 / 3, 215 / 191 / 2, 99 / 192 / 3, 237 / 193 / 2, 92 / 194 / 2, 44 / 195 / 4, 136 / 196 / 2, 82 / 197 / 2, 72 / 198 / 2, 185 / 199 / 2, 128 / 200 / 2, 116 / 201 / 2, 79 / 202 / 2, 104 / 203 / 2, 106 / 204 / 2, 9 / 205 / 3, 74 / 206 / 2, 118 / 207 / 3, 175 / 208 / 2, 132 / 209 / 2, 103 / 210 / 2, 7 / 211 / 3, 190 / 212 / 2, 135 / 213 / 2, 55 / 214 / 4, 217 / 215 / 2, 89 / 216 / 2, 146 / 217 / 3, 156 / 218 / 2, 114 / 219 / 2, 53 / 220 / 2, 10 / 221 / 2, 168 / 222 / 2, 71 / 223 / 2, 8 / 224 / 6, 192 / 225 / 2, 45 / 226 / 2, 26 / 227 / 3, 167 / 228 / 2, 19 / 229 / 3, 80 / 230 / 2, 154 / 231 / 6, 179 / 232 / 2, 115 / 233 / 2, 64 / 234 / 2, 101 / 235 / 2, 11 / 236 / 3, 121 / 237 / 2, 148 / 238 / 3, 205 / 239 / 2, 139 / 240 / 3, 62 / 241 / 2, 224 / 242 / 2, 159 / 243 / 2, 247 / 244 / 2, 169 / 245 / 4, 25 / 246 / 2, 199 / 247 / 2, 174 / 248 / 4, 225 / 249 / 2
doublecenter-alpha_1-115-n250.txt, 1, 1, 250, 3282.71, 2321, 2071, 15, 249,173 / 1 / 2, 26 / 2 / 3, 246 / 3 / 2, 185 / 4 / 2, 104 / 5 / 2, 21 / 6 / 2, 80 / 7 / 2, 163 / 8 / 2, 227 / 9 / 2, 59 / 10 / 2, 22 / 11 / 2, 176 / 12 / 3, 238 / 13 / 2, 203 / 14 / 3, 165 / 15 / 2, 7 / 16 / 3, 48 / 17 / 2, 120 / 18 / 2, 144 / 19 / 2, 219 / 20 / 2, 199 / 21 / 2, 112 / 22 / 3, 223 / 23 / 2, 82 / 24 / 2, 218 / 25 / 2, 187 / 26 / 2, 171 / 27 / 2, 29 / 28 / 2, 209 / 29 / 4, 202 / 30 / 2, 81 / 31 / 2, 125 / 32 / 2, 106 / 33 / 3, 57 / 34 / 2, 119 / 35 / 2, 5 / 36 / 2, 145 / 37 / 3, 225 / 38 / 2, 64 / 39 / 3, 15 / 40 / 2, 63 / 41 / 3, 236 / 42 / 2, 240 / 43 / 2, 226 / 44 / 3, 78 / 45 / 2, 129 / 46 / 3, 157 / 47 / 2, 8 / 48 / 3, 151 / 49 / 2, 58 / 50 / 2, 126 / 51 / 2, 234 / 52 / 2, 72 / 53 / 2, 68 / 54 / 2, 56 / 55 / 2, 212 / 56 / 2, 170 / 57 / 2, 108 / 58 / 2, 191 / 59 / 4, 224 / 60 / 2, 12 / 61 / 2, 17 / 62 / 4, 84 / 63 / 2, 152 / 64 / 2, 135 / 65 / 3, 192 / 66 / 2, 231 / 67 / 4, 113 / 68 / 2, 91 / 69 / 2, 154 / 70 / 2, 237 / 71 / 2, 66 / 72 / 2, 1 / 73 / 2, 206 / 74 / 3, 4 / 75 / 2, 133 / 76 / 4, 141 / 77 / 2, 155 / 78 / 3, 95 / 79 / 2, 177 / 80 / 2, 150 / 81 / 2, 128 / 82 / 2, 244 / 83 / 2, 216 / 84 / 3, 201 / 85 / 2, 127 / 86 / 2, 217 / 87 / 2, 103 / 88 / 2, 132 / 89 / 2, 60 / 90 / 4, 28 / 91 / 2, 221 / 92 / 2, 65 / 93 / 2, 207 / 94 / 2, 229 / 95 / 2, 186 / 96 / 2, 149 / 97 / 3, 210 / 98 / 2, 232 / 99 / 2, 38 / 100 / 15, 23 / 101 / 2, 242 / 102 / 3, 172 / 103 / 2, 67 / 104 / 2, 130 / 105 / 2, 197 / 106 / 3, 74 / 107 / 2, 243 / 108 / 3, 101 / 109 / 2, 87 / 110 / 2, 147 / 111 / 2, 61 / 112 / 2, 11 / 113 / 3, 122 / 114 / 2, 41 / 115 / 3, 134 / 116 / 2, 111 / 117 / 2, 117 / 118 / 2, 115 / 119 / 2, 27 / 120 / 2, 196 / 121 / 2, 131 / 122 / 3, 166 / 123 / 2, 200 / 124 / 2, 9 / 125 / 2, 233 / 126 / 2, 107 / 127 / 2, 121 / 128 / 2, 241 / 129 / 2, 110 / 130 / 2, 36 / 131 / 2, 175 / 132 / 2, 123 / 133 / 2, 214 / 134 / 3, 96 / 135 / 2, 31 / 136 / 3, 146 / 137 / 2, 182 / 138 / 3, 76 / 139 / 2, 45 / 140 / 3, 37 / 141 / 2, 102 / 142 / 3, 92 / 143 / 2, 20 / 144 / 2, 245 / 145 / 2, 34 / 146 / 2, 148 / 147 / 2, 35 / 148 / 2, 14 / 149 / 3, 53 / 150 / 2, 248 / 151 / 3, 43 / 152 / 2, 30 / 153 / 3, 77 / 154 / 2, 239 / 155 / 2, 16 / 156 / 2, 140 / 157 / 3, 180 / 158 / 2, 169 / 159 / 3, 153 / 160 / 2, 33 / 161 / 3, 73 / 162 / 2, 158 / 163 / 2, 204 / 164 / 2, 70 / 165 / 3, 54 / 166 / 2, 13 / 167 / 3, 55 / 168 / 2, 220 / 169 / 2, 51 / 170 / 2, 3 / 171 / 2, 118 / 172 / 3, 124 / 173 / 2, 183 / 174 / 3, 249 / 175 / 2, 98 / 176 / 2, 52 / 177 / 2, 2 / 178 / 3, 178 / 179 / 2, 179 / 180 / 2, 116 / 181 / 4, 42 / 182 / 2, 25 / 183 / 2, 230 / 184 / 2, 86 / 185 / 2, 235 / 186 / 4, 247 / 187 / 2, 161 / 188 / 2, 85 / 189 / 3, 94 / 190 / 2, 162 / 191 / 2, 142 / 192 / 2, 18 / 193 / 2, 114 / 194 / 2, 138 / 195 / 4, 228 / 196 / 2, 168 / 197 / 2, 139 / 198 / 2, 24 / 199 / 3, 156 / 200 / 2, 167 / 201 / 3, 194 / 202 / 2, 109 / 203 / 4, 213 / 204 / 2, 136 / 205 / 2, 10 / 206 / 4, 164 / 207 / 2, 19 / 208 / 3, 222 / 209 / 2, 39 / 210 / 2, 93 / 211 / 4, 89 / 212 / 2, 160 / 213 / 2, 208 / 214 / 2, 198 / 215 / 3, 211 / 216 / 2, 189 / 217 / 3, 188 / 218 / 2, 181 / 219 / 2, 47 / 220 / 2, 50 / 221 / 2, 105 / 222 / 2, 90 / 223 / 2, 71 / 224 / 2, 100 / 225 / 3, 75 / 226 / 2, 174 / 227 / 2, 137 / 228 / 2, 205 / 229 / 2, 215 / 230 / 2, 6 / 231 / 3, 49 / 232 / 2, 99 / 233 / 3, 88 / 234 / 2, 32 / 235 / 2, 44 / 236 / 3, 79 / 237 / 2, 190 / 238 / 2, 97 / 239 / 4, 193 / 240 / 2, 83 / 241 / 3, 69 / 242 / 2, 46 / 243 / 3, 159 / 244 / 2, 195 / 245 / 2, 143 / 246 / 3, 62 / 247 / 2, 40 / 248 / 2, 184 / 249 / 4
doublecenter-alpha_1-116-n250.txt, 1, 1, 250, 3046.25, 2081, 1831, 10, 249,171 / 1 / 7, 54 / 2 / 2, 212 / 3 / 2, 193 / 4 / 3, 46 / 5 / 2, 22 / 6 / 4, 97 / 7 / 2, 53 / 8 / 2, 211 / 9 / 5, 127 / 10 / 2, 109 / 11 / 2, 241 / 12 / 2, 44 / 13 / 5, 9 / 14 / 2, 149 / 15 / 2, 13 / 16 / 2, 16 / 17 / 3, 223 / 18 / 2, 17 / 19 / 3, 12 / 20 / 2, 224 / 21 / 2, 82 / 22 / 3, 73 / 23 / 2, 184 / 24 / 5, 144 / 25 / 2, 14 / 26 / 2, 194 / 27 / 2, 48 / 28 / 5, 225 / 29 / 2, 175 / 30 / 2, 77 / 31 / 2, 115 / 32 / 3, 119 / 33 / 2, 190 / 34 / 2, 91 / 35 / 2, 231 / 36 / 3, 173 / 37 / 2, 161 / 38 / 2, 79 / 39 / 2, 6 / 40 / 3, 39 / 41 / 2, 8 / 42 / 3, 57 / 43 / 2, 117 / 44 / 3, 172 / 45 / 2, 83 / 46 / 3, 51 / 47 / 2, 88 / 48 / 2, 70 / 49 / 3, 65 / 50 / 2, 163 / 51 / 3, 40 / 52 / 2, 7 / 53 / 3, 248 / 54 / 2, 69 / 55 / 2, 112 / 56 / 2, 237 / 57 / 5, 150 / 58 / 2, 244 / 59 / 2, 85 / 60 / 2, 38 / 61 / 2, 33 / 62 / 6, 23 / 63 / 2, 210 / 64 / 2, 11 / 65 / 2, 113 / 66 / 4, 131 / 67 / 2, 165 / 68 / 2, 167 / 69 / 3, 189 / 70 / 2, 180 / 71 / 3, 176 / 72 / 2, 107 / 73 / 2, 19 / 74 / 2, 168 / 75 / 2, 198 / 76 / 2, 47 / 77 / 2, 35 / 78 / 2, 227 / 79 / 2, 143 / 80 / 2, 80 / 81 / 4, 186 / 82 / 2, 125 / 83 / 2, 138 / 84 / 3, 199 / 85 / 2, 92 / 86 / 3, 170 / 87 / 2, 106 / 88 / 3, 219 / 89 / 2, 182 / 90 / 2, 195 / 91 / 2, 222 / 92 / 2, 206 / 93 / 2, 26 / 94 / 2, 216 / 95 / 4, 28 / 96 / 2, 238 / 97 / 3, 158 / 98 / 2, 59 / 99 / 4, 187 / 100 / 2, 10 / 101 / 2, 220 / 102 / 3, 100 / 103 / 2, 153 / 104 / 2, 177 / 105 / 4, 61 / 106 / 2, 178 / 107 / 2, 129 / 108 / 2, 68 / 109 / 4, 136 / 110 / 2, 139 / 111 / 2, 43 / 112 / 2, 75 / 113 / 2, 24 / 114 / 2, 1 / 115 / 3, 242 / 116 / 2, 37 / 117 / 2, 155 / 118 / 4, 42 / 119 / 2, 230 / 120 / 2, 209 / 121 / 2, 128 / 122 / 2, 229 / 123 / 2, 101 / 124 / 2, 142 / 125 / 2, 99 / 126 / 2, 132 / 127 / 2, 95 / 128 / 5, 157 / 129 / 2, 81 / 130 / 3, 181 / 131 / 2, 196 / 132 / 3, 78 / 133 / 2, 58 / 134 / 3, 18 / 135 / 2, 233 / 136 / 2, 105 / 137 / 3, 66 / 138 / 2, 215 / 139 / 4, 25 / 140 / 2, 93 / 141 / 2, 207 / 142 / 4, 174 / 143 / 2, 151 / 144 / 2, 72 / 145 / 2, 96 / 146 / 2, 141 / 147 / 2, 235 / 148 / 3, 135 / 149 / 2, 203 / 150 / 2, 179 / 151 / 2, 234 / 152 / 2, 200 / 153 / 5, 126 / 154 / 2, 160 / 155 / 2, 108 / 156 / 2, 154 / 157 / 2, 103 / 158 / 2, 114 / 159 / 3, 15 / 160 / 2, 146 / 161 / 3, 152 / 162 / 2, 159 / 163 / 2, 208 / 164 / 2, 236 / 165 / 2, 121 / 166 / 2, 76 / 167 / 2, 246 / 168 / 3, 86 / 169 / 2, 147 / 170 / 2, 4 / 171 / 2, 192 / 172 / 2, 123 / 173 / 2, 221 / 174 / 2, 162 / 175 / 2, 191 / 176 / 2, 34 / 177 / 2, 188 / 178 / 10, 197 / 179 / 2, 214 / 180 / 2, 63 / 181 / 3, 249 / 182 / 2, 164 / 183 / 2, 130 / 184 / 4, 201 / 185 / 2, 30 / 186 / 2, 213 / 187 / 4, 156 / 188 / 2, 89 / 189 / 2, 67 / 190 / 2, 104 / 191 / 3, 56 / 192 / 2, 60 / 193 / 2, 102 / 194 / 2, 64 / 195 / 3, 74 / 196 / 2, 20 / 197 / 3, 21 / 198 / 2, 217 / 199 / 2, 134 / 200 / 3, 90 / 201 / 2, 183 / 202 / 2, 137 / 203 / 2, 52 / 204 / 2, 124 / 205 / 2, 84 / 206 / 2, 32 / 207 / 3, 218 / 208 / 2, 204 / 209 / 2, 87 / 210 / 4, 228 / 211 / 2, 122 / 212 / 2, 166 / 213 / 3, 27 / 214 / 2, 71 / 215 / 3, 49 / 216 / 2, 45 / 217 / 2, 133 / 218 / 3, 41 / 219 / 2, 94 / 220 / 2, 55 / 221 / 3, 185 / 222 / 2, 232 / 223 / 3, 118 / 224 / 2, 205 / 225 / 3, 148 / 226 / 2, 116 / 227 / 2, 145 / 228 / 2, 5 / 229 / 2, 202 / 230 / 2, 111 / 231 / 2, 3 / 232 / 4, 239 / 233 / 2, 169 / 234 / 2, 62 / 235 / 3, 243 / 236 / 2, 245 / 237 / 3, 120 / 238 / 2, 226 / 239 / 2, 240 / 240 / 2, 29 / 241 / 3, 140 / 242 / 2, 36 / 243 / 2, 31 / 244 / 3, 50 / 245 / 2, 2 / 246 / 3, 110 / 247 / 2, 247 / 248 / 3, 98 / 249 / 2
doublecenter-alpha_1-117-n250.txt, 1, 1, 250, 3125.63, 1977, 1727, 6, 249,166 / 1 / 3, 51 / 2 / 2, 100 / 3 / 3, 53 / 4 / 2, 188 / 5 / 3, 241 / 6 / 2, 66 / 7 / 2, 141 / 8 / 2, 115 / 9 / 3, 233 / 10 / 2, 192 / 11 / 2, 107 / 12 / 2, 39 / 13 / 2, 13 / 14 / 3, 55 / 15 / 2, 226 / 16 / 2, 90 / 17 / 2, 136 / 18 / 2, 162 / 19 / 2, 184 / 20 / 2, 61 / 21 / 2, 56 / 22 / 3, 139 / 23 / 2, 11 / 24 / 4, 199 / 25 / 2, 80 / 26 / 2, 236 / 27 / 2, 17 / 28 / 3, 79 / 29 / 2, 118 / 30 / 2, 179 / 31 / 2, 52 / 32 / 4, 12 / 33 / 2, 185 / 34 / 2, 101 / 35 / 2, 148 / 36 / 3, 19 / 37 / 2, 176 / 38 / 2, 193 / 39 / 2, 224 / 40 / 2, 113 / 41 / 2, 31 / 42 / 2, 150 / 43 / 2, 35 / 44 / 3, 63 / 45 / 2, 249 / 46 / 2, 165 / 47 / 3, 111 / 48 / 2, 230 / 49 / 2, 158 / 50 / 3, 206 / 51 / 2, 170 / 52 / 3, 129 / 53 / 2, 73 / 54 / 2, 214 / 55 / 3, 175 / 56 / 2, 191 / 57 / 3, 57 / 58 / 2, 24 / 59 / 2, 2 / 60 / 2, 62 / 61 / 4, 102 / 62 / 2, 94 / 63 / 2, 151 / 64 / 3, 210 / 65 / 2, 44 / 66 / 2, 81 / 67 / 3, 196 / 68 / 2, 40 / 69 / 3, 42 / 70 / 2, 244 / 71 / 2, 194 / 72 / 3, 114 / 73 / 2, 71 / 74 / 4, 27 / 75 / 2, 243 / 76 / 3, 48 / 77 / 2, 21 / 78 / 2, 28 / 79 / 3, 121 / 80 / 2, 103 / 81 / 2, 181 / 82 / 2, 29 / 83 / 4, 125 / 84 / 2, 200 / 85 / 2, 159 / 86 / 6, 77 / 87 / 2, 171 / 88 / 2, 220 / 89 / 2, 124 / 90 / 2, 105 / 91 / 2, 70 / 92 / 2, 50 / 93 / 2, 104 / 94 / 2, 160 / 95 / 2, 145 / 96 / 3, 221 / 97 / 2, 92 / 98 / 3, 172 / 99 / 2, 98 / 100 / 5, 122 / 101 / 2, 54 / 102 / 2, 45 / 103 / 2, 187 / 104 / 4, 33 / 105 / 2, 120 / 106 / 2, 142 / 107 / 3, 215 / 108 / 2, 99 / 109 / 4, 7 / 110 / 2, 135 / 111 / 2, 130 / 112 / 2, 207 / 113 / 2, 190 / 114 / 3, 37 / 115 / 2, 186 / 116 / 3, 1 / 117 / 2, 234 / 118 / 2, 89 / 119 / 2, 237 / 120 / 3, 169 / 121 / 2, 197 / 122 / 2, 235 / 123 / 3, 47 / 124 / 2, 168 / 125 / 3, 225 / 126 / 2, 110 / 127 / 3, 246 / 128 / 2, 229 / 129 / 3, 64 / 130 / 2, 182 / 131 / 2, 138 / 132 / 3, 117 / 133 / 2, 161 / 134 / 5, 41 / 135 / 2, 232 / 136 / 2, 212 / 137 / 2, 58 / 138 / 5, 88 / 139 / 2, 82 / 140 / 2, 5 / 141 / 2, 203 / 142 / 4, 108 / 143 / 2, 240 / 144 / 2, 38 / 145 / 6, 180 / 146 / 2, 127 / 147 / 3, 34 / 148 / 2, 112 / 149 / 4, 10 / 150 / 2, 67 / 151 / 2, 195 / 152 / 6, 247 / 153 / 2, 198 / 154 / 2, 109 / 155 / 2, 68 / 156 / 3, 143 / 157 / 2, 4 / 158 / 2, 208 / 159 / 2, 239 / 160 / 2, 204 / 161 / 2, 238 / 162 / 2, 157 / 163 / 3, 152 / 164 / 2, 137 / 165 / 3, 106 / 166 / 2, 189 / 167 / 3, 49 / 168 / 2, 83 / 169 / 2, 227 / 170 / 2, 134 / 171 / 3, 30 / 172 / 2, 116 / 173 / 2, 59 / 174 / 2, 25 / 175 / 3, 173 / 176 / 2, 164 / 177 / 2, 128 / 178 / 3, 8 / 179 / 2, 183 / 180 / 3, 3 / 181 / 2, 155 / 182 / 2, 131 / 183 / 3, 178 / 184 / 2, 242 / 185 / 3, 202 / 186 / 2, 201 / 187 / 2, 167 / 188 / 2, 78 / 189 / 5, 209 / 190 / 2, 15 / 191 / 2, 223 / 192 / 2, 174 / 193 / 5, 85 / 194 / 2, 228 / 195 / 2, 133 / 196 / 4, 163 / 197 / 2, 156 / 198 / 2, 14 / 199 / 3, 93 / 200 / 2, 86 / 201 / 4, 123 / 202 / 2, 97 / 203 / 2, 245 / 204 / 2, 126 / 205 / 6, 32 / 206 / 2, 222 / 207 / 2, 177 / 208 / 3, 18 / 209 / 2, 219 / 210 / 3, 218 / 211 / 2, 91 / 212 / 2, 23 / 213 / 2, 74 / 214 / 3, 69 / 215 / 2, 211 / 216 / 2, 9 / 217 / 3, 149 / 218 / 2, 217 / 219 / 2, 147 / 220 / 2, 205 / 221 / 2, 16 / 222 / 2, 87 / 223 / 2, 72 / 224 / 2, 140 / 225 / 2, 65 / 226 / 5, 154 / 227 / 2, 144 / 228 / 3, 132 / 229 / 2, 43 / 230 / 3, 248 / 231 / 2, 60 / 232 / 3, 95 / 233 / 2, 46 / 234 / 2, 96 / 235 / 2, 26 / 236 / 3, 36 / 237 / 2, 22 / 238 / 3, 213 / 239 / 2, 20 / 240 / 5, 216 / 241 / 2, 153 / 242 / 2, 119 / 243 / 2, 75 / 244 / 3, 76 / 245 / 2, 231 / 246 / 2, 146 / 247 / 3, 6 / 248 / 2, 84 / 249 / 2
doublecenter-alpha_1-118-n250.txt, 1, 1, 250, 3165.41, 2108, 1858, 9, 249,152 / 1 / 3, 28 / 2 / 2, 58 / 3 / 2, 174 / 4 / 2, 68 / 5 / 3, 141 / 6 / 2, 206 / 7 / 2, 157 / 8 / 2, 202 / 9 / 2, 105 / 10 / 2, 86 / 11 / 3, 67 / 12 / 2, 39 / 13 / 2, 125 / 14 / 2, 101 / 15 / 2, 44 / 16 / 2, 143 / 17 / 2, 201 / 18 / 3, 196 / 19 / 2, 226 / 20 / 6, 236 / 21 / 2, 193 / 22 / 2, 230 / 23 / 3, 76 / 24 / 2, 168 / 25 / 2, 131 / 26 / 2, 98 / 27 / 2, 227 / 28 / 3, 172 / 29 / 2, 20 / 30 / 2, 65 / 31 / 3, 229 / 32 / 2, 167 / 33 / 2, 48 / 34 / 2, 243 / 35 / 9, 117 / 36 / 2, 191 / 37 / 3, 55 / 38 / 2, 233 / 39 / 3, 231 / 40 / 2, 82 / 41 / 2, 43 / 42 / 2, 16 / 43 / 3, 159 / 44 / 2, 22 / 45 / 2, 170 / 46 / 3, 88 / 47 / 2, 194 / 48 / 2, 84 / 49 / 2, 137 / 50 / 5, 127 / 51 / 2, 177 / 52 / 2, 165 / 53 / 2, 64 / 54 / 3, 189 / 55 / 2, 128 / 56 / 3, 183 / 57 / 2, 77 / 58 / 2, 214 / 59 / 2, 62 / 60 / 3, 13 / 61 / 2, 200 / 62 / 3, 71 / 63 / 2, 238 / 64 / 2, 135 / 65 / 4, 32 / 66 / 2, 123 / 67 / 3, 224 / 68 / 2, 144 / 69 / 2, 80 / 70 / 2, 133 / 71 / 2, 35 / 72 / 5, 149 / 73 / 2, 45 / 74 / 2, 73 / 75 / 2, 53 / 76 / 2, 51 / 77 / 5, 69 / 78 / 2, 247 / 79 / 3, 4 / 80 / 2, 156 / 81 / 2, 75 / 82 / 2, 70 / 83 / 4, 81 / 84 / 2, 111 / 85 / 2, 47 / 86 / 3, 103 / 87 / 2, 207 / 88 / 7, 50 / 89 / 2, 151 / 90 / 2, 129 / 91 / 2, 239 / 92 / 3, 2 / 93 / 2, 119 / 94 / 2, 121 / 95 / 3, 9 / 96 / 2, 41 / 97 / 2, 232 / 98 / 2, 195 / 99 / 5, 130 / 100 / 2, 138 / 101 / 2, 85 / 102 / 2, 158 / 103 / 3, 17 / 104 / 2, 95 / 105 / 3, 220 / 106 / 2, 182 / 107 / 2, 11 / 108 / 4, 132 / 109 / 2, 124 / 110 / 2, 56 / 111 / 2, 140 / 112 / 3, 37 / 113 / 2, 93 / 114 / 2, 104 / 115 / 2, 83 / 116 / 2, 23 / 117 / 2, 222 / 118 / 3, 36 / 119 / 2, 186 / 120 / 3, 187 / 121 / 2, 242 / 122 / 3, 221 / 123 / 2, 237 / 124 / 3, 99 / 125 / 2, 109 / 126 / 3, 150 / 127 / 2, 212 / 128 / 3, 198 / 129 / 2, 241 / 130 / 2, 63 / 131 / 2, 181 / 132 / 3, 38 / 133 / 2, 26 / 134 / 2, 102 / 135 / 4, 245 / 136 / 2, 223 / 137 / 2, 59 / 138 / 4, 108 / 139 / 2, 118 / 140 / 2, 31 / 141 / 3, 248 / 142 / 2, 3 / 143 / 2, 14 / 144 / 2, 57 / 145 / 2, 126 / 146 / 2, 122 / 147 / 2, 33 / 148 / 2, 134 / 149 / 2, 116 / 150 / 2, 27 / 151 / 2, 42 / 152 / 2, 184 / 153 / 2, 21 / 154 / 3, 218 / 155 / 2, 7 / 156 / 2, 240 / 157 / 2, 49 / 158 / 2, 219 / 159 / 2, 24 / 160 / 2, 96 / 161 / 4, 115 / 162 / 2, 29 / 163 / 2, 197 / 164 / 3, 162 / 165 / 2, 213 / 166 / 2, 228 / 167 / 6, 142 / 168 / 2, 217 / 169 / 2, 97 / 170 / 2, 215 / 171 / 2, 79 / 172 / 2, 5 / 173 / 2, 249 / 174 / 3, 147 / 175 / 2, 91 / 176 / 3, 74 / 177 / 2, 154 / 178 / 3, 173 / 179 / 2, 161 / 180 / 2, 244 / 181 / 3, 190 / 182 / 2, 148 / 183 / 2, 225 / 184 / 2, 114 / 185 / 2, 203 / 186 / 2, 185 / 187 / 3, 171 / 188 / 2, 211 / 189 / 2, 106 / 190 / 2, 19 / 191 / 2, 153 / 192 / 4, 46 / 193 / 2, 188 / 194 / 2, 166 / 195 / 2, 120 / 196 / 3, 1 / 197 / 2, 12 / 198 / 2, 52 / 199 / 3, 78 / 200 / 2, 164 / 201 / 2, 107 / 202 / 3, 145 / 203 / 2, 234 / 204 / 4, 208 / 205 / 2, 90 / 206 / 3, 89 / 207 / 2, 94 / 208 / 2, 160 / 209 / 3, 136 / 210 / 2, 6 / 211 / 3, 178 / 212 / 2, 204 / 213 / 3, 87 / 214 / 2, 155 / 215 / 5, 146 / 216 / 2, 210 / 217 / 3, 61 / 218 / 2, 72 / 219 / 3, 15 / 220 / 2, 205 / 221 / 2, 8 / 222 / 2, 139 / 223 / 3, 209 / 224 / 2, 66 / 225 / 2, 10 / 226 / 3, 34 / 227 / 2, 112 / 228 / 2, 25 / 229 / 2, 163 / 230 / 2, 110 / 231 / 5, 40 / 232 / 2, 18 / 233 / 2, 175 / 234 / 2, 30 / 235 / 3, 246 / 236 / 2, 176 / 237 / 3, 235 / 238 / 2, 180 / 239 / 2, 113 / 240 / 2, 54 / 241 / 3, 179 / 242 / 2, 192 / 243 / 2, 216 / 244 / 3, 92 / 245 / 2, 199 / 246 / 3, 169 / 247 / 2, 100 / 248 / 4, 60 / 249 / 2
doublecenter-alpha_1-119-n250.txt, 1, 1, 250, 3139.44, 2337, 2087, 14, 249,64 / 1 / 2, 243 / 2 / 6, 190 / 3 / 2, 77 / 4 / 2, 51 / 5 / 2, 70 / 6 / 2, 65 / 7 / 6, 191 / 8 / 2, 103 / 9 / 2, 212 / 10 / 3, 143 / 11 / 2, 198 / 12 / 5, 4 / 13 / 2, 115 / 14 / 3, 11 / 15 / 2, 82 / 16 / 2, 47 / 17 / 5, 71 / 18 / 2, 148 / 19 / 2, 246 / 20 / 2, 97 / 21 / 3, 35 / 22 / 2, 217 / 23 / 3, 76 / 24 / 2, 88 / 25 / 3, 99 / 26 / 2, 227 / 27 / 2, 91 / 28 / 3, 85 / 29 / 2, 249 / 30 / 3, 44 / 31 / 2, 19 / 32 / 2, 48 / 33 / 2, 151 / 34 / 3, 222 / 35 / 2, 177 / 36 / 2, 189 / 37 / 2, 100 / 38 / 2, 32 / 39 / 2, 105 / 40 / 2, 107 / 41 / 2, 40 / 42 / 2, 188 / 43 / 2, 221 / 44 / 2, 23 / 45 / 2, 157 / 46 / 2, 41 / 47 / 4, 187 / 48 / 2, 232 / 49 / 2, 122 / 50 / 4, 130 / 51 / 2, 96 / 52 / 2, 164 / 53 / 2, 238 / 54 / 6, 178 / 55 / 2, 74 / 56 / 2, 162 / 57 / 2, 24 / 58 / 2, 247 / 59 / 2, 158 / 60 / 2, 109 / 61 / 2, 28 / 62 / 2, 137 / 63 / 2, 118 / 64 / 3, 80 / 65 / 2, 72 / 66 / 3, 75 / 67 / 2, 200 / 68 / 3, 26 / 69 / 2, 104 / 70 / 3, 128 / 71 / 2, 84 / 72 / 2, 68 / 73 / 3, 230 / 74 / 2, 136 / 75 / 3, 116 / 76 / 2, 184 / 77 / 3, 160 / 78 / 2, 233 / 79 / 3, 211 / 80 / 2, 228 / 81 / 3, 154 / 82 / 2, 101 / 83 / 3, 7 / 84 / 2, 195 / 85 / 2, 79 / 86 / 2, 131 / 87 / 9, 98 / 88 / 2, 33 / 89 / 2, 87 / 90 / 2, 81 / 91 / 2, 218 / 92 / 2, 235 / 93 / 2, 210 / 94 / 3, 216 / 95 / 2, 186 / 96 / 5, 57 / 97 / 2, 90 / 98 / 2, 95 / 99 / 2, 111 / 100 / 4, 50 / 101 / 2, 214 / 102 / 2, 169 / 103 / 3, 182 / 104 / 2, 106 / 105 / 2, 244 / 106 / 3, 239 / 107 / 2, 8 / 108 / 3, 161 / 109 / 2, 167 / 110 / 2, 34 / 111 / 2, 119 / 112 / 2, 194 / 113 / 2, 45 / 114 / 2, 180 / 115 / 2, 126 / 116 / 3, 241 / 117 / 2, 208 / 118 / 2, 12 / 119 / 2, 231 / 120 / 2, 102 / 121 / 2, 134 / 122 / 2, 155 / 123 / 3, 94 / 124 / 2, 54 / 125 / 4, 153 / 126 / 2, 30 / 127 / 2, 159 / 128 / 3, 36 / 129 / 2, 242 / 130 / 3, 21 / 131 / 2, 203 / 132 / 4, 92 / 133 / 2, 31 / 134 / 2, 73 / 135 / 2, 185 / 136 / 14, 209 / 137 / 2, 196 / 138 / 2, 117 / 139 / 2, 135 / 140 / 4, 37 / 141 / 2, 229 / 142 / 2, 125 / 143 / 2, 123 / 144 / 2, 147 / 145 / 4, 15 / 146 / 2, 138 / 147 / 2, 201 / 148 / 2, 183 / 149 / 2, 108 / 150 / 2, 63 / 151 / 2, 27 / 152 / 2, 150 / 153 / 2, 141 / 154 / 3, 61 / 155 / 2, 199 / 156 / 2, 56 / 157 / 7, 170 / 158 / 2, 9 / 159 / 3, 89 / 160 / 2, 236 / 161 / 2, 14 / 162 / 2, 25 / 163 / 4, 213 / 164 / 2, 62 / 165 / 3, 237 / 166 / 2, 93 / 167 / 2, 114 / 168 / 7, 29 / 169 / 2, 175 / 170 / 2, 38 / 171 / 2, 78 / 172 / 5, 66 / 173 / 2, 120 / 174 / 2, 166 / 175 / 2, 204 / 176 / 4, 42 / 177 / 2, 139 / 178 / 2, 224 / 179 / 4, 59 / 180 / 2, 168 / 181 / 2, 3 / 182 / 2, 13 / 183 / 2, 142 / 184 / 2, 205 / 185 / 2, 193 / 186 / 5, 248 / 187 / 2, 16 / 188 / 3, 1 / 189 / 2, 171 / 190 / 2, 112 / 191 / 4, 5 / 192 / 2, 86 / 193 / 2, 173 / 194 / 3, 176 / 195 / 2, 43 / 196 / 2, 113 / 197 / 6, 163 / 198 / 2, 49 / 199 / 2, 145 / 200 / 3, 18 / 201 / 2, 20 / 202 / 2, 192 / 203 / 3, 55 / 204 / 2, 149 / 205 / 3, 172 / 206 / 2, 174 / 207 / 3, 226 / 208 / 2, 2 / 209 / 3, 240 / 210 / 2, 223 / 211 / 2, 146 / 212 / 2, 10 / 213 / 3, 6 / 214 / 2, 53 / 215 / 2, 144 / 216 / 2, 110 / 217 / 3, 17 / 218 / 2, 207 / 219 / 2, 69 / 220 / 2, 60 / 221 / 3, 22 / 222 / 2, 225 / 223 / 3, 245 / 224 / 2, 52 / 225 / 2, 83 / 226 / 3, 121 / 227 / 2, 219 / 228 / 3, 156 / 229 / 2, 58 / 230 / 2, 133 / 231 / 3, 140 / 232 / 2, 202 / 233 / 3, 234 / 234 / 2, 220 / 235 / 3, 197 / 236 / 2, 127 / 237 / 2, 46 / 238 / 2, 39 / 239 / 2, 179 / 240 / 2, 132 / 241 / 2, 152 / 242 / 4, 181 / 243 / 2, 165 / 244 / 2, 67 / 245 / 2, 206 / 246 / 5, 129 / 247 / 2, 124 / 248 / 2, 215 / 249 / 4
doublecenter-alpha_1-12-n375.txt, 1, 1, 375, 3885.1, 3210, 2835, 23, 374,188 / 1 / 4, 209 / 2 / 2, 63 / 3 / 2, 3 / 4 / 2, 185 / 5 / 2, 312 / 6 / 2, 285 / 7 / 2, 31 / 8 / 2, 332 / 9 / 3, 4 / 10 / 2, 151 / 11 / 2, 161 / 12 / 2, 272 / 13 / 2, 203 / 14 / 2, 329 / 15 / 3, 245 / 16 / 2, 115 / 17 / 3, 355 / 18 / 2, 358 / 19 / 2, 268 / 20 / 7, 102 / 21 / 2, 214 / 22 / 3, 9 / 23 / 2, 125 / 24 / 3, 310 / 25 / 2, 343 / 26 / 5, 92 / 27 / 2, 98 / 28 / 2, 373 / 29 / 3, 157 / 30 / 2, 152 / 31 / 4, 222 / 32 / 2, 283 / 33 / 2, 19 / 34 / 3, 210 / 35 / 2, 299 / 36 / 4, 147 / 37 / 2, 263 / 38 / 2, 368 / 39 / 4, 186 / 40 / 2, 23 / 41 / 3, 282 / 42 / 2, 175 / 43 / 3, 105 / 44 / 2, 308 / 45 / 2, 139 / 46 / 4, 68 / 47 / 2, 45 / 48 / 2, 202 / 49 / 3, 327 / 50 / 2, 140 / 51 / 2, 174 / 52 / 2, 81 / 53 / 3, 111 / 54 / 2, 351 / 55 / 3, 52 / 56 / 2, 94 / 57 / 2, 336 / 58 / 2, 25 / 59 / 2, 22 / 60 / 3, 180 / 61 / 2, 155 / 62 / 3, 28 / 63 / 2, 44 / 64 / 2, 87 / 65 / 3, 330 / 66 / 2, 142 / 67 / 3, 290 / 68 / 2, 138 / 69 / 3, 56 / 70 / 2, 13 / 71 / 3, 349 / 72 / 2, 334 / 73 / 2, 51 / 74 / 2, 306 / 75 / 2, 1 / 76 / 3, 190 / 77 / 2, 49 / 78 / 3, 267 / 79 / 2, 93 / 80 / 3, 148 / 81 / 2, 239 / 82 / 2, 34 / 83 / 3, 12 / 84 / 2, 253 / 85 / 3, 20 / 86 / 2, 313 / 87 / 2, 131 / 88 / 2, 153 / 89 / 3, 276 / 90 / 2, 226 / 91 / 3, 106 / 92 / 2, 14 / 93 / 2, 178 / 94 / 3, 170 / 95 / 2, 213 / 96 / 2, 364 / 97 / 2, 342 / 98 / 3, 60 / 99 / 2, 289 / 100 / 3, 347 / 101 / 2, 38 / 102 / 2, 264 / 103 / 2, 293 / 104 / 2, 133 / 105 / 2, 67 / 106 / 6, 166 / 107 / 2, 295 / 108 / 2, 129 / 109 / 4, 298 / 110 / 2, 348 / 111 / 2, 53 / 112 / 2, 95 / 113 / 4, 160 / 114 / 2, 114 / 115 / 2, 325 / 116 / 2, 366 / 117 / 4, 2 / 118 / 2, 191 / 119 / 2, 321 / 120 / 4, 107 / 121 / 2, 136 / 122 / 2, 236 / 123 / 2, 197 / 124 / 2, 168 / 125 / 2, 243 / 126 / 3, 78 / 127 / 2, 57 / 128 / 3, 231 / 129 / 2, 85 / 130 / 5, 11 / 131 / 2, 305 / 132 / 2, 307 / 133 / 2, 112 / 134 / 3, 76 / 135 / 2, 71 / 136 / 2, 32 / 137 / 4, 240 / 138 / 2, 179 / 139 / 2, 367 / 140 / 3, 250 / 141 / 2, 357 / 142 / 2, 331 / 143 / 2, 73 / 144 / 2, 241 / 145 / 3, 337 / 146 / 2, 16 / 147 / 2, 89 / 148 / 3, 55 / 149 / 2, 345 / 150 / 3, 363 / 151 / 2, 164 / 152 / 3, 119 / 153 / 2, 233 / 154 / 3, 103 / 155 / 2, 255 / 156 / 2, 7 / 157 / 2, 238 / 158 / 2, 181 / 159 / 3, 146 / 160 / 2, 162 / 161 / 2, 109 / 162 / 2, 69 / 163 / 2, 50 / 164 / 2, 333 / 165 / 4, 362 / 166 / 2, 196 / 167 / 2, 192 / 168 / 2, 90 / 169 / 3, 303 / 170 / 2, 130 / 171 / 4, 223 / 172 / 2, 127 / 173 / 2, 365 / 174 / 4, 154 / 175 / 2, 278 / 176 / 2, 201 / 177 / 3, 277 / 178 / 2, 230 / 179 / 2, 237 / 180 / 2, 326 / 181 / 3, 194 / 182 / 2, 205 / 183 / 2, 360 / 184 / 2, 288 / 185 / 2, 30 / 186 / 2, 242 / 187 / 2, 206 / 188 / 2, 328 / 189 / 2, 199 / 190 / 2, 361 / 191 / 2, 132 / 192 / 2, 86 / 193 / 2, 261 / 194 / 4, 252 / 195 / 2, 228 / 196 / 2, 104 / 197 / 2, 99 / 198 / 3, 116 / 199 / 2, 254 / 200 / 2, 150 / 201 / 2, 35 / 202 / 3, 172 / 203 / 2, 369 / 204 / 3, 47 / 205 / 2, 108 / 206 / 2, 300 / 207 / 2, 124 / 208 / 3, 204 / 209 / 2, 126 / 210 / 2, 48 / 211 / 2, 88 / 212 / 2, 187 / 213 / 3, 211 / 214 / 2, 244 / 215 / 3, 291 / 216 / 2, 77 / 217 / 3, 82 / 218 / 2, 83 / 219 / 3, 59 / 220 / 2, 262 / 221 / 3, 338 / 222 / 2, 335 / 223 / 2, 15 / 224 / 3, 309 / 225 / 2, 297 / 226 / 2, 66 / 227 / 2, 350 / 228 / 2, 158 / 229 / 3, 346 / 230 / 2, 232 / 231 / 3, 149 / 232 / 2, 215 / 233 / 2, 21 / 234 / 3, 171 / 235 / 2, 280 / 236 / 2, 163 / 237 / 3, 260 / 238 / 2, 317 / 239 / 2, 79 / 240 / 3, 198 / 241 / 2, 273 / 242 / 4, 18 / 243 / 2, 195 / 244 / 2, 156 / 245 / 2, 284 / 246 / 2, 135 / 247 / 4, 177 / 248 / 2, 271 / 249 / 2, 200 / 250 / 2, 216 / 251 / 2, 279 / 252 / 4, 184 / 253 / 2, 10 / 254 / 2, 54 / 255 / 3, 128 / 256 / 2, 259 / 257 / 2, 315 / 258 / 2, 287 / 259 / 2, 6 / 260 / 5, 359 / 261 / 2, 302 / 262 / 3, 218 / 263 / 2, 173 / 264 / 2, 274 / 265 / 3, 36 / 266 / 2, 72 / 267 / 3, 100 / 268 / 2, 134 / 269 / 2, 39 / 270 / 3, 265 / 271 / 2, 80 / 272 / 2, 169 / 273 / 3, 344 / 274 / 2, 234 / 275 / 3, 26 / 276 / 2, 70 / 277 / 3, 319 / 278 / 2, 176 / 279 / 3, 235 / 280 / 2, 246 / 281 / 2, 65 / 282 / 2, 339 / 283 / 3, 286 / 284 / 2, 37 / 285 / 2, 251 / 286 / 2, 257 / 287 / 3, 183 / 288 / 2, 40 / 289 / 2, 113 / 290 / 3, 248 / 291 / 2, 91 / 292 / 2, 258 / 293 / 3, 217 / 294 / 2, 62 / 295 / 2, 17 / 296 / 3, 118 / 297 / 2, 61 / 298 / 3, 123 / 299 / 2, 354 / 300 / 3, 212 / 301 / 2, 97 / 302 / 5, 27 / 303 / 2, 220 / 304 / 2, 182 / 305 / 3, 64 / 306 / 2, 269 / 307 / 3, 120 / 308 / 2, 117 / 309 / 3, 8 / 310 / 2, 193 / 311 / 2, 145 / 312 / 2, 304 / 313 / 2, 353 / 314 / 2, 221 / 315 / 2, 227 / 316 / 2, 311 / 317 / 2, 301 / 318 / 3, 101 / 319 / 2, 371 / 320 / 2, 143 / 321 / 2, 322 / 322 / 2, 74 / 323 / 4, 24 / 324 / 2, 84 / 325 / 2, 292 / 326 / 3, 256 / 327 / 2, 324 / 328 / 4, 122 / 329 / 2, 224 / 330 / 2, 374 / 331 / 3, 141 / 332 / 2, 314 / 333 / 2, 33 / 334 / 4, 167 / 335 / 2, 208 / 336 / 2, 29 / 337 / 2, 58 / 338 / 2, 96 / 339 / 2, 189 / 340 / 2, 159 / 341 / 2, 370 / 342 / 3, 225 / 343 / 2, 42 / 344 / 2, 281 / 345 / 3, 75 / 346 / 2, 207 / 347 / 3, 5 / 348 / 2, 43 / 349 / 2, 294 / 350 / 2, 340 / 351 / 3, 46 / 352 / 2, 296 / 353 / 3, 356 / 354 / 2, 165 / 355 / 3, 110 / 356 / 2, 341 / 357 / 3, 270 / 358 / 2, 275 / 359 / 2, 219 / 360 / 5, 229 / 361 / 2, 372 / 362 / 2, 41 / 363 / 2, 318 / 364 / 23, 121 / 365 / 2, 144 / 366 / 2, 247 / 367 / 3, 320 / 368 / 2, 266 / 369 / 2, 352 / 370 / 4, 137 / 371 / 2, 316 / 372 / 2, 249 / 373 / 2, 323 / 374 / 2
doublecenter-alpha_1-12-n500.txt, 1, 1, 500, 4246.35, 3849, 3349, 7, 499,201 / 1 / 3, 107 / 2 / 2, 101 / 3 / 2, 326 / 4 / 3, 327 / 5 / 2, 280 / 6 / 2, 412 / 7 / 3, 129 / 8 / 2, 191 / 9 / 3, 252 / 10 / 2, 411 / 11 / 4, 49 / 12 / 2, 227 / 13 / 2, 306 / 14 / 4, 85 / 15 / 2, 185 / 16 / 2, 380 / 17 / 3, 58 / 18 / 2, 211 / 19 / 2, 202 / 20 / 3, 117 / 21 / 2, 120 / 22 / 2, 63 / 23 / 2, 287 / 24 / 4, 104 / 25 / 2, 381 / 26 / 2, 348 / 27 / 2, 87 / 28 / 2, 476 / 29 / 3, 123 / 30 / 2, 95 / 31 / 3, 145 / 32 / 2, 393 / 33 / 3, 358 / 34 / 2, 141 / 35 / 2, 209 / 36 / 2, 397 / 37 / 2, 478 / 38 / 2, 232 / 39 / 3, 309 / 40 / 2, 497 / 41 / 2, 312 / 42 / 2, 127 / 43 / 2, 319 / 44 / 3, 296 / 45 / 2, 261 / 46 / 3, 116 / 47 / 2, 489 / 48 / 3, 406 / 49 / 2, 353 / 50 / 2, 275 / 51 / 5, 345 / 52 / 2, 40 / 53 / 2, 395 / 54 / 2, 239 / 55 / 2, 50 / 56 / 2, 300 / 57 / 4, 113 / 58 / 2, 424 / 59 / 2, 453 / 60 / 3, 273 / 61 / 2, 352 / 62 / 2, 8 / 63 / 3, 247 / 64 / 2, 494 / 65 / 2, 257 / 66 / 2, 199 / 67 / 2, 464 / 68 / 5, 91 / 69 / 2, 405 / 70 / 2, 90 / 71 / 3, 487 / 72 / 2, 133 / 73 / 3, 179 / 74 / 2, 99 / 75 / 3, 288 / 76 / 2, 194 / 77 / 3, 204 / 78 / 2, 96 / 79 / 2, 54 / 80 / 2, 359 / 81 / 3, 400 / 82 / 2, 76 / 83 / 3, 446 / 84 / 2, 246 / 85 / 2, 490 / 86 / 2, 186 / 87 / 2, 399 / 88 / 2, 170 / 89 / 2, 374 / 90 / 3, 55 / 91 / 2, 73 / 92 / 2, 429 / 93 / 2, 119 / 94 / 3, 396 / 95 / 2, 418 / 96 / 3, 12 / 97 / 2, 385 / 98 / 3, 376 / 99 / 2, 243 / 100 / 4, 111 / 101 / 2, 372 / 102 / 2, 302 / 103 / 2, 161 / 104 / 2, 364 / 105 / 2, 330 / 106 / 3, 256 / 107 / 2, 45 / 108 / 4, 336 / 109 / 2, 351 / 110 / 2, 425 / 111 / 3, 390 / 112 / 2, 382 / 113 / 4, 177 / 114 / 2, 106 / 115 / 2, 349 / 116 / 2, 340 / 117 / 2, 480 / 118 / 2, 262 / 119 / 4, 47 / 120 / 2, 29 / 121 / 3, 213 / 122 / 2, 149 / 123 / 3, 440 / 124 / 2, 485 / 125 / 2, 468 / 126 / 2, 368 / 127 / 3, 65 / 128 / 2, 236 / 129 / 3, 310 / 130 / 2, 343 / 131 / 2, 281 / 132 / 2, 264 / 133 / 2, 154 / 134 / 3, 286 / 135 / 2, 52 / 136 / 2, 94 / 137 / 2, 277 / 138 / 2, 17 / 139 / 2, 244 / 140 / 2, 461 / 141 / 2, 443 / 142 / 4, 226 / 143 / 2, 266 / 144 / 2, 89 / 145 / 2, 283 / 146 / 2, 48 / 147 / 2, 482 / 148 / 4, 164 / 149 / 2, 361 / 150 / 2, 493 / 151 / 2, 328 / 152 / 4, 70 / 153 / 2, 105 / 154 / 2, 128 / 155 / 3, 355 / 156 / 2, 24 / 157 / 2, 474 / 158 / 2, 242 / 159 / 2, 471 / 160 / 2, 3 / 161 / 5, 298 / 162 / 2, 207 / 163 / 2, 389 / 164 / 2, 22 / 165 / 4, 188 / 166 / 2, 9 / 167 / 3, 366 / 168 / 2, 438 / 169 / 3, 37 / 170 / 2, 311 / 171 / 4, 68 / 172 / 2, 237 / 173 / 2, 162 / 174 / 2, 254 / 175 / 2, 235 / 176 / 2, 477 / 177 / 2, 124 / 178 / 2, 284 / 179 / 4, 403 / 180 / 2, 253 / 181 / 2, 307 / 182 / 2, 81 / 183 / 2, 77 / 184 / 2, 196 / 185 / 2, 166 / 186 / 3, 238 / 187 / 2, 249 / 188 / 3, 78 / 189 / 2, 414 / 190 / 4, 13 / 191 / 2, 34 / 192 / 2, 98 / 193 / 2, 388 / 194 / 4, 337 / 195 / 2, 198 / 196 / 2, 62 / 197 / 3, 379 / 198 / 2, 84 / 199 / 2, 483 / 200 / 3, 347 / 201 / 2, 278 / 202 / 3, 139 / 203 / 2, 308 / 204 / 3, 1 / 205 / 2, 462 / 206 / 2, 408 / 207 / 2, 466 / 208 / 2, 240 / 209 / 4, 143 / 210 / 2, 392 / 211 / 2, 491 / 212 / 2, 176 / 213 / 2, 332 / 214 / 2, 234 / 215 / 2, 75 / 216 / 2, 88 / 217 / 3, 465 / 218 / 2, 71 / 219 / 2, 292 / 220 / 3, 82 / 221 / 2, 72 / 222 / 2, 74 / 223 / 4, 156 / 224 / 2, 228 / 225 / 2, 407 / 226 / 3, 299 / 227 / 2, 46 / 228 / 3, 137 / 229 / 2, 316 / 230 / 5, 427 / 231 / 2, 492 / 232 / 2, 475 / 233 / 2, 455 / 234 / 3, 103 / 235 / 2, 496 / 236 / 2, 334 / 237 / 3, 314 / 238 / 2, 221 / 239 / 2, 430 / 240 / 2, 423 / 241 / 2, 331 / 242 / 4, 160 / 243 / 2, 363 / 244 / 2, 5 / 245 / 3, 444 / 246 / 2, 267 / 247 / 2, 19 / 248 / 2, 367 / 249 / 3, 325 / 250 / 2, 39 / 251 / 2, 165 / 252 / 2, 147 / 253 / 3, 115 / 254 / 2, 157 / 255 / 3, 41 / 256 / 2, 282 / 257 / 2, 4 / 258 / 2, 272 / 259 / 2, 271 / 260 / 4, 230 / 261 / 2, 370 / 262 / 2, 102 / 263 / 3, 57 / 264 / 2, 437 / 265 / 2, 322 / 266 / 3, 180 / 267 / 2, 486 / 268 / 2, 442 / 269 / 2, 422 / 270 / 2, 454 / 271 / 2, 426 / 272 / 3, 171 / 273 / 2, 189 / 274 / 3, 448 / 275 / 2, 118 / 276 / 2, 35 / 277 / 3, 285 / 278 / 2, 445 / 279 / 5, 59 / 280 / 2, 33 / 281 / 2, 69 / 282 / 2, 274 / 283 / 2, 56 / 284 / 2, 417 / 285 / 2, 125 / 286 / 2, 32 / 287 / 3, 384 / 288 / 2, 158 / 289 / 3, 31 / 290 / 2, 258 / 291 / 2, 481 / 292 / 2, 387 / 293 / 2, 175 / 294 / 2, 415 / 295 / 2, 80 / 296 / 2, 173 / 297 / 4, 214 / 298 / 2, 373 / 299 / 2, 354 / 300 / 4, 449 / 301 / 2, 203 / 302 / 2, 269 / 303 / 4, 174 / 304 / 2, 245 / 305 / 2, 342 / 306 / 2, 126 / 307 / 3, 432 / 308 / 2, 450 / 309 / 2, 365 / 310 / 2, 178 / 311 / 3, 16 / 312 / 2, 28 / 313 / 2, 413 / 314 / 2, 219 / 315 / 2, 398 / 316 / 2, 183 / 317 / 3, 248 / 318 / 2, 138 / 319 / 2, 463 / 320 / 2, 255 / 321 / 5, 61 / 322 / 2, 303 / 323 / 2, 460 / 324 / 4, 260 / 325 / 2, 134 / 326 / 2, 197 / 327 / 3, 304 / 328 / 2, 469 / 329 / 3, 150 / 330 / 2, 83 / 331 / 3, 386 / 332 / 2, 420 / 333 / 2, 15 / 334 / 2, 265 / 335 / 2, 297 / 336 / 4, 121 / 337 / 2, 26 / 338 / 2, 321 / 339 / 2, 479 / 340 / 2, 210 / 341 / 2, 135 / 342 / 2, 131 / 343 / 2, 192 / 344 / 2, 225 / 345 / 3, 313 / 346 / 2, 153 / 347 / 3, 168 / 348 / 2, 404 / 349 / 4, 402 / 350 / 2, 270 / 351 / 2, 144 / 352 / 3, 112 / 353 / 2, 391 / 354 / 3, 451 / 355 / 2, 484 / 356 / 2, 335 / 357 / 2, 362 / 358 / 2, 410 / 359 / 2, 155 / 360 / 7, 223 / 361 / 2, 350 / 362 / 2, 456 / 363 / 4, 122 / 364 / 2, 344 / 365 / 2, 195 / 366 / 4, 229 / 367 / 2, 51 / 368 / 2, 182 / 369 / 4, 30 / 370 / 2, 169 / 371 / 2, 231 / 372 / 4, 435 / 373 / 2, 215 / 374 / 2, 60 / 375 / 4, 132 / 376 / 2, 21 / 377 / 2, 224 / 378 / 4, 473 / 379 / 2, 193 / 380 / 2, 43 / 381 / 4, 324 / 382 / 2, 251 / 383 / 2, 2 / 384 / 2, 181 / 385 / 2, 369 / 386 / 2, 241 / 387 / 2, 212 / 388 / 4, 339 / 389 / 2, 357 / 390 / 2, 383 / 391 / 4, 333 / 392 / 2, 151 / 393 / 2, 53 / 394 / 3, 7 / 395 / 2, 187 / 396 / 2, 346 / 397 / 2, 190 / 398 / 2, 439 / 399 / 2, 92 / 400 / 2, 447 / 401 / 3, 268 / 402 / 2, 14 / 403 / 2, 431 / 404 / 3, 375 / 405 / 2, 428 / 406 / 2, 433 / 407 / 3, 44 / 408 / 2, 315 / 409 / 2, 97 / 410 / 2, 459 / 411 / 2, 259 / 412 / 3, 305 / 413 / 2, 276 / 414 / 3, 394 / 415 / 2, 152 / 416 / 2, 140 / 417 / 2, 338 / 418 / 4, 317 / 419 / 2, 378 / 420 / 2, 409 / 421 / 2, 23 / 422 / 3, 216 / 423 / 2, 167 / 424 / 2, 371 / 425 / 2, 294 / 426 / 2, 109 / 427 / 7, 472 / 428 / 2, 291 / 429 / 2, 172 / 430 / 2, 250 / 431 / 2, 421 / 432 / 3, 356 / 433 / 2, 470 / 434 / 3, 360 / 435 / 2, 318 / 436 / 2, 290 / 437 / 2, 289 / 438 / 2, 146 / 439 / 2, 467 / 440 / 2, 452 / 441 / 3, 498 / 442 / 2, 38 / 443 / 3, 64 / 444 / 2, 205 / 445 / 2, 222 / 446 / 2, 108 / 447 / 2, 233 / 448 / 2, 206 / 449 / 3, 457 / 450 / 2, 10 / 451 / 2, 441 / 452 / 3, 329 / 453 / 2, 377 / 454 / 2, 136 / 455 / 3, 293 / 456 / 2, 220 / 457 / 3, 163 / 458 / 2, 401 / 459 / 3, 67 / 460 / 2, 323 / 461 / 3, 218 / 462 / 2, 86 / 463 / 2, 458 / 464 / 2, 320 / 465 / 4, 11 / 466 / 2, 148 / 467 / 3, 279 / 468 / 2, 130 / 469 / 2, 25 / 470 / 2, 495 / 471 / 4, 42 / 472 / 2, 263 / 473 / 2, 341 / 474 / 3, 36 / 475 / 2, 114 / 476 / 2, 159 / 477 / 4, 434 / 478 / 2, 301 / 479 / 2, 200 / 480 / 2, 499 / 481 / 3, 436 / 482 / 2, 295 / 483 / 3, 488 / 484 / 2, 18 / 485 / 3, 142 / 486 / 2, 110 / 487 / 2, 6 / 488 / 2, 184 / 489 / 2, 416 / 490 / 2, 27 / 491 / 4, 100 / 492 / 2, 419 / 493 / 2, 93 / 494 / 2, 66 / 495 / 2, 20 / 496 / 2, 79 / 497 / 2, 208 / 498 / 2, 217 / 499 / 2
doublecenter-alpha_1-12-n6.txt, 1, 1, 6, 540.077, 24, 18, 3, 5,5 / 1 / 2, 2 / 2 / 2, 1 / 3 / 2, 4 / 4 / 2, 3 / 5 / 3
doublecenter-alpha_1-120-n250.txt, 1, 1, 250, 3160.13, 2118, 1868, 9, 249,57 / 1 / 5, 156 / 2 / 2, 116 / 3 / 2, 92 / 4 / 3, 87 / 5 / 2, 98 / 6 / 2, 182 / 7 / 2, 93 / 8 / 2, 71 / 9 / 3, 170 / 10 / 2, 105 / 11 / 2, 189 / 12 / 2, 40 / 13 / 2, 124 / 14 / 2, 61 / 15 / 3, 145 / 16 / 2, 119 / 17 / 2, 29 / 18 / 3, 235 / 19 / 2, 236 / 20 / 2, 211 / 21 / 2, 167 / 22 / 3, 37 / 23 / 2, 21 / 24 / 2, 34 / 25 / 2, 81 / 26 / 4, 1 / 27 / 2, 149 / 28 / 2, 150 / 29 / 4, 19 / 30 / 2, 91 / 31 / 2, 143 / 32 / 4, 115 / 33 / 2, 56 / 34 / 2, 24 / 35 / 2, 114 / 36 / 2, 78 / 37 / 2, 83 / 38 / 2, 17 / 39 / 2, 120 / 40 / 7, 58 / 41 / 2, 173 / 42 / 2, 103 / 43 / 2, 210 / 44 / 3, 11 / 45 / 2, 198 / 46 / 3, 15 / 47 / 2, 12 / 48 / 2, 178 / 49 / 2, 245 / 50 / 2, 132 / 51 / 4, 147 / 52 / 2, 146 / 53 / 2, 43 / 54 / 2, 54 / 55 / 5, 176 / 56 / 2, 233 / 57 / 3, 14 / 58 / 2, 225 / 59 / 2, 45 / 60 / 2, 51 / 61 / 2, 161 / 62 / 3, 111 / 63 / 2, 242 / 64 / 2, 70 / 65 / 4, 209 / 66 / 2, 192 / 67 / 3, 26 / 68 / 2, 128 / 69 / 3, 217 / 70 / 2, 193 / 71 / 3, 201 / 72 / 2, 82 / 73 / 3, 130 / 74 / 2, 10 / 75 / 3, 152 / 76 / 2, 94 / 77 / 2, 169 / 78 / 2, 207 / 79 / 4, 36 / 80 / 2, 244 / 81 / 2, 44 / 82 / 2, 248 / 83 / 3, 100 / 84 / 2, 97 / 85 / 2, 159 / 86 / 3, 190 / 87 / 2, 227 / 88 / 3, 64 / 89 / 2, 42 / 90 / 2, 168 / 91 / 5, 25 / 92 / 2, 89 / 93 / 2, 23 / 94 / 2, 102 / 95 / 3, 31 / 96 / 2, 184 / 97 / 2, 108 / 98 / 4, 224 / 99 / 2, 117 / 100 / 2, 122 / 101 / 3, 180 / 102 / 2, 75 / 103 / 2, 243 / 104 / 2, 247 / 105 / 4, 144 / 106 / 2, 226 / 107 / 3, 220 / 108 / 2, 200 / 109 / 3, 241 / 110 / 2, 186 / 111 / 2, 199 / 112 / 3, 162 / 113 / 2, 62 / 114 / 3, 158 / 115 / 2, 151 / 116 / 2, 166 / 117 / 4, 205 / 118 / 2, 66 / 119 / 3, 160 / 120 / 2, 107 / 121 / 2, 137 / 122 / 2, 154 / 123 / 2, 55 / 124 / 3, 67 / 125 / 2, 35 / 126 / 2, 22 / 127 / 2, 195 / 128 / 2, 39 / 129 / 2, 183 / 130 / 4, 28 / 131 / 2, 121 / 132 / 2, 185 / 133 / 3, 63 / 134 / 2, 65 / 135 / 2, 228 / 136 / 2, 104 / 137 / 2, 13 / 138 / 2, 202 / 139 / 2, 206 / 140 / 2, 84 / 141 / 2, 68 / 142 / 2, 133 / 143 / 2, 50 / 144 / 9, 6 / 145 / 2, 126 / 146 / 3, 153 / 147 / 2, 74 / 148 / 2, 175 / 149 / 3, 234 / 150 / 2, 142 / 151 / 2, 196 / 152 / 3, 69 / 153 / 2, 138 / 154 / 3, 139 / 155 / 2, 27 / 156 / 2, 86 / 157 / 3, 20 / 158 / 2, 53 / 159 / 4, 48 / 160 / 2, 47 / 161 / 2, 230 / 162 / 4, 2 / 163 / 2, 163 / 164 / 3, 249 / 165 / 2, 157 / 166 / 3, 73 / 167 / 2, 208 / 168 / 2, 148 / 169 / 4, 179 / 170 / 2, 219 / 171 / 2, 125 / 172 / 2, 95 / 173 / 3, 99 / 174 / 2, 32 / 175 / 3, 127 / 176 / 2, 246 / 177 / 3, 118 / 178 / 2, 7 / 179 / 2, 155 / 180 / 3, 4 / 181 / 2, 59 / 182 / 3, 194 / 183 / 2, 3 / 184 / 2, 72 / 185 / 2, 85 / 186 / 2, 223 / 187 / 5, 8 / 188 / 2, 181 / 189 / 2, 214 / 190 / 2, 113 / 191 / 2, 229 / 192 / 2, 90 / 193 / 2, 88 / 194 / 2, 77 / 195 / 2, 172 / 196 / 2, 239 / 197 / 3, 30 / 198 / 2, 123 / 199 / 2, 204 / 200 / 5, 112 / 201 / 2, 197 / 202 / 3, 136 / 203 / 2, 129 / 204 / 2, 164 / 205 / 3, 5 / 206 / 2, 165 / 207 / 3, 218 / 208 / 2, 221 / 209 / 2, 33 / 210 / 3, 231 / 211 / 2, 106 / 212 / 5, 187 / 213 / 2, 203 / 214 / 3, 216 / 215 / 2, 9 / 216 / 2, 222 / 217 / 2, 76 / 218 / 5, 52 / 219 / 2, 80 / 220 / 3, 134 / 221 / 2, 213 / 222 / 3, 101 / 223 / 2, 18 / 224 / 2, 171 / 225 / 4, 60 / 226 / 2, 49 / 227 / 2, 96 / 228 / 2, 191 / 229 / 2, 141 / 230 / 2, 215 / 231 / 3, 140 / 232 / 2, 16 / 233 / 3, 110 / 234 / 2, 177 / 235 / 2, 38 / 236 / 2, 240 / 237 / 2, 174 / 238 / 2, 212 / 239 / 2, 131 / 240 / 6, 135 / 241 / 2, 238 / 242 / 2, 232 / 243 / 2, 79 / 244 / 2, 237 / 245 / 2, 188 / 246 / 3, 46 / 247 / 2, 41 / 248 / 2, 109 / 249 / 4
doublecenter-alpha_1-13-n375.txt, 1, 1, 375, 3710.86, 2835, 2460, 7, 374,148 / 1 / 5, 184 / 2 / 2, 183 / 3 / 2, 146 / 4 / 2, 244 / 5 / 3, 41 / 6 / 2, 328 / 7 / 4, 127 / 8 / 2, 35 / 9 / 2, 34 / 10 / 2, 176 / 11 / 2, 21 / 12 / 2, 364 / 13 / 2, 342 / 14 / 3, 69 / 15 / 2, 172 / 16 / 3, 94 / 17 / 2, 262 / 18 / 3, 280 / 19 / 2, 135 / 20 / 2, 151 / 21 / 4, 79 / 22 / 2, 243 / 23 / 2, 30 / 24 / 2, 29 / 25 / 2, 170 / 26 / 3, 140 / 27 / 2, 27 / 28 / 3, 98 / 29 / 2, 80 / 30 / 3, 133 / 31 / 2, 308 / 32 / 2, 278 / 33 / 2, 160 / 34 / 2, 334 / 35 / 3, 52 / 36 / 2, 97 / 37 / 4, 31 / 38 / 2, 50 / 39 / 2, 64 / 40 / 2, 60 / 41 / 2, 303 / 42 / 2, 320 / 43 / 2, 157 / 44 / 2, 229 / 45 / 3, 212 / 46 / 2, 269 / 47 / 2, 250 / 48 / 3, 318 / 49 / 2, 73 / 50 / 2, 18 / 51 / 2, 91 / 52 / 2, 114 / 53 / 2, 182 / 54 / 3, 265 / 55 / 2, 309 / 56 / 2, 119 / 57 / 3, 100 / 58 / 2, 302 / 59 / 3, 145 / 60 / 2, 6 / 61 / 2, 205 / 62 / 7, 84 / 63 / 2, 251 / 64 / 2, 108 / 65 / 2, 237 / 66 / 5, 130 / 67 / 2, 314 / 68 / 2, 362 / 69 / 2, 333 / 70 / 2, 95 / 71 / 2, 37 / 72 / 3, 236 / 73 / 2, 12 / 74 / 2, 268 / 75 / 3, 96 / 76 / 2, 124 / 77 / 2, 312 / 78 / 3, 63 / 79 / 2, 367 / 80 / 2, 53 / 81 / 2, 257 / 82 / 2, 1 / 83 / 2, 180 / 84 / 2, 132 / 85 / 2, 238 / 86 / 2, 286 / 87 / 2, 324 / 88 / 2, 153 / 89 / 3, 284 / 90 / 2, 115 / 91 / 2, 131 / 92 / 3, 134 / 93 / 2, 198 / 94 / 2, 279 / 95 / 3, 295 / 96 / 2, 317 / 97 / 3, 90 / 98 / 2, 233 / 99 / 3, 9 / 100 / 2, 137 / 101 / 2, 200 / 102 / 3, 105 / 103 / 2, 204 / 104 / 2, 345 / 105 / 2, 70 / 106 / 3, 225 / 107 / 2, 38 / 108 / 4, 66 / 109 / 2, 300 / 110 / 2, 209 / 111 / 3, 214 / 112 / 2, 352 / 113 / 2, 109 / 114 / 2, 294 / 115 / 2, 339 / 116 / 3, 85 / 117 / 2, 88 / 118 / 2, 261 / 119 / 2, 210 / 120 / 4, 150 / 121 / 2, 188 / 122 / 2, 33 / 123 / 3, 270 / 124 / 2, 351 / 125 / 2, 357 / 126 / 4, 227 / 127 / 2, 93 / 128 / 2, 72 / 129 / 2, 2 / 130 / 3, 165 / 131 / 2, 208 / 132 / 3, 274 / 133 / 2, 354 / 134 / 3, 353 / 135 / 2, 54 / 136 / 3, 173 / 137 / 2, 325 / 138 / 2, 267 / 139 / 3, 126 / 140 / 2, 216 / 141 / 4, 111 / 142 / 2, 343 / 143 / 3, 48 / 144 / 2, 51 / 145 / 3, 82 / 146 / 2, 197 / 147 / 3, 141 / 148 / 2, 297 / 149 / 2, 346 / 150 / 2, 154 / 151 / 3, 159 / 152 / 2, 241 / 153 / 3, 366 / 154 / 2, 32 / 155 / 3, 166 / 156 / 2, 163 / 157 / 3, 288 / 158 / 2, 24 / 159 / 2, 14 / 160 / 2, 305 / 161 / 2, 266 / 162 / 2, 65 / 163 / 3, 218 / 164 / 2, 356 / 165 / 2, 259 / 166 / 2, 174 / 167 / 6, 3 / 168 / 2, 338 / 169 / 2, 195 / 170 / 2, 361 / 171 / 2, 156 / 172 / 3, 350 / 173 / 2, 231 / 174 / 2, 206 / 175 / 2, 121 / 176 / 2, 327 / 177 / 2, 47 / 178 / 2, 46 / 179 / 2, 272 / 180 / 2, 255 / 181 / 4, 113 / 182 / 2, 341 / 183 / 2, 168 / 184 / 3, 319 / 185 / 2, 103 / 186 / 3, 107 / 187 / 2, 26 / 188 / 3, 371 / 189 / 2, 358 / 190 / 3, 282 / 191 / 2, 306 / 192 / 2, 102 / 193 / 3, 202 / 194 / 2, 369 / 195 / 3, 171 / 196 / 2, 122 / 197 / 3, 330 / 198 / 2, 276 / 199 / 3, 337 / 200 / 2, 161 / 201 / 3, 230 / 202 / 2, 234 / 203 / 5, 191 / 204 / 2, 298 / 205 / 2, 83 / 206 / 2, 221 / 207 / 2, 15 / 208 / 4, 67 / 209 / 2, 144 / 210 / 2, 110 / 211 / 2, 281 / 212 / 3, 55 / 213 / 2, 162 / 214 / 3, 155 / 215 / 2, 181 / 216 / 2, 147 / 217 / 3, 28 / 218 / 2, 89 / 219 / 2, 260 / 220 / 2, 311 / 221 / 2, 360 / 222 / 4, 193 / 223 / 2, 247 / 224 / 2, 368 / 225 / 5, 329 / 226 / 2, 355 / 227 / 3, 45 / 228 / 2, 331 / 229 / 3, 365 / 230 / 2, 248 / 231 / 3, 201 / 232 / 2, 203 / 233 / 3, 245 / 234 / 2, 149 / 235 / 2, 263 / 236 / 3, 152 / 237 / 2, 81 / 238 / 2, 74 / 239 / 2, 223 / 240 / 2, 136 / 241 / 2, 232 / 242 / 5, 158 / 243 / 2, 11 / 244 / 3, 104 / 245 / 2, 199 / 246 / 3, 373 / 247 / 2, 167 / 248 / 2, 220 / 249 / 3, 291 / 250 / 2, 76 / 251 / 2, 61 / 252 / 2, 219 / 253 / 4, 349 / 254 / 2, 370 / 255 / 2, 185 / 256 / 4, 316 / 257 / 2, 92 / 258 / 2, 307 / 259 / 2, 178 / 260 / 3, 372 / 261 / 2, 36 / 262 / 2, 359 / 263 / 2, 315 / 264 / 2, 235 / 265 / 2, 5 / 266 / 2, 323 / 267 / 2, 287 / 268 / 3, 226 / 269 / 2, 240 / 270 / 2, 211 / 271 / 2, 19 / 272 / 2, 62 / 273 / 2, 190 / 274 / 3, 78 / 275 / 2, 254 / 276 / 2, 23 / 277 / 4, 264 / 278 / 2, 118 / 279 / 3, 299 / 280 / 2, 117 / 281 / 2, 186 / 282 / 4, 139 / 283 / 2, 49 / 284 / 3, 196 / 285 / 2, 296 / 286 / 2, 43 / 287 / 3, 322 / 288 / 2, 301 / 289 / 3, 112 / 290 / 2, 86 / 291 / 2, 335 / 292 / 2, 249 / 293 / 3, 285 / 294 / 2, 120 / 295 / 4, 239 / 296 / 2, 189 / 297 / 2, 222 / 298 / 3, 179 / 299 / 2, 290 / 300 / 2, 252 / 301 / 2, 246 / 302 / 2, 348 / 303 / 3, 275 / 304 / 2, 283 / 305 / 2, 289 / 306 / 2, 106 / 307 / 2, 313 / 308 / 2, 142 / 309 / 2, 4 / 310 / 4, 25 / 311 / 2, 101 / 312 / 2, 207 / 313 / 3, 258 / 314 / 2, 56 / 315 / 2, 169 / 316 / 3, 256 / 317 / 2, 16 / 318 / 2, 58 / 319 / 2, 22 / 320 / 5, 224 / 321 / 2, 128 / 322 / 2, 164 / 323 / 3, 347 / 324 / 2, 143 / 325 / 4, 277 / 326 / 2, 71 / 327 / 2, 374 / 328 / 2, 7 / 329 / 4, 20 / 330 / 2, 273 / 331 / 2, 40 / 332 / 2, 57 / 333 / 3, 175 / 334 / 2, 138 / 335 / 2, 332 / 336 / 2, 59 / 337 / 3, 125 / 338 / 2, 39 / 339 / 2, 123 / 340 / 2, 13 / 341 / 2, 8 / 342 / 2, 44 / 343 / 2, 87 / 344 / 3, 77 / 345 / 2, 68 / 346 / 2, 292 / 347 / 3, 42 / 348 / 2, 10 / 349 / 3, 187 / 350 / 2, 336 / 351 / 2, 310 / 352 / 3, 293 / 353 / 2, 326 / 354 / 2, 304 / 355 / 2, 321 / 356 / 3, 217 / 357 / 2, 17 / 358 / 2, 271 / 359 / 2, 177 / 360 / 3, 344 / 361 / 2, 194 / 362 / 3, 129 / 363 / 2, 363 / 364 / 2, 340 / 365 / 3, 75 / 366 / 2, 192 / 367 / 2, 99 / 368 / 2, 242 / 369 / 3, 116 / 370 / 2, 253 / 371 / 2, 228 / 372 / 3, 215 / 373 / 2, 213 / 374 / 5
doublecenter-alpha_1-13-n500.txt, 1, 1, 500, 4098.87, 4117, 3617, 10, 499,263 / 1 / 2, 243 / 2 / 5, 53 / 3 / 2, 364 / 4 / 2, 116 / 5 / 2, 32 / 6 / 4, 68 / 7 / 2, 105 / 8 / 2, 465 / 9 / 3, 169 / 10 / 2, 213 / 11 / 3, 283 / 12 / 2, 93 / 13 / 2, 126 / 14 / 2, 228 / 15 / 3, 111 / 16 / 2, 252 / 17 / 2, 493 / 18 / 2, 394 / 19 / 3, 484 / 20 / 2, 15 / 21 / 3, 260 / 22 / 2, 498 / 23 / 2, 402 / 24 / 2, 310 / 25 / 3, 259 / 26 / 2, 384 / 27 / 3, 406 / 28 / 2, 87 / 29 / 3, 196 / 30 / 2, 452 / 31 / 2, 74 / 32 / 3, 95 / 33 / 2, 201 / 34 / 3, 64 / 35 / 2, 170 / 36 / 2, 399 / 37 / 2, 43 / 38 / 5, 285 / 39 / 2, 426 / 40 / 2, 477 / 41 / 2, 55 / 42 / 4, 20 / 43 / 2, 433 / 44 / 2, 318 / 45 / 3, 159 / 46 / 2, 27 / 47 / 3, 182 / 48 / 2, 372 / 49 / 3, 464 / 50 / 2, 113 / 51 / 2, 298 / 52 / 3, 234 / 53 / 2, 336 / 54 / 2, 104 / 55 / 2, 167 / 56 / 3, 382 / 57 / 2, 258 / 58 / 2, 150 / 59 / 2, 3 / 60 / 3, 379 / 61 / 2, 80 / 62 / 5, 270 / 63 / 2, 79 / 64 / 2, 102 / 65 / 2, 248 / 66 / 2, 419 / 67 / 3, 158 / 68 / 2, 366 / 69 / 2, 127 / 70 / 2, 153 / 71 / 2, 10 / 72 / 2, 485 / 73 / 4, 35 / 74 / 2, 40 / 75 / 2, 277 / 76 / 2, 418 / 77 / 4, 466 / 78 / 2, 26 / 79 / 2, 499 / 80 / 3, 112 / 81 / 2, 22 / 82 / 2, 200 / 83 / 6, 62 / 84 / 2, 186 / 85 / 3, 31 / 86 / 2, 154 / 87 / 2, 210 / 88 / 2, 76 / 89 / 3, 453 / 90 / 2, 199 / 91 / 2, 58 / 92 / 3, 276 / 93 / 2, 271 / 94 / 2, 145 / 95 / 3, 138 / 96 / 2, 395 / 97 / 3, 16 / 98 / 2, 151 / 99 / 2, 208 / 100 / 2, 448 / 101 / 4, 445 / 102 / 2, 415 / 103 / 3, 307 / 104 / 2, 391 / 105 / 4, 482 / 106 / 2, 215 / 107 / 2, 312 / 108 / 2, 229 / 109 / 2, 334 / 110 / 2, 242 / 111 / 2, 424 / 112 / 2, 142 / 113 / 2, 393 / 114 / 3, 222 / 115 / 2, 56 / 116 / 3, 497 / 117 / 2, 355 / 118 / 2, 352 / 119 / 3, 390 / 120 / 2, 13 / 121 / 2, 389 / 122 / 3, 236 / 123 / 2, 178 / 124 / 2, 28 / 125 / 2, 92 / 126 / 3, 347 / 127 / 2, 144 / 128 / 3, 474 / 129 / 2, 38 / 130 / 2, 197 / 131 / 3, 322 / 132 / 2, 495 / 133 / 2, 106 / 134 / 2, 431 / 135 / 3, 232 / 136 / 2, 141 / 137 / 2, 337 / 138 / 2, 160 / 139 / 5, 483 / 140 / 2, 348 / 141 / 3, 360 / 142 / 2, 388 / 143 / 3, 7 / 144 / 2, 203 / 145 / 4, 297 / 146 / 2, 261 / 147 / 3, 403 / 148 / 2, 398 / 149 / 3, 264 / 150 / 2, 301 / 151 / 3, 140 / 152 / 2, 414 / 153 / 3, 278 / 154 / 2, 137 / 155 / 3, 124 / 156 / 2, 231 / 157 / 3, 292 / 158 / 2, 184 / 159 / 3, 492 / 160 / 2, 281 / 161 / 3, 392 / 162 / 2, 290 / 163 / 3, 37 / 164 / 2, 19 / 165 / 2, 293 / 166 / 2, 417 / 167 / 2, 44 / 168 / 2, 220 / 169 / 2, 165 / 170 / 2, 98 / 171 / 2, 84 / 172 / 2, 420 / 173 / 2, 224 / 174 / 4, 363 / 175 / 2, 192 / 176 / 2, 191 / 177 / 3, 149 / 178 / 2, 131 / 179 / 2, 42 / 180 / 4, 361 / 181 / 2, 487 / 182 / 2, 371 / 183 / 3, 211 / 184 / 2, 462 / 185 / 5, 157 / 186 / 2, 47 / 187 / 2, 130 / 188 / 2, 279 / 189 / 2, 107 / 190 / 3, 378 / 191 / 2, 330 / 192 / 2, 51 / 193 / 3, 59 / 194 / 2, 6 / 195 / 3, 181 / 196 / 2, 114 / 197 / 2, 180 / 198 / 2, 354 / 199 / 2, 96 / 200 / 3, 280 / 201 / 2, 407 / 202 / 2, 110 / 203 / 2, 185 / 204 / 3, 69 / 205 / 2, 471 / 206 / 2, 454 / 207 / 2, 442 / 208 / 2, 396 / 209 / 3, 316 / 210 / 2, 376 / 211 / 7, 119 / 212 / 2, 358 / 213 / 2, 478 / 214 / 2, 272 / 215 / 3, 30 / 216 / 2, 469 / 217 / 3, 410 / 218 / 2, 408 / 219 / 5, 425 / 220 / 2, 162 / 221 / 2, 85 / 222 / 3, 122 / 223 / 2, 8 / 224 / 2, 339 / 225 / 2, 218 / 226 / 5, 340 / 227 / 2, 341 / 228 / 2, 320 / 229 / 3, 309 / 230 / 2, 343 / 231 / 3, 481 / 232 / 2, 147 / 233 / 4, 326 / 234 / 2, 423 / 235 / 2, 202 / 236 / 2, 241 / 237 / 4, 444 / 238 / 2, 39 / 239 / 2, 369 / 240 / 2, 100 / 241 / 2, 198 / 242 / 3, 405 / 243 / 2, 251 / 244 / 3, 46 / 245 / 2, 435 / 246 / 3, 317 / 247 / 2, 118 / 248 / 2, 4 / 249 / 3, 175 / 250 / 2, 325 / 251 / 2, 205 / 252 / 2, 12 / 253 / 2, 479 / 254 / 3, 296 / 255 / 2, 54 / 256 / 3, 323 / 257 / 2, 125 / 258 / 2, 300 / 259 / 6, 490 / 260 / 2, 237 / 261 / 2, 24 / 262 / 3, 257 / 263 / 2, 412 / 264 / 3, 143 / 265 / 2, 308 / 266 / 3, 344 / 267 / 2, 83 / 268 / 2, 457 / 269 / 4, 120 / 270 / 2, 89 / 271 / 2, 335 / 272 / 2, 370 / 273 / 2, 5 / 274 / 2, 121 / 275 / 2, 33 / 276 / 2, 52 / 277 / 3, 468 / 278 / 2, 187 / 279 / 2, 78 / 280 / 2, 375 / 281 / 5, 71 / 282 / 2, 460 / 283 / 2, 359 / 284 / 2, 101 / 285 / 5, 331 / 286 / 2, 362 / 287 / 3, 345 / 288 / 2, 373 / 289 / 2, 173 / 290 / 5, 61 / 291 / 2, 204 / 292 / 2, 387 / 293 / 4, 266 / 294 / 2, 66 / 295 / 2, 254 / 296 / 2, 491 / 297 / 2, 25 / 298 / 2, 70 / 299 / 5, 313 / 300 / 2, 103 / 301 / 2, 475 / 302 / 2, 284 / 303 / 2, 77 / 304 / 3, 440 / 305 / 2, 132 / 306 / 2, 166 / 307 / 2, 381 / 308 / 2, 461 / 309 / 2, 447 / 310 / 2, 86 / 311 / 2, 434 / 312 / 3, 82 / 313 / 2, 274 / 314 / 2, 161 / 315 / 4, 338 / 316 / 2, 57 / 317 / 2, 287 / 318 / 3, 255 / 319 / 2, 115 / 320 / 3, 319 / 321 / 2, 171 / 322 / 2, 29 / 323 / 2, 45 / 324 / 2, 190 / 325 / 6, 315 / 326 / 2, 430 / 327 / 3, 227 / 328 / 2, 155 / 329 / 3, 269 / 330 / 2, 174 / 331 / 4, 496 / 332 / 2, 135 / 333 / 2, 383 / 334 / 2, 226 / 335 / 4, 449 / 336 / 2, 265 / 337 / 2, 214 / 338 / 3, 404 / 339 / 2, 194 / 340 / 3, 486 / 341 / 2, 36 / 342 / 3, 217 / 343 / 2, 289 / 344 / 2, 250 / 345 / 2, 422 / 346 / 3, 401 / 347 / 2, 14 / 348 / 4, 441 / 349 / 2, 288 / 350 / 2, 209 / 351 / 3, 219 / 352 / 2, 88 / 353 / 3, 333 / 354 / 2, 275 / 355 / 2, 249 / 356 / 3, 97 / 357 / 2, 463 / 358 / 2, 489 / 359 / 4, 470 / 360 / 2, 253 / 361 / 2, 328 / 362 / 2, 342 / 363 / 3, 356 / 364 / 2, 437 / 365 / 2, 235 / 366 / 3, 164 / 367 / 2, 239 / 368 / 3, 183 / 369 / 2, 223 / 370 / 4, 456 / 371 / 2, 476 / 372 / 2, 488 / 373 / 4, 216 / 374 / 2, 473 / 375 / 2, 225 / 376 / 2, 244 / 377 / 2, 212 / 378 / 5, 240 / 379 / 2, 230 / 380 / 2, 450 / 381 / 2, 314 / 382 / 5, 400 / 383 / 2, 349 / 384 / 2, 195 / 385 / 2, 324 / 386 / 2, 238 / 387 / 3, 188 / 388 / 2, 302 / 389 / 2, 163 / 390 / 3, 75 / 391 / 2, 397 / 392 / 2, 368 / 393 / 2, 480 / 394 / 2, 179 / 395 / 5, 207 / 396 / 2, 353 / 397 / 2, 94 / 398 / 2, 109 / 399 / 2, 9 / 400 / 5, 262 / 401 / 2, 467 / 402 / 2, 386 / 403 / 2, 50 / 404 / 2, 327 / 405 / 2, 176 / 406 / 3, 350 / 407 / 2, 168 / 408 / 2, 443 / 409 / 2, 346 / 410 / 2, 17 / 411 / 2, 294 / 412 / 2, 65 / 413 / 2, 411 / 414 / 2, 429 / 415 / 2, 329 / 416 / 2, 377 / 417 / 3, 146 / 418 / 2, 351 / 419 / 2, 365 / 420 / 4, 321 / 421 / 2, 63 / 422 / 2, 291 / 423 / 2, 99 / 424 / 2, 247 / 425 / 2, 446 / 426 / 2, 273 / 427 / 2, 421 / 428 / 3, 134 / 429 / 2, 303 / 430 / 4, 221 / 431 / 2, 385 / 432 / 3, 1 / 433 / 2, 128 / 434 / 2, 286 / 435 / 4, 117 / 436 / 2, 136 / 437 / 2, 409 / 438 / 2, 459 / 439 / 2, 374 / 440 / 2, 21 / 441 / 2, 367 / 442 / 2, 380 / 443 / 4, 267 / 444 / 2, 139 / 445 / 3, 306 / 446 / 2, 233 / 447 / 3, 494 / 448 / 2, 357 / 449 / 3, 193 / 450 / 2, 436 / 451 / 3, 23 / 452 / 2, 48 / 453 / 2, 245 / 454 / 2, 152 / 455 / 3, 472 / 456 / 2, 206 / 457 / 2, 432 / 458 / 2, 67 / 459 / 2, 123 / 460 / 2, 439 / 461 / 2, 246 / 462 / 5, 299 / 463 / 2, 428 / 464 / 2, 2 / 465 / 3, 90 / 466 / 2, 332 / 467 / 2, 413 / 468 / 2, 455 / 469 / 2, 304 / 470 / 2, 311 / 471 / 7, 91 / 472 / 2, 18 / 473 / 2, 81 / 474 / 3, 189 / 475 / 2, 73 / 476 / 2, 438 / 477 / 2, 60 / 478 / 2, 177 / 479 / 3, 108 / 480 / 2, 295 / 481 / 3, 11 / 482 / 2, 458 / 483 / 2, 49 / 484 / 2, 416 / 485 / 10, 72 / 486 / 2, 282 / 487 / 3, 34 / 488 / 2, 156 / 489 / 2, 41 / 490 / 2, 268 / 491 / 3, 427 / 492 / 2, 256 / 493 / 2, 172 / 494 / 2, 148 / 495 / 3, 451 / 496 / 2, 305 / 497 / 3, 133 / 498 / 2, 129 / 499 / 2
doublecenter-alpha_1-13-n6.txt, 1, 1, 6, 701.874, 25, 19, 6, 5,2 / 1 / 2, 5 / 2 / 2, 3 / 3 / 6, 4 / 4 / 2, 1 / 5 / 2
doublecenter-alpha_1-14-n375.txt, 1, 1, 375, 3909.05, 3122, 2747, 10, 374,338 / 1 / 3, 360 / 2 / 2, 287 / 3 / 2, 243 / 4 / 4, 11 / 5 / 2, 50 / 6 / 3, 10 / 7 / 2, 114 / 8 / 2, 296 / 9 / 2, 16 / 10 / 3, 201 / 11 / 2, 318 / 12 / 2, 153 / 13 / 2, 170 / 14 / 6, 175 / 15 / 2, 276 / 16 / 2, 244 / 17 / 3, 195 / 18 / 2, 286 / 19 / 2, 366 / 20 / 3, 245 / 21 / 2, 32 / 22 / 2, 246 / 23 / 2, 166 / 24 / 2, 110 / 25 / 4, 238 / 26 / 2, 94 / 27 / 2, 3 / 28 / 2, 128 / 29 / 10, 15 / 30 / 2, 81 / 31 / 2, 80 / 32 / 4, 140 / 33 / 2, 59 / 34 / 2, 186 / 35 / 2, 124 / 36 / 4, 264 / 37 / 2, 230 / 38 / 2, 293 / 39 / 2, 48 / 40 / 2, 220 / 41 / 2, 242 / 42 / 2, 290 / 43 / 2, 45 / 44 / 3, 78 / 45 / 2, 294 / 46 / 2, 270 / 47 / 3, 13 / 48 / 2, 172 / 49 / 3, 62 / 50 / 2, 266 / 51 / 2, 137 / 52 / 2, 215 / 53 / 4, 104 / 54 / 2, 192 / 55 / 2, 213 / 56 / 4, 216 / 57 / 2, 142 / 58 / 2, 326 / 59 / 3, 277 / 60 / 2, 85 / 61 / 2, 253 / 62 / 4, 125 / 63 / 2, 24 / 64 / 2, 60 / 65 / 2, 8 / 66 / 2, 138 / 67 / 2, 12 / 68 / 2, 353 / 69 / 3, 308 / 70 / 2, 349 / 71 / 2, 284 / 72 / 4, 106 / 73 / 2, 272 / 74 / 2, 281 / 75 / 2, 193 / 76 / 4, 199 / 77 / 2, 254 / 78 / 2, 65 / 79 / 3, 372 / 80 / 2, 52 / 81 / 2, 136 / 82 / 3, 241 / 83 / 2, 176 / 84 / 3, 256 / 85 / 2, 151 / 86 / 2, 249 / 87 / 2, 135 / 88 / 5, 22 / 89 / 2, 217 / 90 / 2, 38 / 91 / 2, 51 / 92 / 2, 255 / 93 / 4, 234 / 94 / 2, 99 / 95 / 3, 56 / 96 / 2, 158 / 97 / 3, 55 / 98 / 2, 329 / 99 / 2, 292 / 100 / 2, 295 / 101 / 2, 261 / 102 / 2, 316 / 103 / 2, 271 / 104 / 3, 263 / 105 / 2, 309 / 106 / 3, 119 / 107 / 2, 86 / 108 / 2, 278 / 109 / 4, 143 / 110 / 2, 174 / 111 / 2, 111 / 112 / 3, 334 / 113 / 2, 358 / 114 / 2, 219 / 115 / 3, 306 / 116 / 2, 289 / 117 / 3, 320 / 118 / 2, 285 / 119 / 2, 157 / 120 / 4, 235 / 121 / 2, 370 / 122 / 2, 252 / 123 / 3, 122 / 124 / 2, 179 / 125 / 2, 202 / 126 / 2, 149 / 127 / 2, 336 / 128 / 2, 345 / 129 / 2, 304 / 130 / 6, 144 / 131 / 2, 189 / 132 / 3, 257 / 133 / 2, 4 / 134 / 2, 200 / 135 / 2, 18 / 136 / 3, 180 / 137 / 2, 237 / 138 / 3, 14 / 139 / 2, 74 / 140 / 2, 40 / 141 / 3, 232 / 142 / 2, 68 / 143 / 2, 363 / 144 / 4, 27 / 145 / 2, 44 / 146 / 2, 346 / 147 / 2, 184 / 148 / 3, 117 / 149 / 2, 154 / 150 / 3, 109 / 151 / 2, 307 / 152 / 2, 112 / 153 / 3, 223 / 154 / 2, 369 / 155 / 2, 95 / 156 / 2, 132 / 157 / 2, 71 / 158 / 3, 37 / 159 / 2, 36 / 160 / 3, 228 / 161 / 2, 361 / 162 / 3, 90 / 163 / 2, 208 / 164 / 2, 247 / 165 / 4, 89 / 166 / 2, 374 / 167 / 2, 207 / 168 / 4, 167 / 169 / 2, 206 / 170 / 2, 355 / 171 / 2, 49 / 172 / 4, 6 / 173 / 2, 53 / 174 / 2, 64 / 175 / 2, 344 / 176 / 2, 371 / 177 / 2, 291 / 178 / 2, 339 / 179 / 2, 152 / 180 / 2, 105 / 181 / 2, 298 / 182 / 5, 210 / 183 / 2, 300 / 184 / 2, 66 / 185 / 2, 155 / 186 / 3, 185 / 187 / 2, 275 / 188 / 2, 214 / 189 / 4, 19 / 190 / 2, 333 / 191 / 3, 331 / 192 / 2, 126 / 193 / 5, 25 / 194 / 2, 280 / 195 / 2, 164 / 196 / 2, 145 / 197 / 2, 141 / 198 / 3, 325 / 199 / 2, 305 / 200 / 2, 115 / 201 / 3, 312 / 202 / 2, 351 / 203 / 2, 365 / 204 / 3, 197 / 205 / 2, 57 / 206 / 4, 92 / 207 / 2, 181 / 208 / 2, 356 / 209 / 3, 194 / 210 / 2, 83 / 211 / 2, 127 / 212 / 5, 233 / 213 / 2, 221 / 214 / 2, 76 / 215 / 3, 113 / 216 / 2, 159 / 217 / 2, 67 / 218 / 2, 328 / 219 / 3, 324 / 220 / 2, 188 / 221 / 2, 250 / 222 / 6, 118 / 223 / 2, 319 / 224 / 2, 279 / 225 / 2, 364 / 226 / 2, 203 / 227 / 2, 212 / 228 / 3, 54 / 229 / 2, 88 / 230 / 2, 39 / 231 / 3, 43 / 232 / 2, 226 / 233 / 2, 313 / 234 / 3, 102 / 235 / 2, 121 / 236 / 2, 29 / 237 / 3, 348 / 238 / 2, 314 / 239 / 2, 302 / 240 / 2, 315 / 241 / 2, 123 / 242 / 2, 239 / 243 / 2, 265 / 244 / 3, 73 / 245 / 2, 273 / 246 / 3, 337 / 247 / 2, 84 / 248 / 3, 196 / 249 / 2, 107 / 250 / 2, 323 / 251 / 2, 169 / 252 / 2, 368 / 253 / 2, 103 / 254 / 2, 30 / 255 / 3, 260 / 256 / 2, 87 / 257 / 2, 282 / 258 / 3, 191 / 259 / 2, 335 / 260 / 2, 1 / 261 / 4, 165 / 262 / 2, 131 / 263 / 2, 28 / 264 / 2, 91 / 265 / 5, 204 / 266 / 2, 70 / 267 / 3, 17 / 268 / 2, 93 / 269 / 2, 134 / 270 / 2, 150 / 271 / 3, 209 / 272 / 2, 198 / 273 / 2, 101 / 274 / 4, 35 / 275 / 2, 317 / 276 / 2, 340 / 277 / 2, 146 / 278 / 3, 23 / 279 / 2, 182 / 280 / 2, 274 / 281 / 2, 5 / 282 / 2, 163 / 283 / 2, 33 / 284 / 2, 20 / 285 / 2, 173 / 286 / 4, 63 / 287 / 2, 147 / 288 / 3, 262 / 289 / 2, 248 / 290 / 2, 268 / 291 / 4, 357 / 292 / 2, 347 / 293 / 3, 133 / 294 / 2, 9 / 295 / 2, 205 / 296 / 2, 367 / 297 / 3, 330 / 298 / 2, 321 / 299 / 4, 373 / 300 / 2, 82 / 301 / 2, 2 / 302 / 3, 231 / 303 / 2, 251 / 304 / 4, 130 / 305 / 2, 227 / 306 / 2, 218 / 307 / 2, 96 / 308 / 3, 47 / 309 / 2, 160 / 310 / 2, 139 / 311 / 2, 350 / 312 / 3, 225 / 313 / 2, 283 / 314 / 2, 352 / 315 / 3, 222 / 316 / 2, 269 / 317 / 3, 162 / 318 / 2, 42 / 319 / 4, 342 / 320 / 2, 31 / 321 / 2, 301 / 322 / 3, 72 / 323 / 2, 267 / 324 / 2, 236 / 325 / 2, 120 / 326 / 2, 297 / 327 / 3, 362 / 328 / 2, 258 / 329 / 2, 79 / 330 / 3, 26 / 331 / 2, 354 / 332 / 3, 327 / 333 / 2, 359 / 334 / 2, 97 / 335 / 2, 240 / 336 / 4, 75 / 337 / 2, 322 / 338 / 2, 41 / 339 / 9, 58 / 340 / 2, 7 / 341 / 2, 171 / 342 / 2, 161 / 343 / 2, 77 / 344 / 2, 98 / 345 / 5, 310 / 346 / 2, 156 / 347 / 2, 341 / 348 / 3, 177 / 349 / 2, 183 / 350 / 2, 187 / 351 / 3, 303 / 352 / 2, 343 / 353 / 3, 69 / 354 / 2, 211 / 355 / 3, 311 / 356 / 2, 224 / 357 / 2, 61 / 358 / 2, 129 / 359 / 2, 229 / 360 / 3, 46 / 361 / 2, 178 / 362 / 2, 21 / 363 / 3, 116 / 364 / 2, 148 / 365 / 3, 259 / 366 / 2, 190 / 367 / 3, 288 / 368 / 2, 108 / 369 / 2, 299 / 370 / 5, 168 / 371 / 2, 100 / 372 / 2, 332 / 373 / 2, 34 / 374 / 4
doublecenter-alpha_1-14-n500.txt, 1, 1, 500, 4529.08, 3762, 3262, 7, 499,235 / 1 / 2, 196 / 2 / 5, 47 / 3 / 2, 292 / 4 / 2, 498 / 5 / 2, 348 / 6 / 3, 29 / 7 / 2, 168 / 8 / 2, 225 / 9 / 4, 416 / 10 / 2, 163 / 11 / 2, 172 / 12 / 3, 360 / 13 / 2, 230 / 14 / 2, 401 / 15 / 3, 342 / 16 / 2, 135 / 17 / 3, 468 / 18 / 2, 1 / 19 / 2, 156 / 20 / 4, 22 / 21 / 2, 469 / 22 / 2, 369 / 23 / 2, 382 / 24 / 3, 281 / 25 / 2, 146 / 26 / 2, 358 / 27 / 2, 27 / 28 / 4, 306 / 29 / 2, 116 / 30 / 2, 157 / 31 / 4, 346 / 32 / 2, 439 / 33 / 2, 283 / 34 / 4, 349 / 35 / 2, 277 / 36 / 2, 165 / 37 / 3, 345 / 38 / 2, 185 / 39 / 3, 247 / 40 / 2, 275 / 41 / 2, 231 / 42 / 2, 54 / 43 / 2, 159 / 44 / 3, 477 / 45 / 2, 441 / 46 / 2, 142 / 47 / 2, 465 / 48 / 4, 388 / 49 / 2, 429 / 50 / 2, 362 / 51 / 4, 143 / 52 / 2, 315 / 53 / 2, 56 / 54 / 3, 256 / 55 / 2, 460 / 56 / 2, 359 / 57 / 2, 34 / 58 / 2, 162 / 59 / 2, 459 / 60 / 3, 70 / 61 / 2, 189 / 62 / 3, 395 / 63 / 2, 209 / 64 / 2, 219 / 65 / 3, 430 / 66 / 2, 202 / 67 / 2, 187 / 68 / 3, 253 / 69 / 2, 28 / 70 / 3, 109 / 71 / 2, 278 / 72 / 2, 137 / 73 / 3, 449 / 74 / 2, 97 / 75 / 3, 64 / 76 / 2, 280 / 77 / 2, 91 / 78 / 2, 340 / 79 / 2, 44 / 80 / 3, 14 / 81 / 2, 331 / 82 / 2, 320 / 83 / 2, 227 / 84 / 2, 434 / 85 / 2, 153 / 86 / 3, 310 / 87 / 2, 332 / 88 / 2, 319 / 89 / 3, 200 / 90 / 2, 16 / 91 / 2, 312 / 92 / 2, 384 / 93 / 2, 58 / 94 / 2, 161 / 95 / 2, 322 / 96 / 2, 57 / 97 / 2, 155 / 98 / 3, 167 / 99 / 2, 363 / 100 / 3, 325 / 101 / 2, 455 / 102 / 3, 383 / 103 / 2, 32 / 104 / 4, 144 / 105 / 2, 389 / 106 / 2, 458 / 107 / 3, 266 / 108 / 2, 484 / 109 / 3, 198 / 110 / 2, 136 / 111 / 2, 40 / 112 / 2, 175 / 113 / 2, 464 / 114 / 3, 437 / 115 / 2, 475 / 116 / 3, 379 / 117 / 2, 407 / 118 / 3, 78 / 119 / 2, 30 / 120 / 3, 193 / 121 / 2, 405 / 122 / 2, 425 / 123 / 3, 402 / 124 / 2, 301 / 125 / 3, 374 / 126 / 2, 470 / 127 / 2, 261 / 128 / 2, 274 / 129 / 3, 373 / 130 / 2, 94 / 131 / 2, 113 / 132 / 2, 133 / 133 / 3, 454 / 134 / 2, 13 / 135 / 2, 415 / 136 / 2, 279 / 137 / 3, 338 / 138 / 2, 412 / 139 / 2, 265 / 140 / 2, 205 / 141 / 3, 36 / 142 / 2, 336 / 143 / 2, 141 / 144 / 3, 450 / 145 / 2, 267 / 146 / 2, 316 / 147 / 2, 493 / 148 / 3, 282 / 149 / 2, 89 / 150 / 3, 194 / 151 / 2, 105 / 152 / 2, 286 / 153 / 3, 61 / 154 / 2, 42 / 155 / 3, 420 / 156 / 2, 453 / 157 / 2, 347 / 158 / 2, 327 / 159 / 4, 445 / 160 / 2, 99 / 161 / 2, 48 / 162 / 3, 398 / 163 / 2, 92 / 164 / 3, 62 / 165 / 2, 206 / 166 / 2, 396 / 167 / 3, 496 / 168 / 2, 385 / 169 / 5, 55 / 170 / 2, 138 / 171 / 2, 216 / 172 / 3, 84 / 173 / 2, 229 / 174 / 3, 154 / 175 / 2, 276 / 176 / 2, 258 / 177 / 2, 243 / 178 / 2, 35 / 179 / 2, 12 / 180 / 2, 285 / 181 / 2, 41 / 182 / 2, 397 / 183 / 2, 158 / 184 / 2, 178 / 185 / 2, 112 / 186 / 2, 313 / 187 / 2, 418 / 188 / 2, 90 / 189 / 2, 249 / 190 / 5, 456 / 191 / 2, 457 / 192 / 2, 334 / 193 / 4, 406 / 194 / 2, 140 / 195 / 2, 381 / 196 / 3, 71 / 197 / 2, 73 / 198 / 2, 101 / 199 / 2, 435 / 200 / 3, 176 / 201 / 2, 487 / 202 / 2, 245 / 203 / 6, 43 / 204 / 2, 443 / 205 / 2, 252 / 206 / 2, 106 / 207 / 2, 357 / 208 / 6, 102 / 209 / 2, 223 / 210 / 2, 21 / 211 / 2, 110 / 212 / 2, 210 / 213 / 2, 111 / 214 / 2, 270 / 215 / 3, 9 / 216 / 2, 273 / 217 / 2, 204 / 218 / 2, 242 / 219 / 2, 127 / 220 / 2, 248 / 221 / 2, 234 / 222 / 2, 19 / 223 / 2, 482 / 224 / 2, 228 / 225 / 2, 20 / 226 / 2, 411 / 227 / 3, 365 / 228 / 2, 335 / 229 / 2, 290 / 230 / 2, 122 / 231 / 2, 39 / 232 / 2, 76 / 233 / 2, 293 / 234 / 2, 125 / 235 / 2, 386 / 236 / 2, 367 / 237 / 2, 240 / 238 / 3, 426 / 239 / 2, 497 / 240 / 2, 72 / 241 / 2, 269 / 242 / 3, 52 / 243 / 2, 354 / 244 / 2, 333 / 245 / 7, 370 / 246 / 2, 447 / 247 / 2, 215 / 248 / 2, 400 / 249 / 2, 289 / 250 / 2, 424 / 251 / 2, 221 / 252 / 5, 263 / 253 / 2, 103 / 254 / 3, 18 / 255 / 2, 352 / 256 / 2, 452 / 257 / 4, 427 / 258 / 2, 486 / 259 / 2, 328 / 260 / 2, 392 / 261 / 2, 478 / 262 / 3, 5 / 263 / 2, 152 / 264 / 2, 474 / 265 / 3, 271 / 266 / 2, 350 / 267 / 2, 287 / 268 / 2, 145 / 269 / 4, 8 / 270 / 2, 264 / 271 / 2, 387 / 272 / 4, 451 / 273 / 2, 170 / 274 / 2, 378 / 275 / 2, 160 / 276 / 3, 114 / 277 / 2, 7 / 278 / 3, 488 / 279 / 2, 81 / 280 / 2, 108 / 281 / 3, 217 / 282 / 2, 353 / 283 / 3, 376 / 284 / 2, 104 / 285 / 2, 121 / 286 / 2, 244 / 287 / 2, 393 / 288 / 3, 180 / 289 / 2, 305 / 290 / 3, 236 / 291 / 2, 317 / 292 / 2, 190 / 293 / 3, 195 / 294 / 2, 237 / 295 / 3, 394 / 296 / 2, 499 / 297 / 2, 403 / 298 / 2, 364 / 299 / 2, 495 / 300 / 2, 351 / 301 / 2, 297 / 302 / 4, 208 / 303 / 2, 461 / 304 / 2, 3 / 305 / 4, 203 / 306 / 2, 212 / 307 / 2, 100 / 308 / 2, 130 / 309 / 3, 53 / 310 / 2, 476 / 311 / 2, 417 / 312 / 2, 233 / 313 / 2, 294 / 314 / 2, 128 / 315 / 2, 182 / 316 / 3, 96 / 317 / 2, 462 / 318 / 2, 408 / 319 / 3, 207 / 320 / 2, 150 / 321 / 3, 15 / 322 / 2, 98 / 323 / 2, 197 / 324 / 2, 33 / 325 / 3, 466 / 326 / 2, 375 / 327 / 2, 485 / 328 / 3, 173 / 329 / 2, 75 / 330 / 2, 442 / 331 / 2, 489 / 332 / 3, 67 / 333 / 2, 186 / 334 / 2, 124 / 335 / 5, 24 / 336 / 2, 246 / 337 / 2, 6 / 338 / 2, 368 / 339 / 2, 390 / 340 / 2, 250 / 341 / 4, 222 / 342 / 2, 296 / 343 / 2, 45 / 344 / 2, 239 / 345 / 2, 473 / 346 / 4, 151 / 347 / 2, 323 / 348 / 2, 423 / 349 / 2, 201 / 350 / 3, 147 / 351 / 2, 436 / 352 / 2, 169 / 353 / 2, 361 / 354 / 2, 419 / 355 / 4, 448 / 356 / 2, 494 / 357 / 2, 324 / 358 / 4, 87 / 359 / 2, 26 / 360 / 2, 139 / 361 / 2, 117 / 362 / 3, 166 / 363 / 2, 309 / 364 / 3, 10 / 365 / 2, 65 / 366 / 3, 171 / 367 / 2, 372 / 368 / 2, 260 / 369 / 2, 82 / 370 / 2, 330 / 371 / 4, 129 / 372 / 2, 226 / 373 / 3, 321 / 374 / 2, 37 / 375 / 2, 300 / 376 / 3, 218 / 377 / 2, 491 / 378 / 2, 80 / 379 / 2, 38 / 380 / 2, 199 / 381 / 5, 95 / 382 / 2, 414 / 383 / 2, 107 / 384 / 2, 148 / 385 / 4, 444 / 386 / 2, 446 / 387 / 2, 483 / 388 / 4, 440 / 389 / 2, 433 / 390 / 2, 115 / 391 / 4, 188 / 392 / 2, 413 / 393 / 2, 31 / 394 / 2, 304 / 395 / 3, 85 / 396 / 2, 183 / 397 / 4, 432 / 398 / 2, 472 / 399 / 2, 298 / 400 / 2, 409 / 401 / 2, 131 / 402 / 3, 181 / 403 / 2, 220 / 404 / 2, 132 / 405 / 3, 177 / 406 / 2, 88 / 407 / 4, 481 / 408 / 2, 191 / 409 / 3, 262 / 410 / 2, 291 / 411 / 5, 51 / 412 / 2, 11 / 413 / 2, 341 / 414 / 2, 119 / 415 / 2, 428 / 416 / 2, 174 / 417 / 2, 46 / 418 / 6, 4 / 419 / 2, 438 / 420 / 2, 123 / 421 / 2, 179 / 422 / 2, 257 / 423 / 2, 49 / 424 / 3, 83 / 425 / 2, 241 / 426 / 2, 479 / 427 / 2, 307 / 428 / 2, 421 / 429 / 4, 79 / 430 / 2, 126 / 431 / 2, 302 / 432 / 2, 184 / 433 / 2, 23 / 434 / 3, 380 / 435 / 2, 74 / 436 / 2, 337 / 437 / 2, 314 / 438 / 4, 490 / 439 / 2, 410 / 440 / 2, 356 / 441 / 3, 118 / 442 / 2, 211 / 443 / 3, 344 / 444 / 2, 86 / 445 / 4, 355 / 446 / 2, 232 / 447 / 2, 404 / 448 / 2, 471 / 449 / 2, 343 / 450 / 6, 2 / 451 / 2, 50 / 452 / 2, 326 / 453 / 3, 69 / 454 / 2, 149 / 455 / 2, 318 / 456 / 3, 431 / 457 / 2, 299 / 458 / 2, 25 / 459 / 2, 480 / 460 / 2, 66 / 461 / 3, 288 / 462 / 2, 492 / 463 / 4, 251 / 464 / 2, 77 / 465 / 2, 391 / 466 / 4, 377 / 467 / 2, 272 / 468 / 2, 238 / 469 / 2, 134 / 470 / 2, 68 / 471 / 4, 224 / 472 / 2, 254 / 473 / 2, 164 / 474 / 2, 295 / 475 / 5, 213 / 476 / 2, 366 / 477 / 2, 60 / 478 / 2, 399 / 479 / 2, 463 / 480 / 2, 308 / 481 / 4, 339 / 482 / 2, 17 / 483 / 2, 255 / 484 / 2, 120 / 485 / 2, 422 / 486 / 2, 192 / 487 / 2, 214 / 488 / 3, 259 / 489 / 2, 59 / 490 / 2, 311 / 491 / 2, 329 / 492 / 2, 268 / 493 / 2, 303 / 494 / 2, 284 / 495 / 2, 93 / 496 / 2, 371 / 497 / 3, 467 / 498 / 2, 63 / 499 / 2
doublecenter-alpha_1-14-n6.txt, 1, 1, 6, 641.109, 25, 19, 6, 5,5 / 1 / 2, 1 / 2 / 2, 4 / 3 / 2, 3 / 4 / 6, 2 / 5 / 2
doublecenter-alpha_1-15-n375.txt, 1, 1, 375, 3819.36, 3201, 2826, 8, 374,94 / 1 / 2, 49 / 2 / 6, 136 / 3 / 2, 364 / 4 / 2, 201 / 5 / 2, 295 / 6 / 4, 12 / 7 / 2, 264 / 8 / 2, 104 / 9 / 3, 140 / 10 / 2, 195 / 11 / 2, 225 / 12 / 3, 226 / 13 / 2, 248 / 14 / 3, 337 / 15 / 2, 286 / 16 / 2, 255 / 17 / 5, 70 / 18 / 2, 206 / 19 / 2, 182 / 20 / 2, 222 / 21 / 3, 119 / 22 / 2, 160 / 23 / 3, 151 / 24 / 2, 367 / 25 / 3, 6 / 26 / 2, 324 / 27 / 3, 79 / 28 / 2, 354 / 29 / 2, 121 / 30 / 2, 123 / 31 / 4, 139 / 32 / 2, 59 / 33 / 2, 156 / 34 / 4, 108 / 35 / 2, 290 / 36 / 2, 147 / 37 / 4, 216 / 38 / 2, 56 / 39 / 2, 279 / 40 / 2, 256 / 41 / 2, 306 / 42 / 3, 9 / 43 / 2, 357 / 44 / 2, 81 / 45 / 4, 251 / 46 / 2, 21 / 47 / 2, 308 / 48 / 4, 358 / 49 / 2, 208 / 50 / 2, 55 / 51 / 4, 263 / 52 / 2, 8 / 53 / 2, 209 / 54 / 3, 323 / 55 / 2, 161 / 56 / 2, 26 / 57 / 2, 267 / 58 / 2, 231 / 59 / 2, 124 / 60 / 2, 234 / 61 / 3, 220 / 62 / 2, 284 / 63 / 2, 356 / 64 / 2, 110 / 65 / 5, 291 / 66 / 2, 187 / 67 / 2, 213 / 68 / 2, 42 / 69 / 2, 312 / 70 / 2, 96 / 71 / 2, 276 / 72 / 4, 341 / 73 / 2, 191 / 74 / 2, 322 / 75 / 2, 129 / 76 / 2, 258 / 77 / 3, 230 / 78 / 2, 37 / 79 / 2, 62 / 80 / 3, 338 / 81 / 2, 196 / 82 / 3, 204 / 83 / 2, 261 / 84 / 2, 214 / 85 / 3, 69 / 86 / 2, 302 / 87 / 3, 82 / 88 / 2, 329 / 89 / 4, 293 / 90 / 2, 268 / 91 / 2, 277 / 92 / 2, 100 / 93 / 7, 38 / 94 / 2, 116 / 95 / 2, 138 / 96 / 2, 346 / 97 / 3, 243 / 98 / 2, 167 / 99 / 2, 175 / 100 / 3, 169 / 101 / 2, 331 / 102 / 3, 65 / 103 / 2, 41 / 104 / 2, 198 / 105 / 4, 239 / 106 / 2, 298 / 107 / 2, 68 / 108 / 4, 299 / 109 / 2, 365 / 110 / 2, 314 / 111 / 3, 294 / 112 / 2, 310 / 113 / 3, 54 / 114 / 2, 192 / 115 / 3, 52 / 116 / 2, 155 / 117 / 3, 43 / 118 / 2, 120 / 119 / 2, 217 / 120 / 2, 317 / 121 / 2, 51 / 122 / 2, 307 / 123 / 2, 280 / 124 / 2, 289 / 125 / 2, 154 / 126 / 3, 48 / 127 / 2, 363 / 128 / 3, 15 / 129 / 2, 78 / 130 / 2, 63 / 131 / 2, 373 / 132 / 2, 210 / 133 / 2, 224 / 134 / 3, 174 / 135 / 2, 95 / 136 / 2, 238 / 137 / 2, 25 / 138 / 2, 207 / 139 / 2, 342 / 140 / 3, 2 / 141 / 2, 72 / 142 / 2, 71 / 143 / 3, 272 / 144 / 2, 105 / 145 / 2, 118 / 146 / 5, 285 / 147 / 2, 215 / 148 / 2, 87 / 149 / 4, 368 / 150 / 2, 172 / 151 / 3, 107 / 152 / 2, 186 / 153 / 2, 109 / 154 / 2, 28 / 155 / 3, 91 / 156 / 2, 352 / 157 / 3, 132 / 158 / 2, 275 / 159 / 2, 165 / 160 / 6, 369 / 161 / 2, 270 / 162 / 2, 114 / 163 / 2, 60 / 164 / 2, 144 / 165 / 2, 5 / 166 / 2, 259 / 167 / 2, 221 / 168 / 4, 332 / 169 / 2, 211 / 170 / 3, 98 / 171 / 2, 75 / 172 / 2, 20 / 173 / 2, 254 / 174 / 7, 137 / 175 / 2, 320 / 176 / 3, 370 / 177 / 2, 13 / 178 / 2, 296 / 179 / 2, 273 / 180 / 5, 34 / 181 / 2, 271 / 182 / 2, 292 / 183 / 2, 18 / 184 / 2, 177 / 185 / 6, 158 / 186 / 2, 152 / 187 / 2, 361 / 188 / 2, 148 / 189 / 2, 326 / 190 / 2, 40 / 191 / 4, 92 / 192 / 2, 241 / 193 / 3, 333 / 194 / 2, 262 / 195 / 2, 372 / 196 / 2, 240 / 197 / 3, 300 / 198 / 2, 90 / 199 / 2, 197 / 200 / 2, 153 / 201 / 2, 74 / 202 / 2, 146 / 203 / 3, 117 / 204 / 2, 86 / 205 / 2, 244 / 206 / 3, 348 / 207 / 2, 180 / 208 / 3, 134 / 209 / 2, 219 / 210 / 4, 313 / 211 / 2, 229 / 212 / 2, 218 / 213 / 2, 44 / 214 / 2, 349 / 215 / 2, 194 / 216 / 2, 11 / 217 / 3, 141 / 218 / 2, 233 / 219 / 3, 145 / 220 / 2, 228 / 221 / 2, 171 / 222 / 3, 205 / 223 / 2, 58 / 224 / 2, 304 / 225 / 4, 103 / 226 / 2, 247 / 227 / 2, 45 / 228 / 2, 143 / 229 / 2, 202 / 230 / 3, 287 / 231 / 2, 374 / 232 / 2, 102 / 233 / 3, 318 / 234 / 2, 189 / 235 / 2, 242 / 236 / 3, 193 / 237 / 2, 85 / 238 / 3, 351 / 239 / 2, 157 / 240 / 2, 179 / 241 / 2, 24 / 242 / 2, 371 / 243 / 5, 336 / 244 / 2, 236 / 245 / 2, 288 / 246 / 2, 274 / 247 / 2, 127 / 248 / 3, 281 / 249 / 2, 112 / 250 / 2, 67 / 251 / 4, 163 / 252 / 2, 162 / 253 / 2, 14 / 254 / 2, 325 / 255 / 4, 328 / 256 / 2, 260 / 257 / 2, 73 / 258 / 2, 350 / 259 / 2, 250 / 260 / 5, 166 / 261 / 2, 113 / 262 / 3, 16 / 263 / 2, 237 / 264 / 2, 232 / 265 / 2, 223 / 266 / 2, 335 / 267 / 5, 173 / 268 / 2, 122 / 269 / 2, 269 / 270 / 3, 89 / 271 / 2, 50 / 272 / 2, 345 / 273 / 4, 185 / 274 / 2, 184 / 275 / 2, 181 / 276 / 2, 53 / 277 / 2, 77 / 278 / 5, 190 / 279 / 2, 330 / 280 / 2, 178 / 281 / 2, 359 / 282 / 2, 17 / 283 / 2, 84 / 284 / 4, 22 / 285 / 2, 30 / 286 / 2, 316 / 287 / 2, 343 / 288 / 2, 19 / 289 / 2, 235 / 290 / 2, 199 / 291 / 3, 265 / 292 / 2, 344 / 293 / 2, 311 / 294 / 4, 36 / 295 / 2, 93 / 296 / 2, 355 / 297 / 4, 176 / 298 / 2, 301 / 299 / 2, 249 / 300 / 2, 257 / 301 / 3, 297 / 302 / 2, 278 / 303 / 3, 188 / 304 / 2, 46 / 305 / 2, 334 / 306 / 2, 305 / 307 / 2, 168 / 308 / 2, 130 / 309 / 3, 245 / 310 / 2, 159 / 311 / 2, 128 / 312 / 3, 131 / 313 / 2, 76 / 314 / 4, 66 / 315 / 2, 32 / 316 / 2, 319 / 317 / 2, 283 / 318 / 2, 88 / 319 / 4, 61 / 320 / 2, 125 / 321 / 2, 327 / 322 / 3, 126 / 323 / 2, 33 / 324 / 3, 111 / 325 / 2, 340 / 326 / 3, 31 / 327 / 2, 150 / 328 / 4, 106 / 329 / 2, 303 / 330 / 2, 47 / 331 / 4, 309 / 332 / 2, 170 / 333 / 2, 133 / 334 / 2, 266 / 335 / 2, 366 / 336 / 2, 23 / 337 / 2, 246 / 338 / 5, 212 / 339 / 2, 252 / 340 / 2, 10 / 341 / 2, 200 / 342 / 3, 149 / 343 / 2, 227 / 344 / 3, 83 / 345 / 2, 203 / 346 / 3, 101 / 347 / 2, 282 / 348 / 3, 339 / 349 / 2, 321 / 350 / 3, 115 / 351 / 2, 27 / 352 / 4, 57 / 353 / 2, 3 / 354 / 2, 362 / 355 / 2, 353 / 356 / 2, 253 / 357 / 8, 39 / 358 / 2, 135 / 359 / 2, 35 / 360 / 3, 142 / 361 / 2, 347 / 362 / 2, 29 / 363 / 3, 80 / 364 / 2, 4 / 365 / 2, 99 / 366 / 4, 315 / 367 / 2, 183 / 368 / 3, 1 / 369 / 2, 97 / 370 / 2, 64 / 371 / 2, 164 / 372 / 7, 7 / 373 / 2, 360 / 374 / 3
doublecenter-alpha_1-15-n6.txt, 1, 1, 6, 576.063, 27, 21, 6, 5,1 / 1 / 2, 5 / 2 / 6, 2 / 3 / 2, 4 / 4 / 2, 3 / 5 / 4
doublecenter-alpha_1-16-n375.txt, 1, 1, 375, 3443.14, 2999, 2624, 7, 374,225 / 1 / 2, 101 / 2 / 4, 371 / 3 / 2, 25 / 4 / 2, 274 / 5 / 6, 172 / 6 / 2, 334 / 7 / 2, 329 / 8 / 3, 169 / 9 / 2, 311 / 10 / 3, 362 / 11 / 2, 168 / 12 / 2, 198 / 13 / 6, 71 / 14 / 2, 18 / 15 / 3, 63 / 16 / 2, 170 / 17 / 2, 314 / 18 / 2, 192 / 19 / 5, 129 / 20 / 2, 365 / 21 / 2, 166 / 22 / 2, 333 / 23 / 2, 191 / 24 / 3, 214 / 25 / 2, 212 / 26 / 2, 105 / 27 / 2, 151 / 28 / 4, 370 / 29 / 2, 97 / 30 / 2, 127 / 31 / 4, 303 / 32 / 2, 93 / 33 / 2, 253 / 34 / 7, 154 / 35 / 2, 121 / 36 / 2, 155 / 37 / 2, 72 / 38 / 3, 51 / 39 / 2, 43 / 40 / 2, 182 / 41 / 2, 149 / 42 / 3, 372 / 43 / 2, 31 / 44 / 2, 258 / 45 / 3, 340 / 46 / 2, 286 / 47 / 3, 205 / 48 / 2, 90 / 49 / 3, 243 / 50 / 2, 94 / 51 / 2, 226 / 52 / 2, 47 / 53 / 2, 86 / 54 / 3, 165 / 55 / 2, 33 / 56 / 2, 67 / 57 / 3, 167 / 58 / 2, 28 / 59 / 5, 256 / 60 / 2, 199 / 61 / 3, 262 / 62 / 2, 92 / 63 / 2, 249 / 64 / 3, 196 / 65 / 2, 22 / 66 / 3, 332 / 67 / 2, 263 / 68 / 3, 184 / 69 / 2, 206 / 70 / 2, 328 / 71 / 3, 345 / 72 / 2, 159 / 73 / 3, 322 / 74 / 2, 278 / 75 / 3, 34 / 76 / 2, 283 / 77 / 3, 358 / 78 / 2, 83 / 79 / 3, 29 / 80 / 2, 160 / 81 / 2, 247 / 82 / 2, 250 / 83 / 3, 50 / 84 / 2, 268 / 85 / 2, 189 / 86 / 3, 292 / 87 / 2, 305 / 88 / 3, 175 / 89 / 2, 91 / 90 / 2, 76 / 91 / 3, 327 / 92 / 2, 227 / 93 / 4, 217 / 94 / 2, 236 / 95 / 2, 137 / 96 / 4, 119 / 97 / 2, 58 / 98 / 3, 150 / 99 / 2, 59 / 100 / 3, 60 / 101 / 2, 240 / 102 / 2, 45 / 103 / 2, 186 / 104 / 2, 161 / 105 / 2, 38 / 106 / 2, 56 / 107 / 2, 13 / 108 / 3, 179 / 109 / 2, 102 / 110 / 2, 39 / 111 / 3, 157 / 112 / 2, 53 / 113 / 3, 229 / 114 / 2, 48 / 115 / 2, 103 / 116 / 4, 364 / 117 / 2, 64 / 118 / 3, 312 / 119 / 2, 270 / 120 / 2, 335 / 121 / 2, 207 / 122 / 2, 194 / 123 / 3, 1 / 124 / 2, 141 / 125 / 2, 324 / 126 / 5, 142 / 127 / 2, 330 / 128 / 2, 197 / 129 / 2, 297 / 130 / 4, 356 / 131 / 2, 285 / 132 / 3, 342 / 133 / 2, 5 / 134 / 2, 222 / 135 / 3, 337 / 136 / 2, 8 / 137 / 4, 17 / 138 / 2, 118 / 139 / 2, 233 / 140 / 2, 259 / 141 / 3, 323 / 142 / 2, 271 / 143 / 2, 15 / 144 / 2, 291 / 145 / 2, 355 / 146 / 3, 131 / 147 / 2, 239 / 148 / 2, 177 / 149 / 3, 44 / 150 / 2, 68 / 151 / 2, 201 / 152 / 3, 146 / 153 / 2, 281 / 154 / 2, 26 / 155 / 2, 284 / 156 / 2, 300 / 157 / 3, 272 / 158 / 2, 7 / 159 / 3, 10 / 160 / 2, 266 / 161 / 2, 211 / 162 / 2, 269 / 163 / 2, 232 / 164 / 3, 109 / 165 / 2, 349 / 166 / 2, 143 / 167 / 2, 221 / 168 / 4, 344 / 169 / 2, 369 / 170 / 3, 49 / 171 / 2, 112 / 172 / 2, 318 / 173 / 3, 144 / 174 / 2, 36 / 175 / 3, 289 / 176 / 2, 35 / 177 / 2, 325 / 178 / 3, 96 / 179 / 2, 122 / 180 / 3, 73 / 181 / 2, 99 / 182 / 4, 78 / 183 / 2, 215 / 184 / 2, 245 / 185 / 2, 242 / 186 / 3, 290 / 187 / 2, 124 / 188 / 2, 246 / 189 / 3, 299 / 190 / 2, 113 / 191 / 3, 3 / 192 / 2, 110 / 193 / 2, 254 / 194 / 2, 310 / 195 / 2, 341 / 196 / 3, 209 / 197 / 2, 190 / 198 / 2, 11 / 199 / 2, 12 / 200 / 5, 180 / 201 / 2, 220 / 202 / 2, 252 / 203 / 2, 176 / 204 / 2, 128 / 205 / 4, 40 / 206 / 2, 123 / 207 / 2, 203 / 208 / 2, 188 / 209 / 2, 145 / 210 / 3, 52 / 211 / 2, 163 / 212 / 2, 115 / 213 / 2, 19 / 214 / 2, 251 / 215 / 3, 195 / 216 / 2, 24 / 217 / 3, 61 / 218 / 2, 126 / 219 / 2, 117 / 220 / 2, 104 / 221 / 3, 352 / 222 / 2, 89 / 223 / 2, 106 / 224 / 4, 153 / 225 / 2, 248 / 226 / 2, 84 / 227 / 4, 138 / 228 / 2, 116 / 229 / 2, 125 / 230 / 4, 178 / 231 / 2, 204 / 232 / 3, 230 / 233 / 2, 21 / 234 / 2, 295 / 235 / 2, 353 / 236 / 4, 65 / 237 / 2, 46 / 238 / 3, 16 / 239 / 2, 326 / 240 / 2, 347 / 241 / 4, 308 / 242 / 2, 374 / 243 / 2, 135 / 244 / 2, 346 / 245 / 3, 185 / 246 / 2, 360 / 247 / 3, 95 / 248 / 2, 313 / 249 / 2, 173 / 250 / 2, 241 / 251 / 3, 275 / 252 / 2, 234 / 253 / 2, 307 / 254 / 2, 301 / 255 / 2, 70 / 256 / 2, 4 / 257 / 3, 277 / 258 / 2, 231 / 259 / 5, 282 / 260 / 2, 351 / 261 / 2, 302 / 262 / 3, 279 / 263 / 2, 208 / 264 / 2, 120 / 265 / 2, 210 / 266 / 5, 293 / 267 / 2, 265 / 268 / 3, 55 / 269 / 2, 54 / 270 / 4, 361 / 271 / 2, 267 / 272 / 3, 200 / 273 / 2, 111 / 274 / 2, 156 / 275 / 2, 181 / 276 / 2, 331 / 277 / 2, 219 / 278 / 6, 2 / 279 / 2, 9 / 280 / 3, 354 / 281 / 2, 37 / 282 / 2, 309 / 283 / 2, 6 / 284 / 5, 317 / 285 / 2, 108 / 286 / 3, 162 / 287 / 2, 238 / 288 / 2, 80 / 289 / 3, 228 / 290 / 2, 287 / 291 / 2, 315 / 292 / 2, 244 / 293 / 2, 373 / 294 / 2, 367 / 295 / 4, 320 / 296 / 2, 260 / 297 / 2, 235 / 298 / 2, 164 / 299 / 3, 32 / 300 / 2, 366 / 301 / 3, 130 / 302 / 2, 296 / 303 / 2, 27 / 304 / 2, 132 / 305 / 4, 152 / 306 / 2, 359 / 307 / 2, 319 / 308 / 3, 69 / 309 / 2, 321 / 310 / 2, 85 / 311 / 2, 264 / 312 / 3, 357 / 313 / 2, 348 / 314 / 3, 134 / 315 / 2, 213 / 316 / 3, 193 / 317 / 2, 114 / 318 / 2, 174 / 319 / 2, 79 / 320 / 2, 57 / 321 / 2, 171 / 322 / 2, 147 / 323 / 3, 133 / 324 / 2, 107 / 325 / 2, 255 / 326 / 2, 273 / 327 / 2, 368 / 328 / 2, 136 / 329 / 2, 218 / 330 / 2, 223 / 331 / 4, 187 / 332 / 2, 316 / 333 / 2, 42 / 334 / 2, 74 / 335 / 2, 87 / 336 / 3, 81 / 337 / 2, 306 / 338 / 3, 338 / 339 / 2, 98 / 340 / 2, 257 / 341 / 3, 183 / 342 / 2, 336 / 343 / 3, 288 / 344 / 2, 88 / 345 / 3, 237 / 346 / 2, 261 / 347 / 2, 62 / 348 / 2, 350 / 349 / 2, 304 / 350 / 3, 100 / 351 / 2, 294 / 352 / 2, 66 / 353 / 2, 276 / 354 / 2, 41 / 355 / 3, 202 / 356 / 2, 30 / 357 / 2, 139 / 358 / 3, 216 / 359 / 2, 82 / 360 / 3, 298 / 361 / 2, 280 / 362 / 3, 140 / 363 / 2, 158 / 364 / 2, 363 / 365 / 2, 343 / 366 / 4, 75 / 367 / 2, 224 / 368 / 2, 339 / 369 / 3, 77 / 370 / 2, 148 / 371 / 2, 14 / 372 / 2, 20 / 373 / 5, 23 / 374 / 2
doublecenter-alpha_1-16-n6.txt, 1, 1, 6, 592.712, 26, 20, 4, 5,4 / 1 / 4, 1 / 2 / 2, 5 / 3 / 2, 2 / 4 / 4, 3 / 5 / 2
doublecenter-alpha_1-17-n375.txt, 1, 1, 375, 4046.64, 3234, 2859, 13, 374,125 / 1 / 3, 374 / 2 / 2, 204 / 3 / 4, 1 / 4 / 2, 205 / 5 / 2, 264 / 6 / 2, 144 / 7 / 2, 188 / 8 / 3, 310 / 9 / 2, 343 / 10 / 4, 86 / 11 / 2, 19 / 12 / 2, 164 / 13 / 2, 196 / 14 / 3, 174 / 15 / 2, 87 / 16 / 2, 48 / 17 / 2, 132 / 18 / 2, 286 / 19 / 3, 351 / 20 / 2, 191 / 21 / 4, 322 / 22 / 2, 355 / 23 / 2, 2 / 24 / 4, 89 / 25 / 2, 23 / 26 / 2, 120 / 27 / 2, 213 / 28 / 2, 115 / 29 / 2, 227 / 30 / 2, 261 / 31 / 2, 97 / 32 / 2, 195 / 33 / 4, 279 / 34 / 2, 197 / 35 / 2, 7 / 36 / 2, 189 / 37 / 3, 107 / 38 / 2, 65 / 39 / 2, 46 / 40 / 3, 80 / 41 / 2, 96 / 42 / 4, 307 / 43 / 2, 332 / 44 / 2, 223 / 45 / 3, 233 / 46 / 2, 8 / 47 / 4, 90 / 48 / 2, 18 / 49 / 2, 258 / 50 / 2, 370 / 51 / 3, 348 / 52 / 2, 344 / 53 / 2, 304 / 54 / 4, 238 / 55 / 2, 268 / 56 / 2, 252 / 57 / 3, 215 / 58 / 2, 208 / 59 / 2, 285 / 60 / 2, 334 / 61 / 3, 303 / 62 / 2, 221 / 63 / 2, 111 / 64 / 2, 330 / 65 / 2, 251 / 66 / 3, 38 / 67 / 2, 170 / 68 / 2, 33 / 69 / 2, 165 / 70 / 2, 159 / 71 / 2, 6 / 72 / 2, 59 / 73 / 2, 373 / 74 / 3, 113 / 75 / 2, 27 / 76 / 2, 63 / 77 / 3, 181 / 78 / 2, 77 / 79 / 3, 311 / 80 / 2, 209 / 81 / 3, 216 / 82 / 2, 220 / 83 / 2, 160 / 84 / 3, 235 / 85 / 2, 109 / 86 / 2, 70 / 87 / 3, 69 / 88 / 2, 321 / 89 / 3, 71 / 90 / 2, 234 / 91 / 2, 368 / 92 / 3, 142 / 93 / 2, 49 / 94 / 2, 292 / 95 / 2, 126 / 96 / 2, 299 / 97 / 2, 135 / 98 / 4, 124 / 99 / 2, 176 / 100 / 2, 156 / 101 / 2, 320 / 102 / 2, 309 / 103 / 4, 313 / 104 / 2, 277 / 105 / 2, 342 / 106 / 3, 200 / 107 / 2, 349 / 108 / 3, 278 / 109 / 2, 145 / 110 / 4, 312 / 111 / 2, 253 / 112 / 2, 352 / 113 / 2, 254 / 114 / 2, 146 / 115 / 3, 138 / 116 / 2, 20 / 117 / 3, 103 / 118 / 2, 219 / 119 / 2, 31 / 120 / 2, 218 / 121 / 2, 274 / 122 / 2, 13 / 123 / 3, 100 / 124 / 2, 178 / 125 / 4, 119 / 126 / 2, 114 / 127 / 2, 270 / 128 / 3, 280 / 129 / 2, 161 / 130 / 3, 288 / 131 / 2, 36 / 132 / 2, 187 / 133 / 2, 331 / 134 / 2, 269 / 135 / 2, 306 / 136 / 2, 242 / 137 / 2, 128 / 138 / 2, 201 / 139 / 2, 241 / 140 / 2, 339 / 141 / 3, 248 / 142 / 2, 211 / 143 / 3, 41 / 144 / 2, 10 / 145 / 3, 295 / 146 / 2, 225 / 147 / 2, 64 / 148 / 2, 37 / 149 / 2, 122 / 150 / 2, 52 / 151 / 3, 47 / 152 / 2, 217 / 153 / 2, 162 / 154 / 2, 324 / 155 / 2, 244 / 156 / 3, 272 / 157 / 2, 291 / 158 / 6, 123 / 159 / 2, 158 / 160 / 3, 78 / 161 / 2, 76 / 162 / 2, 326 / 163 / 2, 136 / 164 / 2, 129 / 165 / 2, 147 / 166 / 2, 39 / 167 / 2, 173 / 168 / 5, 345 / 169 / 2, 260 / 170 / 2, 246 / 171 / 4, 315 / 172 / 2, 328 / 173 / 2, 266 / 174 / 4, 243 / 175 / 2, 151 / 176 / 2, 105 / 177 / 3, 308 / 178 / 2, 367 / 179 / 3, 110 / 180 / 2, 81 / 181 / 3, 214 / 182 / 2, 25 / 183 / 2, 131 / 184 / 4, 358 / 185 / 2, 362 / 186 / 2, 102 / 187 / 3, 369 / 188 / 2, 226 / 189 / 5, 169 / 190 / 2, 371 / 191 / 3, 185 / 192 / 2, 230 / 193 / 2, 14 / 194 / 5, 9 / 195 / 2, 45 / 196 / 2, 327 / 197 / 4, 363 / 198 / 2, 104 / 199 / 3, 91 / 200 / 2, 329 / 201 / 3, 44 / 202 / 2, 222 / 203 / 2, 143 / 204 / 2, 333 / 205 / 2, 82 / 206 / 2, 283 / 207 / 2, 263 / 208 / 2, 61 / 209 / 2, 133 / 210 / 2, 271 / 211 / 4, 79 / 212 / 2, 93 / 213 / 2, 210 / 214 / 3, 249 / 215 / 2, 240 / 216 / 2, 224 / 217 / 3, 346 / 218 / 2, 356 / 219 / 3, 365 / 220 / 2, 68 / 221 / 2, 232 / 222 / 3, 228 / 223 / 2, 140 / 224 / 2, 74 / 225 / 2, 255 / 226 / 5, 184 / 227 / 2, 335 / 228 / 2, 57 / 229 / 4, 239 / 230 / 2, 296 / 231 / 2, 60 / 232 / 2, 150 / 233 / 3, 341 / 234 / 2, 154 / 235 / 2, 153 / 236 / 2, 337 / 237 / 6, 265 / 238 / 2, 259 / 239 / 2, 267 / 240 / 3, 168 / 241 / 2, 152 / 242 / 5, 361 / 243 / 2, 247 / 244 / 3, 372 / 245 / 2, 98 / 246 / 2, 92 / 247 / 2, 72 / 248 / 2, 317 / 249 / 5, 127 / 250 / 2, 314 / 251 / 2, 287 / 252 / 2, 75 / 253 / 3, 171 / 254 / 2, 99 / 255 / 2, 148 / 256 / 2, 121 / 257 / 2, 199 / 258 / 4, 347 / 259 / 2, 141 / 260 / 2, 166 / 261 / 3, 340 / 262 / 2, 256 / 263 / 4, 338 / 264 / 2, 88 / 265 / 2, 298 / 266 / 4, 273 / 267 / 2, 207 / 268 / 3, 101 / 269 / 2, 163 / 270 / 2, 112 / 271 / 3, 108 / 272 / 2, 282 / 273 / 2, 229 / 274 / 3, 364 / 275 / 2, 149 / 276 / 2, 50 / 277 / 2, 42 / 278 / 2, 137 / 279 / 2, 250 / 280 / 2, 17 / 281 / 3, 357 / 282 / 2, 130 / 283 / 2, 193 / 284 / 2, 318 / 285 / 2, 106 / 286 / 6, 139 / 287 / 2, 67 / 288 / 2, 290 / 289 / 3, 257 / 290 / 2, 194 / 291 / 2, 293 / 292 / 2, 177 / 293 / 5, 172 / 294 / 2, 276 / 295 / 2, 62 / 296 / 2, 21 / 297 / 3, 353 / 298 / 2, 4 / 299 / 3, 83 / 300 / 2, 95 / 301 / 2, 3 / 302 / 3, 167 / 303 / 2, 118 / 304 / 2, 301 / 305 / 2, 350 / 306 / 2, 117 / 307 / 2, 85 / 308 / 2, 354 / 309 / 2, 319 / 310 / 4, 134 / 311 / 2, 12 / 312 / 2, 236 / 313 / 2, 16 / 314 / 2, 359 / 315 / 6, 281 / 316 / 2, 366 / 317 / 2, 15 / 318 / 3, 26 / 319 / 2, 66 / 320 / 2, 155 / 321 / 3, 54 / 322 / 2, 22 / 323 / 3, 58 / 324 / 2, 203 / 325 / 3, 84 / 326 / 2, 192 / 327 / 3, 245 / 328 / 2, 175 / 329 / 2, 40 / 330 / 2, 190 / 331 / 2, 302 / 332 / 2, 300 / 333 / 3, 336 / 334 / 2, 289 / 335 / 2, 294 / 336 / 3, 316 / 337 / 2, 29 / 338 / 3, 28 / 339 / 2, 34 / 340 / 3, 212 / 341 / 2, 198 / 342 / 4, 262 / 343 / 2, 11 / 344 / 2, 284 / 345 / 2, 24 / 346 / 3, 180 / 347 / 2, 182 / 348 / 3, 56 / 349 / 2, 94 / 350 / 13, 157 / 351 / 2, 116 / 352 / 2, 323 / 353 / 2, 55 / 354 / 3, 51 / 355 / 2, 305 / 356 / 2, 179 / 357 / 4, 53 / 358 / 2, 360 / 359 / 3, 275 / 360 / 2, 43 / 361 / 3, 186 / 362 / 2, 5 / 363 / 2, 297 / 364 / 2, 183 / 365 / 2, 32 / 366 / 5, 202 / 367 / 2, 237 / 368 / 3, 325 / 369 / 2, 73 / 370 / 4, 30 / 371 / 2, 35 / 372 / 2, 231 / 373 / 2, 206 / 374 / 4
doublecenter-alpha_1-17-n6.txt, 1, 1, 6, 639.306, 23, 17, 3, 5,2 / 1 / 2, 5 / 2 / 3, 3 / 3 / 2, 1 / 4 / 3, 4 / 5 / 2
doublecenter-alpha_1-18-n375.txt, 1, 1, 375, 3779.7, 2901, 2526, 9, 374,40 / 1 / 2, 170 / 2 / 3, 286 / 3 / 2, 291 / 4 / 2, 163 / 5 / 2, 101 / 6 / 2, 347 / 7 / 2, 214 / 8 / 2, 181 / 9 / 2, 129 / 10 / 4, 366 / 11 / 2, 352 / 12 / 2, 77 / 13 / 3, 85 / 14 / 2, 262 / 15 / 2, 252 / 16 / 3, 323 / 17 / 2, 30 / 18 / 5, 125 / 19 / 2, 8 / 20 / 2, 65 / 21 / 2, 290 / 22 / 3, 212 / 23 / 2, 105 / 24 / 3, 166 / 25 / 2, 370 / 26 / 2, 25 / 27 / 3, 281 / 28 / 2, 120 / 29 / 4, 235 / 30 / 2, 203 / 31 / 2, 51 / 32 / 2, 168 / 33 / 3, 22 / 34 / 2, 272 / 35 / 2, 46 / 36 / 3, 149 / 37 / 2, 142 / 38 / 2, 138 / 39 / 2, 37 / 40 / 4, 94 / 41 / 2, 373 / 42 / 2, 151 / 43 / 4, 103 / 44 / 2, 245 / 45 / 2, 209 / 46 / 2, 5 / 47 / 2, 292 / 48 / 2, 243 / 49 / 3, 117 / 50 / 2, 54 / 51 / 3, 309 / 52 / 2, 81 / 53 / 2, 185 / 54 / 3, 57 / 55 / 2, 38 / 56 / 7, 41 / 57 / 2, 47 / 58 / 2, 132 / 59 / 2, 130 / 60 / 2, 224 / 61 / 2, 56 / 62 / 2, 256 / 63 / 2, 229 / 64 / 2, 322 / 65 / 2, 6 / 66 / 3, 20 / 67 / 2, 358 / 68 / 5, 45 / 69 / 2, 135 / 70 / 3, 36 / 71 / 2, 296 / 72 / 2, 208 / 73 / 2, 336 / 74 / 3, 333 / 75 / 2, 295 / 76 / 3, 146 / 77 / 2, 293 / 78 / 2, 124 / 79 / 2, 215 / 80 / 2, 63 / 81 / 2, 363 / 82 / 3, 285 / 83 / 2, 80 / 84 / 3, 176 / 85 / 2, 273 / 86 / 2, 171 / 87 / 3, 299 / 88 / 2, 306 / 89 / 2, 92 / 90 / 2, 326 / 91 / 2, 365 / 92 / 2, 167 / 93 / 2, 335 / 94 / 2, 55 / 95 / 2, 280 / 96 / 2, 134 / 97 / 2, 364 / 98 / 3, 2 / 99 / 2, 76 / 100 / 3, 191 / 101 / 2, 247 / 102 / 2, 16 / 103 / 3, 88 / 104 / 2, 83 / 105 / 2, 160 / 106 / 3, 258 / 107 / 2, 341 / 108 / 2, 24 / 109 / 3, 180 / 110 / 2, 269 / 111 / 3, 265 / 112 / 2, 216 / 113 / 2, 165 / 114 / 4, 284 / 115 / 2, 231 / 116 / 2, 228 / 117 / 4, 233 / 118 / 2, 98 / 119 / 3, 193 / 120 / 2, 206 / 121 / 2, 62 / 122 / 4, 324 / 123 / 2, 143 / 124 / 2, 74 / 125 / 4, 49 / 126 / 2, 264 / 127 / 3, 329 / 128 / 2, 344 / 129 / 2, 308 / 130 / 2, 202 / 131 / 3, 90 / 132 / 2, 301 / 133 / 3, 187 / 134 / 2, 157 / 135 / 2, 240 / 136 / 2, 93 / 137 / 3, 221 / 138 / 2, 367 / 139 / 3, 18 / 140 / 2, 9 / 141 / 2, 314 / 142 / 4, 317 / 143 / 2, 196 / 144 / 2, 237 / 145 / 3, 66 / 146 / 2, 119 / 147 / 2, 159 / 148 / 2, 112 / 149 / 4, 282 / 150 / 2, 3 / 151 / 2, 156 / 152 / 2, 201 / 153 / 2, 369 / 154 / 2, 334 / 155 / 3, 116 / 156 / 2, 219 / 157 / 2, 242 / 158 / 3, 86 / 159 / 2, 153 / 160 / 2, 257 / 161 / 3, 226 / 162 / 2, 102 / 163 / 2, 61 / 164 / 3, 32 / 165 / 2, 303 / 166 / 3, 302 / 167 / 2, 337 / 168 / 2, 34 / 169 / 2, 113 / 170 / 3, 155 / 171 / 2, 266 / 172 / 2, 239 / 173 / 2, 58 / 174 / 2, 73 / 175 / 2, 253 / 176 / 4, 200 / 177 / 2, 95 / 178 / 2, 173 / 179 / 3, 275 / 180 / 2, 91 / 181 / 3, 19 / 182 / 2, 137 / 183 / 2, 360 / 184 / 2, 17 / 185 / 6, 300 / 186 / 2, 72 / 187 / 2, 354 / 188 / 2, 97 / 189 / 3, 182 / 190 / 2, 64 / 191 / 3, 207 / 192 / 2, 327 / 193 / 2, 11 / 194 / 2, 79 / 195 / 3, 372 / 196 / 2, 259 / 197 / 2, 75 / 198 / 3, 123 / 199 / 2, 331 / 200 / 2, 35 / 201 / 2, 89 / 202 / 4, 311 / 203 / 2, 53 / 204 / 2, 150 / 205 / 3, 359 / 206 / 2, 371 / 207 / 2, 31 / 208 / 4, 238 / 209 / 2, 351 / 210 / 2, 248 / 211 / 4, 236 / 212 / 2, 42 / 213 / 3, 223 / 214 / 2, 218 / 215 / 2, 312 / 216 / 3, 267 / 217 / 2, 69 / 218 / 2, 21 / 219 / 3, 332 / 220 / 2, 71 / 221 / 3, 340 / 222 / 2, 107 / 223 / 3, 177 / 224 / 2, 213 / 225 / 2, 279 / 226 / 2, 13 / 227 / 2, 39 / 228 / 2, 294 / 229 / 2, 357 / 230 / 3, 353 / 231 / 2, 87 / 232 / 2, 12 / 233 / 2, 313 / 234 / 2, 342 / 235 / 2, 111 / 236 / 2, 109 / 237 / 2, 222 / 238 / 2, 140 / 239 / 2, 84 / 240 / 2, 263 / 241 / 2, 374 / 242 / 4, 158 / 243 / 2, 305 / 244 / 3, 10 / 245 / 2, 23 / 246 / 3, 104 / 247 / 2, 192 / 248 / 4, 204 / 249 / 2, 268 / 250 / 2, 78 / 251 / 2, 52 / 252 / 5, 249 / 253 / 2, 28 / 254 / 2, 154 / 255 / 2, 148 / 256 / 2, 225 / 257 / 3, 251 / 258 / 2, 26 / 259 / 2, 368 / 260 / 5, 118 / 261 / 2, 186 / 262 / 2, 287 / 263 / 2, 139 / 264 / 3, 321 / 265 / 2, 319 / 266 / 2, 48 / 267 / 3, 338 / 268 / 2, 356 / 269 / 3, 232 / 270 / 2, 304 / 271 / 3, 198 / 272 / 2, 161 / 273 / 2, 141 / 274 / 2, 44 / 275 / 4, 15 / 276 / 2, 210 / 277 / 2, 241 / 278 / 3, 346 / 279 / 2, 99 / 280 / 3, 14 / 281 / 2, 145 / 282 / 4, 110 / 283 / 2, 315 / 284 / 3, 330 / 285 / 2, 230 / 286 / 3, 147 / 287 / 2, 162 / 288 / 2, 227 / 289 / 2, 126 / 290 / 3, 270 / 291 / 2, 178 / 292 / 2, 271 / 293 / 3, 179 / 294 / 2, 190 / 295 / 2, 96 / 296 / 2, 345 / 297 / 2, 297 / 298 / 2, 274 / 299 / 2, 169 / 300 / 4, 67 / 301 / 2, 349 / 302 / 3, 205 / 303 / 2, 277 / 304 / 2, 194 / 305 / 2, 27 / 306 / 3, 197 / 307 / 2, 100 / 308 / 4, 217 / 309 / 2, 115 / 310 / 3, 307 / 311 / 2, 254 / 312 / 2, 350 / 313 / 2, 164 / 314 / 3, 211 / 315 / 2, 278 / 316 / 3, 106 / 317 / 2, 174 / 318 / 3, 289 / 319 / 2, 348 / 320 / 2, 220 / 321 / 3, 234 / 322 / 2, 122 / 323 / 2, 4 / 324 / 4, 59 / 325 / 2, 316 / 326 / 2, 108 / 327 / 2, 320 / 328 / 2, 131 / 329 / 2, 310 / 330 / 2, 7 / 331 / 3, 188 / 332 / 2, 361 / 333 / 2, 298 / 334 / 2, 189 / 335 / 2, 362 / 336 / 7, 184 / 337 / 2, 328 / 338 / 2, 43 / 339 / 3, 70 / 340 / 2, 255 / 341 / 2, 175 / 342 / 2, 250 / 343 / 2, 121 / 344 / 2, 33 / 345 / 3, 355 / 346 / 2, 114 / 347 / 2, 339 / 348 / 3, 144 / 349 / 2, 152 / 350 / 2, 128 / 351 / 2, 60 / 352 / 4, 50 / 353 / 2, 343 / 354 / 2, 172 / 355 / 2, 68 / 356 / 2, 82 / 357 / 2, 195 / 358 / 2, 261 / 359 / 4, 244 / 360 / 2, 29 / 361 / 2, 199 / 362 / 4, 283 / 363 / 2, 127 / 364 / 2, 260 / 365 / 2, 1 / 366 / 2, 183 / 367 / 3, 325 / 368 / 2, 136 / 369 / 2, 276 / 370 / 2, 318 / 371 / 4, 246 / 372 / 2, 288 / 373 / 2, 133 / 374 / 9
doublecenter-alpha_1-18-n6.txt, 1, 1, 6, 620.836, 22, 16, 3, 5,2 / 1 / 2, 5 / 2 / 2, 4 / 3 / 3, 1 / 4 / 2, 3 / 5 / 2
doublecenter-alpha_1-19-n375.txt, 1, 1, 375, 3793.62, 3067, 2692, 10, 374,338 / 1 / 2, 256 / 2 / 10, 284 / 3 / 2, 246 / 4 / 2, 226 / 5 / 2, 216 / 6 / 5, 295 / 7 / 2, 279 / 8 / 2, 174 / 9 / 2, 145 / 10 / 2, 180 / 11 / 2, 305 / 12 / 5, 288 / 13 / 2, 25 / 14 / 2, 352 / 15 / 2, 92 / 16 / 4, 86 / 17 / 2, 320 / 18 / 2, 173 / 19 / 3, 220 / 20 / 2, 293 / 21 / 2, 68 / 22 / 4, 121 / 23 / 2, 168 / 24 / 2, 44 / 25 / 2, 282 / 26 / 4, 291 / 27 / 2, 70 / 28 / 2, 236 / 29 / 2, 200 / 30 / 2, 374 / 31 / 2, 292 / 32 / 2, 110 / 33 / 3, 311 / 34 / 2, 266 / 35 / 3, 274 / 36 / 2, 19 / 37 / 4, 263 / 38 / 2, 40 / 39 / 2, 190 / 40 / 3, 122 / 41 / 2, 341 / 42 / 3, 50 / 43 / 2, 280 / 44 / 7, 39 / 45 / 2, 130 / 46 / 2, 77 / 47 / 3, 38 / 48 / 2, 166 / 49 / 2, 362 / 50 / 5, 66 / 51 / 2, 18 / 52 / 2, 364 / 53 / 2, 21 / 54 / 5, 131 / 55 / 2, 139 / 56 / 2, 204 / 57 / 3, 294 / 58 / 2, 84 / 59 / 2, 244 / 60 / 2, 138 / 61 / 2, 287 / 62 / 2, 27 / 63 / 2, 249 / 64 / 2, 290 / 65 / 4, 144 / 66 / 2, 367 / 67 / 2, 321 / 68 / 2, 178 / 69 / 2, 165 / 70 / 3, 172 / 71 / 2, 330 / 72 / 2, 101 / 73 / 2, 85 / 74 / 3, 30 / 75 / 2, 281 / 76 / 2, 20 / 77 / 2, 132 / 78 / 2, 15 / 79 / 2, 48 / 80 / 2, 164 / 81 / 2, 14 / 82 / 2, 344 / 83 / 2, 261 / 84 / 5, 193 / 85 / 2, 149 / 86 / 2, 189 / 87 / 2, 182 / 88 / 2, 241 / 89 / 2, 104 / 90 / 7, 16 / 91 / 2, 221 / 92 / 3, 155 / 93 / 2, 36 / 94 / 5, 42 / 95 / 2, 179 / 96 / 2, 87 / 97 / 2, 228 / 98 / 2, 206 / 99 / 3, 332 / 100 / 2, 67 / 101 / 2, 346 / 102 / 2, 11 / 103 / 2, 140 / 104 / 3, 319 / 105 / 2, 361 / 106 / 2, 255 / 107 / 4, 90 / 108 / 2, 102 / 109 / 2, 118 / 110 / 3, 373 / 111 / 2, 45 / 112 / 3, 99 / 113 / 2, 103 / 114 / 2, 369 / 115 / 2, 276 / 116 / 2, 60 / 117 / 2, 141 / 118 / 5, 9 / 119 / 2, 272 / 120 / 3, 348 / 121 / 2, 368 / 122 / 2, 251 / 123 / 2, 231 / 124 / 5, 337 / 125 / 2, 7 / 126 / 2, 154 / 127 / 2, 143 / 128 / 3, 112 / 129 / 2, 218 / 130 / 2, 339 / 131 / 2, 88 / 132 / 2, 167 / 133 / 3, 357 / 134 / 2, 195 / 135 / 2, 32 / 136 / 2, 181 / 137 / 4, 230 / 138 / 2, 314 / 139 / 2, 310 / 140 / 2, 326 / 141 / 2, 275 / 142 / 2, 137 / 143 / 2, 162 / 144 / 3, 358 / 145 / 2, 128 / 146 / 2, 308 / 147 / 3, 210 / 148 / 2, 177 / 149 / 2, 303 / 150 / 2, 250 / 151 / 2, 34 / 152 / 4, 176 / 153 / 2, 150 / 154 / 2, 329 / 155 / 3, 370 / 156 / 2, 98 / 157 / 2, 135 / 158 / 3, 13 / 159 / 2, 63 / 160 / 2, 117 / 161 / 4, 29 / 162 / 2, 6 / 163 / 3, 325 / 164 / 2, 201 / 165 / 2, 17 / 166 / 4, 95 / 167 / 2, 134 / 168 / 2, 23 / 169 / 4, 317 / 170 / 2, 147 / 171 / 2, 342 / 172 / 3, 343 / 173 / 2, 205 / 174 / 2, 208 / 175 / 2, 43 / 176 / 2, 248 / 177 / 2, 304 / 178 / 2, 183 / 179 / 2, 116 / 180 / 2, 300 / 181 / 2, 37 / 182 / 3, 8 / 183 / 2, 213 / 184 / 2, 82 / 185 / 2, 269 / 186 / 2, 315 / 187 / 2, 106 / 188 / 2, 209 / 189 / 2, 28 / 190 / 7, 108 / 191 / 2, 238 / 192 / 2, 91 / 193 / 2, 83 / 194 / 3, 239 / 195 / 2, 125 / 196 / 3, 235 / 197 / 2, 252 / 198 / 4, 12 / 199 / 2, 71 / 200 / 3, 113 / 201 / 2, 123 / 202 / 2, 188 / 203 / 2, 51 / 204 / 2, 247 / 205 / 2, 127 / 206 / 2, 35 / 207 / 2, 299 / 208 / 2, 81 / 209 / 2, 142 / 210 / 2, 302 / 211 / 2, 65 / 212 / 4, 156 / 213 / 2, 161 / 214 / 2, 146 / 215 / 2, 57 / 216 / 7, 232 / 217 / 2, 136 / 218 / 2, 322 / 219 / 2, 260 / 220 / 2, 80 / 221 / 3, 257 / 222 / 2, 334 / 223 / 3, 158 / 224 / 2, 355 / 225 / 3, 1 / 226 / 2, 345 / 227 / 3, 171 / 228 / 2, 119 / 229 / 2, 354 / 230 / 2, 240 / 231 / 5, 371 / 232 / 2, 225 / 233 / 3, 270 / 234 / 2, 286 / 235 / 3, 229 / 236 / 2, 64 / 237 / 2, 54 / 238 / 2, 24 / 239 / 3, 61 / 240 / 2, 207 / 241 / 2, 347 / 242 / 3, 245 / 243 / 2, 318 / 244 / 5, 151 / 245 / 2, 115 / 246 / 2, 271 / 247 / 2, 273 / 248 / 3, 152 / 249 / 2, 243 / 250 / 2, 94 / 251 / 4, 105 / 252 / 2, 351 / 253 / 2, 340 / 254 / 2, 185 / 255 / 2, 215 / 256 / 4, 170 / 257 / 2, 192 / 258 / 2, 219 / 259 / 3, 296 / 260 / 2, 227 / 261 / 2, 212 / 262 / 2, 148 / 263 / 2, 217 / 264 / 2, 74 / 265 / 3, 79 / 266 / 2, 191 / 267 / 3, 126 / 268 / 2, 267 / 269 / 2, 258 / 270 / 2, 184 / 271 / 2, 333 / 272 / 3, 335 / 273 / 2, 3 / 274 / 2, 211 / 275 / 2, 129 / 276 / 2, 169 / 277 / 2, 349 / 278 / 5, 313 / 279 / 2, 360 / 280 / 2, 31 / 281 / 2, 62 / 282 / 2, 268 / 283 / 6, 331 / 284 / 2, 222 / 285 / 2, 194 / 286 / 3, 153 / 287 / 2, 33 / 288 / 2, 199 / 289 / 4, 56 / 290 / 2, 96 / 291 / 2, 109 / 292 / 4, 253 / 293 / 2, 323 / 294 / 2, 5 / 295 / 2, 264 / 296 / 5, 157 / 297 / 2, 120 / 298 / 2, 2 / 299 / 4, 223 / 300 / 2, 328 / 301 / 2, 327 / 302 / 2, 196 / 303 / 2, 100 / 304 / 3, 198 / 305 / 2, 312 / 306 / 2, 187 / 307 / 2, 237 / 308 / 2, 55 / 309 / 2, 26 / 310 / 3, 297 / 311 / 2, 234 / 312 / 7, 47 / 313 / 2, 353 / 314 / 2, 265 / 315 / 2, 307 / 316 / 2, 285 / 317 / 2, 214 / 318 / 5, 175 / 319 / 2, 10 / 320 / 2, 133 / 321 / 3, 283 / 322 / 2, 363 / 323 / 2, 159 / 324 / 3, 356 / 325 / 2, 22 / 326 / 3, 242 / 327 / 2, 316 / 328 / 2, 324 / 329 / 3, 224 / 330 / 2, 278 / 331 / 2, 4 / 332 / 3, 76 / 333 / 2, 69 / 334 / 2, 359 / 335 / 2, 365 / 336 / 3, 114 / 337 / 2, 277 / 338 / 3, 298 / 339 / 2, 49 / 340 / 2, 197 / 341 / 2, 52 / 342 / 2, 160 / 343 / 2, 97 / 344 / 2, 46 / 345 / 2, 93 / 346 / 4, 41 / 347 / 2, 163 / 348 / 3, 254 / 349 / 2, 233 / 350 / 4, 73 / 351 / 2, 53 / 352 / 2, 262 / 353 / 4, 259 / 354 / 2, 301 / 355 / 2, 203 / 356 / 2, 372 / 357 / 3, 366 / 358 / 2, 78 / 359 / 3, 289 / 360 / 2, 59 / 361 / 6, 89 / 362 / 2, 202 / 363 / 2, 111 / 364 / 3, 75 / 365 / 2, 336 / 366 / 4, 58 / 367 / 2, 186 / 368 / 2, 124 / 369 / 4, 72 / 370 / 2, 309 / 371 / 2, 107 / 372 / 2, 350 / 373 / 8, 306 / 374 / 2
doublecenter-alpha_1-19-n6.txt, 1, 1, 6, 516.415, 27, 21, 6, 5,5 / 1 / 2, 4 / 2 / 6, 1 / 3 / 2, 3 / 4 / 2, 2 / 5 / 4
doublecenter-alpha_1-2-n250.txt, 1, 1, 250, 2818.33, 2198, 1948, 10, 249,73 / 1 / 6, 12 / 2 / 2, 139 / 3 / 2, 75 / 4 / 2, 113 / 5 / 4, 160 / 6 / 2, 120 / 7 / 2, 46 / 8 / 6, 14 / 9 / 2, 123 / 10 / 2, 132 / 11 / 2, 186 / 12 / 2, 94 / 13 / 2, 98 / 14 / 4, 189 / 15 / 2, 131 / 16 / 2, 171 / 17 / 2, 119 / 18 / 3, 136 / 19 / 2, 225 / 20 / 3, 209 / 21 / 2, 174 / 22 / 2, 71 / 23 / 2, 10 / 24 / 3, 248 / 25 / 2, 176 / 26 / 3, 130 / 27 / 2, 86 / 28 / 3, 103 / 29 / 2, 17 / 30 / 2, 188 / 31 / 3, 81 / 32 / 2, 100 / 33 / 2, 211 / 34 / 2, 237 / 35 / 2, 156 / 36 / 3, 59 / 37 / 2, 224 / 38 / 2, 196 / 39 / 4, 122 / 40 / 2, 172 / 41 / 3, 168 / 42 / 2, 229 / 43 / 2, 150 / 44 / 4, 107 / 45 / 2, 238 / 46 / 2, 63 / 47 / 3, 148 / 48 / 2, 169 / 49 / 2, 45 / 50 / 3, 112 / 51 / 2, 142 / 52 / 2, 51 / 53 / 3, 99 / 54 / 2, 11 / 55 / 2, 85 / 56 / 2, 184 / 57 / 3, 33 / 58 / 2, 177 / 59 / 3, 53 / 60 / 2, 15 / 61 / 3, 23 / 62 / 2, 34 / 63 / 2, 178 / 64 / 4, 118 / 65 / 2, 190 / 66 / 2, 197 / 67 / 2, 74 / 68 / 2, 193 / 69 / 2, 43 / 70 / 2, 56 / 71 / 2, 83 / 72 / 5, 87 / 73 / 2, 104 / 74 / 2, 32 / 75 / 3, 204 / 76 / 2, 54 / 77 / 4, 134 / 78 / 2, 232 / 79 / 2, 58 / 80 / 2, 116 / 81 / 2, 222 / 82 / 2, 110 / 83 / 2, 101 / 84 / 2, 66 / 85 / 3, 37 / 86 / 2, 24 / 87 / 3, 92 / 88 / 2, 115 / 89 / 2, 213 / 90 / 3, 124 / 91 / 2, 154 / 92 / 2, 223 / 93 / 2, 9 / 94 / 4, 62 / 95 / 2, 93 / 96 / 2, 114 / 97 / 2, 127 / 98 / 2, 234 / 99 / 2, 165 / 100 / 3, 205 / 101 / 2, 217 / 102 / 3, 173 / 103 / 2, 129 / 104 / 3, 44 / 105 / 2, 242 / 106 / 2, 231 / 107 / 3, 68 / 108 / 2, 84 / 109 / 2, 70 / 110 / 2, 175 / 111 / 2, 76 / 112 / 2, 198 / 113 / 3, 249 / 114 / 2, 28 / 115 / 2, 236 / 116 / 2, 219 / 117 / 2, 26 / 118 / 8, 4 / 119 / 2, 218 / 120 / 3, 191 / 121 / 2, 20 / 122 / 3, 182 / 123 / 2, 192 / 124 / 3, 141 / 125 / 2, 30 / 126 / 2, 31 / 127 / 2, 207 / 128 / 3, 79 / 129 / 2, 64 / 130 / 2, 138 / 131 / 2, 126 / 132 / 2, 133 / 133 / 2, 69 / 134 / 3, 161 / 135 / 2, 137 / 136 / 2, 102 / 137 / 3, 221 / 138 / 2, 55 / 139 / 2, 1 / 140 / 2, 241 / 141 / 2, 206 / 142 / 2, 7 / 143 / 2, 109 / 144 / 2, 233 / 145 / 2, 67 / 146 / 10, 239 / 147 / 2, 78 / 148 / 2, 179 / 149 / 2, 128 / 150 / 3, 18 / 151 / 2, 220 / 152 / 3, 65 / 153 / 2, 153 / 154 / 2, 25 / 155 / 3, 170 / 156 / 2, 2 / 157 / 2, 16 / 158 / 2, 146 / 159 / 2, 201 / 160 / 2, 61 / 161 / 2, 40 / 162 / 2, 187 / 163 / 2, 35 / 164 / 2, 216 / 165 / 2, 157 / 166 / 4, 39 / 167 / 2, 77 / 168 / 3, 36 / 169 / 2, 162 / 170 / 2, 29 / 171 / 2, 106 / 172 / 2, 166 / 173 / 2, 143 / 174 / 5, 227 / 175 / 2, 245 / 176 / 2, 72 / 177 / 2, 50 / 178 / 2, 47 / 179 / 2, 200 / 180 / 2, 42 / 181 / 2, 8 / 182 / 2, 91 / 183 / 2, 149 / 184 / 2, 60 / 185 / 2, 230 / 186 / 4, 48 / 187 / 2, 80 / 188 / 3, 135 / 189 / 2, 82 / 190 / 2, 95 / 191 / 8, 226 / 192 / 2, 105 / 193 / 3, 41 / 194 / 2, 117 / 195 / 2, 202 / 196 / 3, 235 / 197 / 2, 246 / 198 / 2, 210 / 199 / 2, 199 / 200 / 3, 203 / 201 / 2, 215 / 202 / 2, 214 / 203 / 3, 158 / 204 / 2, 167 / 205 / 3, 108 / 206 / 2, 185 / 207 / 2, 164 / 208 / 3, 243 / 209 / 2, 208 / 210 / 2, 151 / 211 / 4, 6 / 212 / 2, 194 / 213 / 2, 195 / 214 / 3, 147 / 215 / 2, 49 / 216 / 3, 240 / 217 / 2, 3 / 218 / 3, 5 / 219 / 2, 57 / 220 / 2, 181 / 221 / 4, 96 / 222 / 2, 212 / 223 / 2, 19 / 224 / 2, 121 / 225 / 2, 125 / 226 / 3, 183 / 227 / 2, 97 / 228 / 3, 145 / 229 / 2, 90 / 230 / 2, 21 / 231 / 5, 88 / 232 / 2, 38 / 233 / 2, 247 / 234 / 2, 89 / 235 / 4, 180 / 236 / 2, 140 / 237 / 2, 244 / 238 / 2, 155 / 239 / 2, 52 / 240 / 2, 22 / 241 / 2, 228 / 242 / 4, 13 / 243 / 2, 152 / 244 / 3, 144 / 245 / 2, 163 / 246 / 3, 159 / 247 / 2, 27 / 248 / 2, 111 / 249 / 3
doublecenter-alpha_1-2-n375.txt, 1, 1, 375, 3927.17, 3026, 2651, 8, 374,113 / 1 / 2, 324 / 2 / 2, 160 / 3 / 2, 6 / 4 / 2, 201 / 5 / 2, 306 / 6 / 2, 114 / 7 / 3, 145 / 8 / 2, 364 / 9 / 2, 232 / 10 / 3, 263 / 11 / 2, 15 / 12 / 3, 84 / 13 / 2, 180 / 14 / 3, 59 / 15 / 2, 96 / 16 / 2, 274 / 17 / 2, 307 / 18 / 3, 290 / 19 / 2, 188 / 20 / 2, 20 / 21 / 3, 86 / 22 / 2, 373 / 23 / 2, 248 / 24 / 2, 166 / 25 / 2, 30 / 26 / 5, 283 / 27 / 2, 205 / 28 / 2, 273 / 29 / 3, 281 / 30 / 2, 120 / 31 / 3, 193 / 32 / 2, 77 / 33 / 2, 293 / 34 / 4, 69 / 35 / 2, 194 / 36 / 2, 177 / 37 / 2, 23 / 38 / 7, 33 / 39 / 2, 282 / 40 / 2, 156 / 41 / 2, 79 / 42 / 3, 173 / 43 / 2, 115 / 44 / 2, 61 / 45 / 2, 321 / 46 / 2, 49 / 47 / 3, 78 / 48 / 2, 48 / 49 / 3, 275 / 50 / 2, 82 / 51 / 2, 26 / 52 / 2, 291 / 53 / 3, 142 / 54 / 2, 297 / 55 / 2, 365 / 56 / 2, 370 / 57 / 2, 128 / 58 / 3, 239 / 59 / 2, 106 / 60 / 3, 315 / 61 / 2, 208 / 62 / 3, 221 / 63 / 2, 122 / 64 / 3, 223 / 65 / 2, 313 / 66 / 3, 303 / 67 / 2, 351 / 68 / 4, 181 / 69 / 2, 52 / 70 / 2, 45 / 71 / 2, 249 / 72 / 2, 99 / 73 / 2, 143 / 74 / 3, 344 / 75 / 2, 302 / 76 / 2, 270 / 77 / 3, 169 / 78 / 2, 186 / 79 / 3, 161 / 80 / 2, 108 / 81 / 2, 28 / 82 / 2, 240 / 83 / 3, 17 / 84 / 2, 317 / 85 / 2, 71 / 86 / 2, 330 / 87 / 8, 81 / 88 / 2, 217 / 89 / 2, 101 / 90 / 2, 9 / 91 / 3, 325 / 92 / 2, 93 / 93 / 3, 354 / 94 / 2, 242 / 95 / 3, 256 / 96 / 2, 312 / 97 / 2, 284 / 98 / 4, 337 / 99 / 2, 227 / 100 / 2, 296 / 101 / 2, 224 / 102 / 2, 129 / 103 / 3, 50 / 104 / 2, 357 / 105 / 2, 358 / 106 / 4, 97 / 107 / 2, 191 / 108 / 2, 58 / 109 / 4, 174 / 110 / 2, 238 / 111 / 2, 167 / 112 / 3, 63 / 113 / 2, 299 / 114 / 2, 57 / 115 / 2, 339 / 116 / 3, 43 / 117 / 2, 85 / 118 / 2, 369 / 119 / 3, 289 / 120 / 2, 333 / 121 / 2, 184 / 122 / 2, 198 / 123 / 6, 55 / 124 / 2, 305 / 125 / 2, 51 / 126 / 3, 178 / 127 / 2, 279 / 128 / 2, 70 / 129 / 2, 309 / 130 / 2, 347 / 131 / 2, 36 / 132 / 3, 67 / 133 / 2, 335 / 134 / 2, 229 / 135 / 2, 163 / 136 / 2, 286 / 137 / 4, 2 / 138 / 2, 316 / 139 / 2, 135 / 140 / 3, 90 / 141 / 2, 152 / 142 / 2, 5 / 143 / 5, 21 / 144 / 2, 144 / 145 / 3, 277 / 146 / 2, 259 / 147 / 2, 225 / 148 / 4, 236 / 149 / 2, 207 / 150 / 2, 234 / 151 / 4, 121 / 152 / 2, 189 / 153 / 2, 246 / 154 / 2, 262 / 155 / 2, 219 / 156 / 2, 278 / 157 / 2, 363 / 158 / 4, 352 / 159 / 2, 322 / 160 / 2, 149 / 161 / 4, 16 / 162 / 2, 1 / 163 / 2, 66 / 164 / 2, 213 / 165 / 2, 159 / 166 / 2, 153 / 167 / 2, 216 / 168 / 2, 214 / 169 / 2, 331 / 170 / 3, 292 / 171 / 2, 355 / 172 / 2, 222 / 173 / 2, 341 / 174 / 5, 65 / 175 / 2, 125 / 176 / 2, 136 / 177 / 3, 47 / 178 / 2, 255 / 179 / 3, 295 / 180 / 2, 107 / 181 / 3, 40 / 182 / 2, 64 / 183 / 3, 100 / 184 / 2, 362 / 185 / 2, 251 / 186 / 3, 126 / 187 / 2, 10 / 188 / 3, 304 / 189 / 2, 158 / 190 / 2, 374 / 191 / 3, 102 / 192 / 2, 215 / 193 / 2, 308 / 194 / 4, 371 / 195 / 2, 25 / 196 / 2, 88 / 197 / 2, 237 / 198 / 2, 310 / 199 / 2, 212 / 200 / 3, 368 / 201 / 2, 218 / 202 / 2, 44 / 203 / 2, 119 / 204 / 2, 328 / 205 / 2, 235 / 206 / 2, 190 / 207 / 2, 241 / 208 / 2, 361 / 209 / 3, 231 / 210 / 2, 211 / 211 / 3, 253 / 212 / 2, 11 / 213 / 2, 13 / 214 / 3, 73 / 215 / 2, 366 / 216 / 3, 171 / 217 / 2, 199 / 218 / 2, 200 / 219 / 2, 319 / 220 / 2, 268 / 221 / 2, 372 / 222 / 2, 124 / 223 / 2, 147 / 224 / 2, 280 / 225 / 2, 175 / 226 / 2, 150 / 227 / 3, 134 / 228 / 2, 254 / 229 / 2, 62 / 230 / 2, 342 / 231 / 4, 176 / 232 / 2, 112 / 233 / 2, 195 / 234 / 3, 336 / 235 / 2, 298 / 236 / 2, 301 / 237 / 2, 157 / 238 / 2, 68 / 239 / 3, 294 / 240 / 2, 288 / 241 / 3, 133 / 242 / 2, 226 / 243 / 3, 192 / 244 / 2, 154 / 245 / 3, 206 / 246 / 2, 117 / 247 / 2, 327 / 248 / 2, 151 / 249 / 6, 348 / 250 / 2, 139 / 251 / 3, 103 / 252 / 2, 340 / 253 / 2, 76 / 254 / 3, 94 / 255 / 2, 338 / 256 / 3, 179 / 257 / 2, 182 / 258 / 2, 109 / 259 / 3, 265 / 260 / 2, 19 / 261 / 2, 349 / 262 / 5, 46 / 263 / 2, 267 / 264 / 2, 41 / 265 / 3, 37 / 266 / 2, 130 / 267 / 2, 209 / 268 / 2, 343 / 269 / 2, 87 / 270 / 2, 360 / 271 / 2, 264 / 272 / 4, 261 / 273 / 2, 247 / 274 / 2, 346 / 275 / 2, 89 / 276 / 2, 27 / 277 / 4, 162 / 278 / 2, 183 / 279 / 2, 210 / 280 / 2, 329 / 281 / 5, 138 / 282 / 2, 332 / 283 / 2, 202 / 284 / 2, 257 / 285 / 2, 118 / 286 / 3, 3 / 287 / 2, 155 / 288 / 3, 104 / 289 / 2, 196 / 290 / 2, 91 / 291 / 3, 269 / 292 / 2, 228 / 293 / 2, 314 / 294 / 3, 204 / 295 / 2, 146 / 296 / 3, 110 / 297 / 2, 233 / 298 / 2, 140 / 299 / 2, 148 / 300 / 4, 131 / 301 / 2, 29 / 302 / 2, 54 / 303 / 2, 95 / 304 / 4, 53 / 305 / 2, 72 / 306 / 2, 127 / 307 / 2, 334 / 308 / 2, 187 / 309 / 2, 300 / 310 / 3, 276 / 311 / 2, 271 / 312 / 2, 132 / 313 / 4, 220 / 314 / 2, 74 / 315 / 2, 22 / 316 / 2, 98 / 317 / 2, 39 / 318 / 3, 230 / 319 / 2, 350 / 320 / 3, 345 / 321 / 2, 35 / 322 / 2, 80 / 323 / 3, 60 / 324 / 2, 12 / 325 / 3, 359 / 326 / 2, 123 / 327 / 2, 266 / 328 / 3, 56 / 329 / 2, 75 / 330 / 2, 4 / 331 / 3, 367 / 332 / 2, 258 / 333 / 3, 244 / 334 / 2, 243 / 335 / 2, 141 / 336 / 4, 311 / 337 / 2, 92 / 338 / 2, 168 / 339 / 2, 116 / 340 / 4, 172 / 341 / 2, 42 / 342 / 2, 31 / 343 / 2, 38 / 344 / 6, 34 / 345 / 2, 272 / 346 / 3, 250 / 347 / 2, 83 / 348 / 2, 260 / 349 / 4, 32 / 350 / 2, 165 / 351 / 2, 197 / 352 / 3, 326 / 353 / 2, 111 / 354 / 2, 18 / 355 / 5, 287 / 356 / 2, 320 / 357 / 2, 164 / 358 / 2, 7 / 359 / 2, 356 / 360 / 2, 8 / 361 / 3, 203 / 362 / 2, 323 / 363 / 3, 285 / 364 / 2, 252 / 365 / 2, 14 / 366 / 2, 185 / 367 / 2, 245 / 368 / 2, 105 / 369 / 3, 24 / 370 / 2, 170 / 371 / 2, 137 / 372 / 2, 318 / 373 / 2, 353 / 374 / 4
doublecenter-alpha_1-2-n5.txt, 1, 1, 5, 459.018, 19, 14, 5, 4,4 / 1 / 3, 3 / 2 / 2, 1 / 3 / 2, 2 / 4 / 5
doublecenter-alpha_1-20-n375.txt, 1, 1, 375, 3835.69, 3012, 2637, 7, 374,247 / 1 / 3, 145 / 2 / 2, 75 / 3 / 2, 73 / 4 / 2, 262 / 5 / 2, 322 / 6 / 3, 31 / 7 / 2, 211 / 8 / 3, 291 / 9 / 2, 67 / 10 / 4, 267 / 11 / 2, 296 / 12 / 3, 202 / 13 / 2, 22 / 14 / 4, 300 / 15 / 2, 200 / 16 / 2, 135 / 17 / 4, 49 / 18 / 2, 10 / 19 / 2, 355 / 20 / 3, 182 / 21 / 2, 33 / 22 / 3, 244 / 23 / 2, 11 / 24 / 2, 217 / 25 / 3, 240 / 26 / 2, 118 / 27 / 2, 351 / 28 / 2, 346 / 29 / 2, 274 / 30 / 3, 331 / 31 / 2, 297 / 32 / 2, 146 / 33 / 2, 277 / 34 / 2, 120 / 35 / 2, 115 / 36 / 2, 181 / 37 / 3, 3 / 38 / 2, 69 / 39 / 6, 341 / 40 / 2, 261 / 41 / 2, 338 / 42 / 3, 221 / 43 / 2, 254 / 44 / 2, 42 / 45 / 7, 16 / 46 / 2, 157 / 47 / 2, 328 / 48 / 3, 368 / 49 / 2, 360 / 50 / 3, 141 / 51 / 2, 162 / 52 / 3, 127 / 53 / 2, 86 / 54 / 3, 170 / 55 / 2, 321 / 56 / 3, 349 / 57 / 2, 335 / 58 / 3, 173 / 59 / 2, 224 / 60 / 2, 119 / 61 / 3, 63 / 62 / 2, 265 / 63 / 2, 227 / 64 / 5, 160 / 65 / 2, 344 / 66 / 2, 363 / 67 / 2, 278 / 68 / 2, 271 / 69 / 2, 58 / 70 / 5, 365 / 71 / 2, 372 / 72 / 2, 268 / 73 / 2, 246 / 74 / 2, 348 / 75 / 2, 184 / 76 / 4, 185 / 77 / 2, 109 / 78 / 2, 336 / 79 / 2, 144 / 80 / 3, 19 / 81 / 2, 356 / 82 / 3, 121 / 83 / 2, 190 / 84 / 2, 53 / 85 / 3, 253 / 86 / 2, 37 / 87 / 3, 7 / 88 / 2, 212 / 89 / 2, 107 / 90 / 2, 232 / 91 / 4, 339 / 92 / 2, 373 / 93 / 2, 124 / 94 / 2, 195 / 95 / 3, 196 / 96 / 2, 233 / 97 / 2, 366 / 98 / 3, 15 / 99 / 2, 138 / 100 / 2, 108 / 101 / 2, 352 / 102 / 3, 354 / 103 / 2, 208 / 104 / 3, 114 / 105 / 2, 256 / 106 / 2, 39 / 107 / 3, 25 / 108 / 2, 94 / 109 / 2, 197 / 110 / 5, 281 / 111 / 2, 192 / 112 / 2, 168 / 113 / 2, 187 / 114 / 5, 288 / 115 / 2, 313 / 116 / 2, 319 / 117 / 3, 260 / 118 / 2, 279 / 119 / 2, 47 / 120 / 2, 125 / 121 / 2, 364 / 122 / 2, 370 / 123 / 2, 71 / 124 / 2, 191 / 125 / 3, 203 / 126 / 2, 105 / 127 / 3, 332 / 128 / 2, 255 / 129 / 2, 48 / 130 / 3, 188 / 131 / 2, 359 / 132 / 3, 97 / 133 / 2, 269 / 134 / 5, 320 / 135 / 2, 51 / 136 / 2, 152 / 137 / 2, 111 / 138 / 2, 276 / 139 / 2, 91 / 140 / 4, 270 / 141 / 2, 218 / 142 / 2, 176 / 143 / 2, 113 / 144 / 4, 155 / 145 / 2, 293 / 146 / 2, 1 / 147 / 2, 99 / 148 / 2, 301 / 149 / 3, 20 / 150 / 2, 248 / 151 / 2, 266 / 152 / 2, 222 / 153 / 4, 358 / 154 / 2, 36 / 155 / 2, 23 / 156 / 2, 102 / 157 / 3, 316 / 158 / 2, 238 / 159 / 2, 283 / 160 / 2, 87 / 161 / 7, 329 / 162 / 2, 83 / 163 / 2, 239 / 164 / 2, 147 / 165 / 2, 140 / 166 / 2, 21 / 167 / 2, 280 / 168 / 2, 303 / 169 / 2, 164 / 170 / 2, 5 / 171 / 3, 308 / 172 / 2, 35 / 173 / 2, 143 / 174 / 2, 70 / 175 / 6, 287 / 176 / 2, 223 / 177 / 2, 166 / 178 / 2, 292 / 179 / 2, 78 / 180 / 5, 178 / 181 / 2, 367 / 182 / 2, 189 / 183 / 2, 132 / 184 / 3, 193 / 185 / 2, 59 / 186 / 2, 326 / 187 / 2, 112 / 188 / 2, 38 / 189 / 2, 32 / 190 / 2, 117 / 191 / 2, 295 / 192 / 2, 310 / 193 / 2, 204 / 194 / 2, 312 / 195 / 2, 134 / 196 / 2, 174 / 197 / 2, 169 / 198 / 2, 26 / 199 / 3, 231 / 200 / 2, 180 / 201 / 3, 259 / 202 / 2, 343 / 203 / 3, 2 / 204 / 2, 148 / 205 / 2, 129 / 206 / 2, 61 / 207 / 2, 220 / 208 / 2, 179 / 209 / 2, 306 / 210 / 2, 6 / 211 / 3, 201 / 212 / 2, 88 / 213 / 3, 369 / 214 / 2, 299 / 215 / 2, 194 / 216 / 6, 350 / 217 / 2, 347 / 218 / 2, 234 / 219 / 2, 275 / 220 / 2, 96 / 221 / 2, 235 / 222 / 3, 136 / 223 / 2, 161 / 224 / 3, 245 / 225 / 2, 24 / 226 / 3, 205 / 227 / 2, 290 / 228 / 2, 230 / 229 / 2, 44 / 230 / 3, 251 / 231 / 2, 207 / 232 / 2, 272 / 233 / 6, 156 / 234 / 2, 258 / 235 / 2, 167 / 236 / 3, 122 / 237 / 2, 55 / 238 / 3, 98 / 239 / 2, 353 / 240 / 2, 228 / 241 / 2, 159 / 242 / 3, 85 / 243 / 2, 257 / 244 / 2, 13 / 245 / 2, 76 / 246 / 2, 183 / 247 / 2, 128 / 248 / 3, 74 / 249 / 2, 285 / 250 / 2, 12 / 251 / 3, 225 / 252 / 2, 264 / 253 / 2, 362 / 254 / 4, 311 / 255 / 2, 361 / 256 / 3, 100 / 257 / 2, 54 / 258 / 2, 374 / 259 / 2, 215 / 260 / 4, 80 / 261 / 2, 171 / 262 / 3, 40 / 263 / 2, 137 / 264 / 2, 337 / 265 / 2, 242 / 266 / 2, 314 / 267 / 2, 82 / 268 / 3, 14 / 269 / 2, 305 / 270 / 5, 29 / 271 / 2, 163 / 272 / 2, 282 / 273 / 3, 17 / 274 / 2, 101 / 275 / 2, 345 / 276 / 2, 8 / 277 / 2, 213 / 278 / 2, 126 / 279 / 2, 110 / 280 / 2, 131 / 281 / 2, 333 / 282 / 2, 153 / 283 / 2, 149 / 284 / 3, 357 / 285 / 2, 334 / 286 / 5, 4 / 287 / 2, 177 / 288 / 2, 84 / 289 / 2, 286 / 290 / 3, 56 / 291 / 2, 250 / 292 / 2, 226 / 293 / 2, 28 / 294 / 2, 116 / 295 / 2, 90 / 296 / 2, 327 / 297 / 2, 206 / 298 / 2, 106 / 299 / 2, 50 / 300 / 2, 307 / 301 / 2, 77 / 302 / 6, 249 / 303 / 2, 199 / 304 / 2, 57 / 305 / 3, 371 / 306 / 2, 142 / 307 / 2, 340 / 308 / 4, 43 / 309 / 2, 229 / 310 / 2, 172 / 311 / 3, 309 / 312 / 2, 289 / 313 / 2, 252 / 314 / 3, 304 / 315 / 2, 210 / 316 / 5, 27 / 317 / 2, 45 / 318 / 2, 219 / 319 / 3, 237 / 320 / 2, 130 / 321 / 2, 93 / 322 / 3, 318 / 323 / 2, 325 / 324 / 2, 46 / 325 / 2, 186 / 326 / 2, 317 / 327 / 2, 104 / 328 / 5, 273 / 329 / 2, 323 / 330 / 2, 241 / 331 / 3, 66 / 332 / 2, 133 / 333 / 3, 236 / 334 / 2, 79 / 335 / 3, 165 / 336 / 2, 72 / 337 / 3, 151 / 338 / 2, 30 / 339 / 2, 18 / 340 / 4, 60 / 341 / 2, 294 / 342 / 2, 95 / 343 / 4, 330 / 344 / 2, 150 / 345 / 2, 34 / 346 / 2, 198 / 347 / 2, 52 / 348 / 4, 342 / 349 / 2, 9 / 350 / 2, 154 / 351 / 2, 41 / 352 / 2, 324 / 353 / 3, 123 / 354 / 2, 302 / 355 / 3, 65 / 356 / 2, 175 / 357 / 2, 243 / 358 / 2, 62 / 359 / 2, 89 / 360 / 2, 158 / 361 / 2, 64 / 362 / 2, 284 / 363 / 2, 139 / 364 / 3, 92 / 365 / 2, 68 / 366 / 3, 298 / 367 / 2, 263 / 368 / 2, 81 / 369 / 3, 214 / 370 / 2, 216 / 371 / 3, 315 / 372 / 2, 103 / 373 / 2, 209 / 374 / 4
doublecenter-alpha_1-20-n6.txt, 1, 1, 6, 486.292, 23, 17, 3, 5,4 / 1 / 3, 5 / 2 / 2, 3 / 3 / 2, 2 / 4 / 3, 1 / 5 / 2
doublecenter-alpha_1-21-n7.txt, 1, 1, 7, 679.817, 35, 28, 7, 6,6 / 1 / 3, 1 / 2 / 2, 4 / 3 / 7, 2 / 4 / 2, 5 / 5 / 2, 3 / 6 / 3
doublecenter-alpha_1-22-n7.txt, 1, 1, 7, 578.001, 36, 29, 6, 6,6 / 1 / 6, 3 / 2 / 2, 2 / 3 / 2, 1 / 4 / 3, 4 / 5 / 2, 5 / 6 / 3
doublecenter-alpha_1-23-n7.txt, 1, 1, 7, 625.472, 34, 27, 4, 6,5 / 1 / 3, 2 / 2 / 2, 1 / 3 / 4, 4 / 4 / 2, 3 / 5 / 2, 6 / 6 / 2
doublecenter-alpha_1-24-n7.txt, 1, 1, 7, 616.903, 32, 25, 3, 6,1 / 1 / 3, 2 / 2 / 2, 4 / 3 / 2, 6 / 4 / 3, 3 / 5 / 2, 5 / 6 / 3
doublecenter-alpha_1-25-n7.txt, 1, 1, 7, 816.052, 33, 26, 5, 6,5 / 1 / 3, 2 / 2 / 2, 3 / 3 / 2, 1 / 4 / 2, 6 / 5 / 5, 4 / 6 / 2
doublecenter-alpha_1-26-n7.txt, 1, 1, 7, 543.29, 32, 25, 4, 6,6 / 1 / 3, 5 / 2 / 2, 4 / 3 / 3, 2 / 4 / 2, 3 / 5 / 2, 1 / 6 / 4
doublecenter-alpha_1-27-n7.txt, 1, 1, 7, 562.15, 36, 29, 4, 6,1 / 1 / 3, 2 / 2 / 2, 4 / 3 / 4, 6 / 4 / 2, 3 / 5 / 2, 5 / 6 / 4
doublecenter-alpha_1-28-n7.txt, 1, 1, 7, 670.512, 34, 27, 5, 6,4 / 1 / 2, 5 / 2 / 5, 1 / 3 / 2, 3 / 4 / 2, 6 / 5 / 2, 2 / 6 / 4
doublecenter-alpha_1-29-n7.txt, 1, 1, 7, 553.979, 34, 27, 4, 6,6 / 1 / 3, 2 / 2 / 2, 4 / 3 / 4, 3 / 4 / 2, 5 / 5 / 2, 1 / 6 / 4
doublecenter-alpha_1-3-n250.txt, 1, 1, 250, 3039.43, 1885, 1635, 6, 249,217 / 1 / 2, 112 / 2 / 2, 4 / 3 / 2, 121 / 4 / 3, 178 / 5 / 2, 128 / 6 / 3, 192 / 7 / 2, 39 / 8 / 2, 176 / 9 / 3, 102 / 10 / 2, 47 / 11 / 2, 233 / 12 / 2, 42 / 13 / 2, 93 / 14 / 2, 32 / 15 / 3, 74 / 16 / 2, 46 / 17 / 2, 245 / 18 / 2, 216 / 19 / 3, 195 / 20 / 2, 44 / 21 / 2, 104 / 22 / 2, 14 / 23 / 2, 82 / 24 / 2, 28 / 25 / 2, 213 / 26 / 3, 66 / 27 / 2, 70 / 28 / 2, 147 / 29 / 3, 180 / 30 / 2, 129 / 31 / 3, 83 / 32 / 2, 81 / 33 / 3, 177 / 34 / 2, 219 / 35 / 2, 75 / 36 / 3, 50 / 37 / 2, 210 / 38 / 2, 12 / 39 / 2, 240 / 40 / 2, 149 / 41 / 2, 156 / 42 / 2, 236 / 43 / 2, 53 / 44 / 3, 199 / 45 / 2, 244 / 46 / 3, 52 / 47 / 2, 18 / 48 / 3, 189 / 49 / 2, 152 / 50 / 2, 40 / 51 / 3, 3 / 52 / 2, 218 / 53 / 2, 230 / 54 / 2, 99 / 55 / 2, 214 / 56 / 2, 116 / 57 / 2, 92 / 58 / 3, 101 / 59 / 2, 164 / 60 / 3, 84 / 61 / 2, 35 / 62 / 2, 211 / 63 / 2, 105 / 64 / 2, 64 / 65 / 2, 182 / 66 / 3, 224 / 67 / 2, 72 / 68 / 3, 238 / 69 / 2, 27 / 70 / 3, 161 / 71 / 2, 16 / 72 / 2, 193 / 73 / 3, 23 / 74 / 2, 89 / 75 / 2, 163 / 76 / 3, 227 / 77 / 2, 239 / 78 / 2, 117 / 79 / 3, 185 / 80 / 2, 20 / 81 / 2, 45 / 82 / 4, 167 / 83 / 2, 111 / 84 / 2, 98 / 85 / 2, 184 / 86 / 2, 110 / 87 / 2, 170 / 88 / 3, 54 / 89 / 2, 166 / 90 / 2, 58 / 91 / 2, 33 / 92 / 2, 140 / 93 / 2, 127 / 94 / 2, 48 / 95 / 2, 171 / 96 / 4, 181 / 97 / 2, 95 / 98 / 2, 91 / 99 / 3, 174 / 100 / 2, 141 / 101 / 2, 208 / 102 / 3, 123 / 103 / 2, 130 / 104 / 2, 113 / 105 / 3, 247 / 106 / 2, 5 / 107 / 6, 88 / 108 / 2, 41 / 109 / 3, 17 / 110 / 2, 194 / 111 / 3, 190 / 112 / 2, 179 / 113 / 2, 67 / 114 / 3, 13 / 115 / 2, 73 / 116 / 2, 26 / 117 / 4, 37 / 118 / 2, 234 / 119 / 2, 137 / 120 / 3, 77 / 121 / 2, 202 / 122 / 2, 237 / 123 / 4, 25 / 124 / 2, 186 / 125 / 2, 36 / 126 / 3, 80 / 127 / 2, 249 / 128 / 3, 11 / 129 / 2, 21 / 130 / 2, 24 / 131 / 3, 19 / 132 / 2, 221 / 133 / 3, 60 / 134 / 2, 9 / 135 / 2, 136 / 136 / 4, 155 / 137 / 2, 15 / 138 / 2, 114 / 139 / 4, 8 / 140 / 2, 131 / 141 / 2, 49 / 142 / 2, 7 / 143 / 5, 246 / 144 / 2, 132 / 145 / 2, 55 / 146 / 2, 187 / 147 / 2, 154 / 148 / 3, 107 / 149 / 2, 200 / 150 / 2, 100 / 151 / 3, 188 / 152 / 2, 63 / 153 / 3, 241 / 154 / 2, 243 / 155 / 2, 85 / 156 / 3, 205 / 157 / 2, 115 / 158 / 4, 165 / 159 / 2, 201 / 160 / 2, 231 / 161 / 3, 43 / 162 / 2, 158 / 163 / 3, 96 / 164 / 2, 197 / 165 / 2, 1 / 166 / 2, 146 / 167 / 2, 220 / 168 / 2, 248 / 169 / 3, 94 / 170 / 2, 209 / 171 / 2, 108 / 172 / 4, 242 / 173 / 2, 31 / 174 / 2, 183 / 175 / 4, 86 / 176 / 2, 228 / 177 / 2, 223 / 178 / 4, 6 / 179 / 2, 126 / 180 / 2, 106 / 181 / 2, 144 / 182 / 3, 172 / 183 / 2, 122 / 184 / 2, 103 / 185 / 2, 175 / 186 / 5, 59 / 187 / 2, 215 / 188 / 3, 65 / 189 / 2, 226 / 190 / 2, 142 / 191 / 4, 143 / 192 / 2, 22 / 193 / 2, 78 / 194 / 2, 125 / 195 / 4, 235 / 196 / 2, 225 / 197 / 2, 207 / 198 / 2, 71 / 199 / 3, 229 / 200 / 2, 203 / 201 / 3, 38 / 202 / 2, 198 / 203 / 3, 56 / 204 / 2, 168 / 205 / 2, 191 / 206 / 4, 204 / 207 / 2, 138 / 208 / 3, 118 / 209 / 2, 134 / 210 / 2, 222 / 211 / 3, 206 / 212 / 2, 133 / 213 / 2, 148 / 214 / 3, 90 / 215 / 2, 76 / 216 / 5, 162 / 217 / 2, 61 / 218 / 3, 145 / 219 / 2, 173 / 220 / 5, 51 / 221 / 2, 57 / 222 / 3, 196 / 223 / 2, 87 / 224 / 2, 69 / 225 / 2, 29 / 226 / 4, 169 / 227 / 2, 150 / 228 / 2, 232 / 229 / 2, 30 / 230 / 2, 153 / 231 / 3, 124 / 232 / 2, 10 / 233 / 3, 97 / 234 / 2, 139 / 235 / 3, 157 / 236 / 2, 151 / 237 / 3, 119 / 238 / 2, 79 / 239 / 2, 68 / 240 / 2, 62 / 241 / 2, 120 / 242 / 2, 2 / 243 / 3, 109 / 244 / 2, 212 / 245 / 2, 34 / 246 / 2, 160 / 247 / 5, 159 / 248 / 2, 135 / 249 / 2
doublecenter-alpha_1-3-n375.txt, 1, 1, 375, 3746.09, 2953, 2578, 7, 374,97 / 1 / 2, 371 / 2 / 4, 339 / 3 / 2, 167 / 4 / 2, 305 / 5 / 4, 2 / 6 / 2, 145 / 7 / 2, 211 / 8 / 3, 191 / 9 / 2, 358 / 10 / 3, 70 / 11 / 2, 360 / 12 / 2, 6 / 13 / 2, 9 / 14 / 2, 109 / 15 / 4, 215 / 16 / 2, 329 / 17 / 3, 106 / 18 / 2, 171 / 19 / 3, 47 / 20 / 2, 85 / 21 / 2, 238 / 22 / 3, 59 / 23 / 2, 213 / 24 / 2, 149 / 25 / 3, 345 / 26 / 2, 89 / 27 / 4, 226 / 28 / 2, 216 / 29 / 2, 131 / 30 / 2, 154 / 31 / 4, 278 / 32 / 2, 46 / 33 / 2, 150 / 34 / 2, 294 / 35 / 4, 332 / 36 / 2, 180 / 37 / 2, 157 / 38 / 2, 162 / 39 / 2, 31 / 40 / 4, 51 / 41 / 2, 303 / 42 / 2, 178 / 43 / 3, 207 / 44 / 2, 188 / 45 / 3, 275 / 46 / 2, 258 / 47 / 2, 34 / 48 / 2, 231 / 49 / 2, 331 / 50 / 2, 356 / 51 / 2, 217 / 52 / 3, 122 / 53 / 2, 84 / 54 / 2, 79 / 55 / 2, 99 / 56 / 2, 138 / 57 / 2, 205 / 58 / 2, 372 / 59 / 3, 176 / 60 / 2, 134 / 61 / 2, 21 / 62 / 5, 185 / 63 / 2, 227 / 64 / 2, 297 / 65 / 3, 344 / 66 / 2, 324 / 67 / 3, 95 / 68 / 2, 123 / 69 / 3, 281 / 70 / 2, 323 / 71 / 2, 365 / 72 / 2, 214 / 73 / 2, 361 / 74 / 3, 314 / 75 / 2, 256 / 76 / 3, 71 / 77 / 2, 224 / 78 / 2, 368 / 79 / 3, 335 / 80 / 2, 136 / 81 / 2, 272 / 82 / 3, 366 / 83 / 2, 184 / 84 / 3, 159 / 85 / 2, 135 / 86 / 2, 265 / 87 / 3, 206 / 88 / 2, 49 / 89 / 3, 158 / 90 / 2, 61 / 91 / 2, 169 / 92 / 5, 296 / 93 / 2, 80 / 94 / 3, 163 / 95 / 2, 8 / 96 / 5, 174 / 97 / 2, 321 / 98 / 2, 280 / 99 / 2, 257 / 100 / 5, 66 / 101 / 2, 44 / 102 / 2, 367 / 103 / 2, 369 / 104 / 2, 37 / 105 / 4, 190 / 106 / 2, 196 / 107 / 3, 186 / 108 / 2, 147 / 109 / 2, 337 / 110 / 4, 222 / 111 / 2, 354 / 112 / 2, 94 / 113 / 2, 187 / 114 / 2, 316 / 115 / 2, 35 / 116 / 2, 103 / 117 / 3, 350 / 118 / 2, 313 / 119 / 4, 175 / 120 / 2, 373 / 121 / 2, 244 / 122 / 4, 277 / 123 / 2, 325 / 124 / 2, 156 / 125 / 2, 346 / 126 / 2, 195 / 127 / 3, 69 / 128 / 2, 72 / 129 / 3, 13 / 130 / 2, 42 / 131 / 2, 102 / 132 / 2, 255 / 133 / 3, 242 / 134 / 2, 229 / 135 / 2, 111 / 136 / 4, 340 / 137 / 2, 338 / 138 / 2, 249 / 139 / 4, 353 / 140 / 2, 30 / 141 / 3, 292 / 142 / 2, 239 / 143 / 2, 183 / 144 / 3, 253 / 145 / 2, 304 / 146 / 3, 78 / 147 / 2, 348 / 148 / 2, 193 / 149 / 2, 168 / 150 / 4, 293 / 151 / 2, 309 / 152 / 3, 19 / 153 / 2, 237 / 154 / 2, 86 / 155 / 5, 57 / 156 / 2, 370 / 157 / 3, 318 / 158 / 2, 160 / 159 / 4, 336 / 160 / 2, 77 / 161 / 2, 260 / 162 / 2, 5 / 163 / 2, 43 / 164 / 3, 301 / 165 / 2, 153 / 166 / 3, 243 / 167 / 2, 210 / 168 / 2, 116 / 169 / 2, 322 / 170 / 5, 246 / 171 / 2, 352 / 172 / 2, 74 / 173 / 2, 15 / 174 / 3, 87 / 175 / 2, 25 / 176 / 2, 73 / 177 / 3, 289 / 178 / 2, 56 / 179 / 3, 290 / 180 / 2, 261 / 181 / 2, 28 / 182 / 3, 204 / 183 / 2, 132 / 184 / 3, 33 / 185 / 2, 100 / 186 / 2, 262 / 187 / 2, 96 / 188 / 2, 236 / 189 / 4, 130 / 190 / 2, 60 / 191 / 2, 220 / 192 / 2, 39 / 193 / 2, 17 / 194 / 3, 279 / 195 / 2, 11 / 196 / 2, 266 / 197 / 2, 129 / 198 / 4, 251 / 199 / 2, 267 / 200 / 2, 285 / 201 / 2, 82 / 202 / 3, 10 / 203 / 2, 18 / 204 / 3, 315 / 205 / 2, 75 / 206 / 2, 271 / 207 / 2, 284 / 208 / 7, 254 / 209 / 2, 181 / 210 / 2, 359 / 211 / 4, 148 / 212 / 2, 24 / 213 / 2, 311 / 214 / 2, 110 / 215 / 3, 179 / 216 / 2, 317 / 217 / 2, 27 / 218 / 2, 198 / 219 / 4, 355 / 220 / 2, 234 / 221 / 2, 172 / 222 / 2, 32 / 223 / 3, 1 / 224 / 2, 7 / 225 / 3, 327 / 226 / 2, 299 / 227 / 2, 273 / 228 / 5, 143 / 229 / 2, 347 / 230 / 2, 62 / 231 / 2, 48 / 232 / 2, 203 / 233 / 3, 334 / 234 / 2, 12 / 235 / 3, 29 / 236 / 2, 202 / 237 / 2, 264 / 238 / 3, 209 / 239 / 2, 58 / 240 / 2, 362 / 241 / 2, 137 / 242 / 3, 91 / 243 / 2, 306 / 244 / 3, 119 / 245 / 2, 182 / 246 / 2, 3 / 247 / 2, 221 / 248 / 2, 20 / 249 / 5, 363 / 250 / 2, 235 / 251 / 2, 326 / 252 / 3, 114 / 253 / 2, 23 / 254 / 3, 26 / 255 / 2, 76 / 256 / 2, 170 / 257 / 3, 126 / 258 / 2, 270 / 259 / 2, 200 / 260 / 3, 364 / 261 / 2, 36 / 262 / 2, 312 / 263 / 2, 263 / 264 / 3, 101 / 265 / 2, 118 / 266 / 3, 248 / 267 / 2, 342 / 268 / 3, 192 / 269 / 2, 107 / 270 / 2, 55 / 271 / 2, 45 / 272 / 2, 64 / 273 / 2, 140 / 274 / 2, 310 / 275 / 4, 166 / 276 / 2, 274 / 277 / 2, 16 / 278 / 3, 319 / 279 / 2, 88 / 280 / 2, 320 / 281 / 2, 52 / 282 / 2, 330 / 283 / 2, 374 / 284 / 3, 4 / 285 / 2, 117 / 286 / 4, 247 / 287 / 2, 240 / 288 / 2, 302 / 289 / 2, 233 / 290 / 4, 173 / 291 / 2, 53 / 292 / 2, 38 / 293 / 3, 282 / 294 / 2, 65 / 295 / 3, 112 / 296 / 2, 252 / 297 / 4, 201 / 298 / 2, 328 / 299 / 2, 120 / 300 / 2, 351 / 301 / 3, 139 / 302 / 2, 68 / 303 / 2, 127 / 304 / 2, 93 / 305 / 2, 54 / 306 / 3, 223 / 307 / 2, 92 / 308 / 3, 50 / 309 / 2, 128 / 310 / 2, 228 / 311 / 4, 113 / 312 / 2, 288 / 313 / 2, 164 / 314 / 3, 197 / 315 / 2, 141 / 316 / 2, 14 / 317 / 5, 259 / 318 / 2, 341 / 319 / 2, 98 / 320 / 2, 232 / 321 / 2, 300 / 322 / 2, 121 / 323 / 2, 241 / 324 / 2, 298 / 325 / 2, 349 / 326 / 3, 146 / 327 / 2, 225 / 328 / 2, 269 / 329 / 2, 357 / 330 / 2, 308 / 331 / 3, 219 / 332 / 2, 151 / 333 / 5, 283 / 334 / 2, 343 / 335 / 2, 194 / 336 / 2, 40 / 337 / 2, 144 / 338 / 2, 161 / 339 / 2, 287 / 340 / 2, 152 / 341 / 2, 104 / 342 / 3, 268 / 343 / 2, 67 / 344 / 2, 105 / 345 / 3, 81 / 346 / 2, 142 / 347 / 2, 286 / 348 / 2, 208 / 349 / 3, 83 / 350 / 2, 276 / 351 / 3, 63 / 352 / 2, 90 / 353 / 2, 41 / 354 / 4, 115 / 355 / 2, 124 / 356 / 2, 155 / 357 / 4, 199 / 358 / 2, 212 / 359 / 2, 133 / 360 / 2, 295 / 361 / 4, 189 / 362 / 2, 333 / 363 / 2, 230 / 364 / 3, 245 / 365 / 2, 22 / 366 / 2, 125 / 367 / 4, 307 / 368 / 2, 108 / 369 / 2, 250 / 370 / 3, 165 / 371 / 2, 218 / 372 / 2, 291 / 373 / 2, 177 / 374 / 5
doublecenter-alpha_1-3-n5.txt, 1, 1, 5, 570.096, 20, 15, 5, 4,4 / 1 / 5, 1 / 2 / 2, 2 / 3 / 2, 3 / 4 / 4
doublecenter-alpha_1-30-n7.txt, 1, 1, 7, 693.396, 34, 27, 5, 6,4 / 1 / 2, 1 / 2 / 2, 6 / 3 / 4, 2 / 4 / 2, 5 / 5 / 2, 3 / 6 / 5
doublecenter-alpha_1-31-n8.txt, 1, 1, 8, 671.781, 37, 29, 3, 7,5 / 1 / 3, 6 / 2 / 2, 3 / 3 / 2, 7 / 4 / 2, 2 / 5 / 3, 4 / 6 / 2, 1 / 7 / 2
doublecenter-alpha_1-32-n8.txt, 1, 1, 8, 635.889, 45, 37, 8, 7,4 / 1 / 3, 7 / 2 / 2, 2 / 3 / 4, 5 / 4 / 2, 3 / 5 / 2, 1 / 6 / 8, 6 / 7 / 2
doublecenter-alpha_1-33-n8.txt, 1, 1, 8, 608, 41, 33, 4, 7,4 / 1 / 2, 7 / 2 / 4, 6 / 3 / 2, 5 / 4 / 2, 1 / 5 / 3, 3 / 6 / 2, 2 / 7 / 3
doublecenter-alpha_1-34-n8.txt, 1, 1, 8, 942.362, 40, 32, 4, 7,7 / 1 / 3, 1 / 2 / 2, 4 / 3 / 4, 2 / 4 / 2, 6 / 5 / 2, 5 / 6 / 3, 3 / 7 / 2
doublecenter-alpha_1-35-n8.txt, 1, 1, 8, 616.589, 39, 31, 4, 7,5 / 1 / 2, 6 / 2 / 2, 3 / 3 / 3, 4 / 4 / 2, 2 / 5 / 2, 1 / 6 / 4, 7 / 7 / 2
doublecenter-alpha_1-36-n8.txt, 1, 1, 8, 749.87, 42, 34, 4, 7,1 / 1 / 4, 4 / 2 / 2, 5 / 3 / 2, 7 / 4 / 4, 3 / 5 / 2, 6 / 6 / 2, 2 / 7 / 3
doublecenter-alpha_1-37-n8.txt, 1, 1, 8, 503.667, 44, 36, 8, 7,1 / 1 / 2, 2 / 2 / 2, 5 / 3 / 4, 3 / 4 / 2, 7 / 5 / 2, 6 / 6 / 8, 4 / 7 / 2
doublecenter-alpha_1-38-n8.txt, 1, 1, 8, 754.847, 35, 27, 4, 7,7 / 1 / 2, 3 / 2 / 2, 2 / 3 / 2, 6 / 4 / 2, 1 / 5 / 2, 5 / 6 / 2, 4 / 7 / 4
doublecenter-alpha_1-39-n8.txt, 1, 1, 8, 792.636, 37, 29, 4, 7,1 / 1 / 4, 4 / 2 / 2, 2 / 3 / 2, 6 / 4 / 3, 7 / 5 / 2, 5 / 6 / 3, 3 / 7 / 2
doublecenter-alpha_1-4-n250.txt, 1, 1, 250, 2947.73, 1806, 1556, 6, 249,99 / 1 / 2, 18 / 2 / 2, 230 / 3 / 2, 63 / 4 / 2, 25 / 5 / 2, 106 / 6 / 2, 151 / 7 / 2, 192 / 8 / 3, 32 / 9 / 2, 160 / 10 / 2, 33 / 11 / 2, 211 / 12 / 2, 87 / 13 / 2, 112 / 14 / 4, 154 / 15 / 2, 202 / 16 / 3, 89 / 17 / 2, 34 / 18 / 2, 72 / 19 / 3, 221 / 20 / 2, 150 / 21 / 2, 163 / 22 / 2, 114 / 23 / 3, 73 / 24 / 2, 20 / 25 / 2, 88 / 26 / 3, 12 / 27 / 2, 243 / 28 / 2, 191 / 29 / 3, 9 / 30 / 2, 155 / 31 / 2, 235 / 32 / 2, 60 / 33 / 2, 40 / 34 / 2, 218 / 35 / 2, 201 / 36 / 3, 49 / 37 / 2, 204 / 38 / 3, 229 / 39 / 2, 166 / 40 / 2, 149 / 41 / 2, 210 / 42 / 2, 64 / 43 / 3, 24 / 44 / 2, 141 / 45 / 3, 104 / 46 / 2, 56 / 47 / 2, 157 / 48 / 2, 180 / 49 / 2, 92 / 50 / 2, 133 / 51 / 3, 185 / 52 / 2, 231 / 53 / 2, 152 / 54 / 3, 54 / 55 / 2, 28 / 56 / 2, 66 / 57 / 2, 183 / 58 / 3, 91 / 59 / 2, 118 / 60 / 3, 41 / 61 / 2, 111 / 62 / 2, 5 / 63 / 4, 16 / 64 / 2, 162 / 65 / 2, 170 / 66 / 2, 216 / 67 / 2, 35 / 68 / 3, 130 / 69 / 2, 226 / 70 / 2, 69 / 71 / 3, 214 / 72 / 2, 110 / 73 / 2, 1 / 74 / 2, 102 / 75 / 2, 86 / 76 / 4, 109 / 77 / 2, 140 / 78 / 2, 123 / 79 / 5, 57 / 80 / 2, 120 / 81 / 2, 44 / 82 / 2, 196 / 83 / 3, 245 / 84 / 2, 147 / 85 / 3, 8 / 86 / 2, 13 / 87 / 2, 124 / 88 / 2, 239 / 89 / 2, 125 / 90 / 3, 244 / 91 / 2, 22 / 92 / 2, 105 / 93 / 2, 137 / 94 / 2, 193 / 95 / 2, 59 / 96 / 2, 48 / 97 / 2, 52 / 98 / 2, 11 / 99 / 2, 171 / 100 / 3, 128 / 101 / 2, 76 / 102 / 2, 67 / 103 / 2, 4 / 104 / 6, 98 / 105 / 2, 23 / 106 / 2, 184 / 107 / 2, 194 / 108 / 2, 189 / 109 / 2, 195 / 110 / 2, 7 / 111 / 2, 79 / 112 / 2, 169 / 113 / 2, 55 / 114 / 3, 238 / 115 / 2, 165 / 116 / 2, 19 / 117 / 3, 100 / 118 / 2, 206 / 119 / 2, 131 / 120 / 2, 30 / 121 / 4, 233 / 122 / 2, 46 / 123 / 2, 36 / 124 / 2, 199 / 125 / 3, 227 / 126 / 2, 95 / 127 / 2, 115 / 128 / 3, 200 / 129 / 2, 51 / 130 / 2, 97 / 131 / 2, 96 / 132 / 3, 178 / 133 / 2, 45 / 134 / 2, 81 / 135 / 2, 80 / 136 / 3, 78 / 137 / 2, 77 / 138 / 2, 129 / 139 / 2, 93 / 140 / 3, 179 / 141 / 2, 47 / 142 / 2, 168 / 143 / 2, 182 / 144 / 4, 121 / 145 / 2, 208 / 146 / 2, 65 / 147 / 2, 117 / 148 / 2, 126 / 149 / 5, 159 / 150 / 2, 156 / 151 / 2, 225 / 152 / 2, 237 / 153 / 2, 135 / 154 / 5, 127 / 155 / 2, 70 / 156 / 2, 177 / 157 / 2, 220 / 158 / 2, 224 / 159 / 2, 167 / 160 / 3, 37 / 161 / 2, 62 / 162 / 3, 188 / 163 / 2, 6 / 164 / 3, 161 / 165 / 2, 84 / 166 / 3, 176 / 167 / 2, 172 / 168 / 3, 3 / 169 / 2, 181 / 170 / 2, 228 / 171 / 2, 146 / 172 / 2, 113 / 173 / 3, 213 / 174 / 2, 14 / 175 / 3, 236 / 176 / 2, 174 / 177 / 2, 61 / 178 / 3, 145 / 179 / 2, 21 / 180 / 4, 107 / 181 / 2, 26 / 182 / 2, 203 / 183 / 2, 2 / 184 / 4, 71 / 185 / 2, 101 / 186 / 2, 108 / 187 / 4, 234 / 188 / 2, 83 / 189 / 2, 139 / 190 / 2, 248 / 191 / 2, 207 / 192 / 2, 217 / 193 / 3, 68 / 194 / 2, 116 / 195 / 2, 119 / 196 / 2, 209 / 197 / 2, 247 / 198 / 2, 103 / 199 / 2, 249 / 200 / 4, 74 / 201 / 2, 215 / 202 / 2, 242 / 203 / 4, 29 / 204 / 2, 212 / 205 / 2, 186 / 206 / 2, 75 / 207 / 3, 82 / 208 / 2, 43 / 209 / 2, 142 / 210 / 2, 205 / 211 / 3, 132 / 212 / 2, 122 / 213 / 2, 94 / 214 / 2, 190 / 215 / 2, 50 / 216 / 3, 39 / 217 / 2, 198 / 218 / 2, 175 / 219 / 2, 173 / 220 / 2, 85 / 221 / 2, 223 / 222 / 2, 10 / 223 / 2, 144 / 224 / 3, 17 / 225 / 2, 136 / 226 / 2, 164 / 227 / 3, 158 / 228 / 2, 143 / 229 / 3, 148 / 230 / 2, 42 / 231 / 3, 222 / 232 / 2, 53 / 233 / 3, 197 / 234 / 2, 153 / 235 / 3, 31 / 236 / 2, 240 / 237 / 4, 38 / 238 / 2, 134 / 239 / 2, 90 / 240 / 3, 219 / 241 / 2, 27 / 242 / 2, 232 / 243 / 4, 241 / 244 / 2, 246 / 245 / 2, 58 / 246 / 2, 187 / 247 / 3, 138 / 248 / 2, 15 / 249 / 3
doublecenter-alpha_1-4-n375.txt, 1, 1, 375, 3920.21, 2876, 2501, 6, 374,277 / 1 / 2, 345 / 2 / 4, 7 / 3 / 2, 106 / 4 / 2, 26 / 5 / 3, 116 / 6 / 2, 121 / 7 / 3, 238 / 8 / 2, 305 / 9 / 2, 152 / 10 / 2, 157 / 11 / 2, 100 / 12 / 2, 232 / 13 / 2, 69 / 14 / 2, 233 / 15 / 2, 24 / 16 / 2, 200 / 17 / 6, 352 / 18 / 2, 208 / 19 / 2, 113 / 20 / 2, 37 / 21 / 2, 244 / 22 / 4, 314 / 23 / 2, 189 / 24 / 2, 321 / 25 / 2, 178 / 26 / 2, 140 / 27 / 2, 12 / 28 / 2, 151 / 29 / 2, 90 / 30 / 2, 258 / 31 / 2, 193 / 32 / 2, 255 / 33 / 3, 301 / 34 / 2, 187 / 35 / 5, 145 / 36 / 2, 112 / 37 / 2, 242 / 38 / 2, 70 / 39 / 3, 34 / 40 / 2, 173 / 41 / 2, 114 / 42 / 2, 240 / 43 / 2, 134 / 44 / 2, 267 / 45 / 2, 322 / 46 / 3, 188 / 47 / 2, 213 / 48 / 2, 241 / 49 / 2, 3 / 50 / 3, 42 / 51 / 2, 128 / 52 / 2, 344 / 53 / 2, 335 / 54 / 2, 259 / 55 / 2, 294 / 56 / 3, 49 / 57 / 2, 161 / 58 / 2, 219 / 59 / 4, 8 / 60 / 2, 50 / 61 / 2, 340 / 62 / 2, 83 / 63 / 4, 367 / 64 / 2, 326 / 65 / 2, 224 / 66 / 3, 11 / 67 / 2, 342 / 68 / 3, 82 / 69 / 2, 51 / 70 / 2, 307 / 71 / 4, 9 / 72 / 2, 324 / 73 / 2, 107 / 74 / 4, 296 / 75 / 2, 56 / 76 / 2, 225 / 77 / 2, 164 / 78 / 2, 103 / 79 / 4, 190 / 80 / 2, 97 / 81 / 2, 361 / 82 / 4, 264 / 83 / 2, 231 / 84 / 2, 312 / 85 / 2, 251 / 86 / 2, 160 / 87 / 2, 313 / 88 / 2, 72 / 89 / 2, 363 / 90 / 5, 95 / 91 / 2, 10 / 92 / 2, 215 / 93 / 3, 27 / 94 / 2, 212 / 95 / 3, 85 / 96 / 2, 254 / 97 / 3, 337 / 98 / 2, 263 / 99 / 2, 55 / 100 / 3, 211 / 101 / 2, 349 / 102 / 3, 287 / 103 / 2, 331 / 104 / 3, 88 / 105 / 2, 75 / 106 / 2, 306 / 107 / 3, 282 / 108 / 2, 316 / 109 / 2, 323 / 110 / 2, 358 / 111 / 2, 101 / 112 / 2, 309 / 113 / 2, 181 / 114 / 2, 199 / 115 / 2, 270 / 116 / 3, 336 / 117 / 2, 150 / 118 / 2, 354 / 119 / 3, 206 / 120 / 2, 29 / 121 / 3, 332 / 122 / 2, 25 / 123 / 3, 168 / 124 / 2, 31 / 125 / 2, 64 / 126 / 3, 230 / 127 / 2, 239 / 128 / 3, 203 / 129 / 2, 104 / 130 / 3, 275 / 131 / 2, 162 / 132 / 2, 61 / 133 / 2, 248 / 134 / 2, 18 / 135 / 3, 249 / 136 / 2, 148 / 137 / 2, 38 / 138 / 2, 122 / 139 / 4, 176 / 140 / 2, 175 / 141 / 3, 196 / 142 / 2, 86 / 143 / 3, 217 / 144 / 2, 142 / 145 / 2, 96 / 146 / 2, 91 / 147 / 2, 68 / 148 / 4, 341 / 149 / 2, 169 / 150 / 2, 20 / 151 / 2, 222 / 152 / 2, 57 / 153 / 2, 272 / 154 / 2, 79 / 155 / 3, 136 / 156 / 2, 48 / 157 / 2, 45 / 158 / 5, 308 / 159 / 2, 373 / 160 / 2, 60 / 161 / 2, 185 / 162 / 2, 278 / 163 / 2, 138 / 164 / 3, 16 / 165 / 2, 53 / 166 / 3, 44 / 167 / 2, 262 / 168 / 3, 166 / 169 / 2, 77 / 170 / 3, 171 / 171 / 2, 328 / 172 / 5, 283 / 173 / 2, 144 / 174 / 2, 237 / 175 / 2, 6 / 176 / 3, 320 / 177 / 2, 273 / 178 / 3, 32 / 179 / 2, 184 / 180 / 2, 194 / 181 / 2, 265 / 182 / 4, 293 / 183 / 2, 118 / 184 / 2, 204 / 185 / 2, 226 / 186 / 2, 286 / 187 / 3, 52 / 188 / 2, 329 / 189 / 2, 279 / 190 / 2, 92 / 191 / 2, 126 / 192 / 2, 292 / 193 / 4, 250 / 194 / 2, 66 / 195 / 2, 252 / 196 / 2, 356 / 197 / 3, 35 / 198 / 2, 303 / 199 / 2, 15 / 200 / 3, 80 / 201 / 2, 163 / 202 / 3, 266 / 203 / 2, 364 / 204 / 3, 327 / 205 / 2, 245 / 206 / 3, 191 / 207 / 2, 253 / 208 / 5, 274 / 209 / 2, 229 / 210 / 2, 40 / 211 / 3, 285 / 212 / 2, 338 / 213 / 3, 269 / 214 / 2, 311 / 215 / 3, 192 / 216 / 2, 348 / 217 / 3, 67 / 218 / 2, 374 / 219 / 3, 256 / 220 / 2, 65 / 221 / 2, 257 / 222 / 2, 284 / 223 / 2, 371 / 224 / 2, 334 / 225 / 3, 372 / 226 / 2, 210 / 227 / 2, 228 / 228 / 4, 346 / 229 / 2, 201 / 230 / 2, 177 / 231 / 2, 186 / 232 / 2, 111 / 233 / 3, 234 / 234 / 2, 33 / 235 / 5, 19 / 236 / 2, 350 / 237 / 2, 281 / 238 / 2, 260 / 239 / 4, 288 / 240 / 2, 290 / 241 / 2, 209 / 242 / 4, 13 / 243 / 2, 159 / 244 / 2, 179 / 245 / 2, 124 / 246 / 3, 180 / 247 / 2, 300 / 248 / 5, 291 / 249 / 2, 295 / 250 / 3, 172 / 251 / 2, 369 / 252 / 3, 365 / 253 / 2, 310 / 254 / 2, 165 / 255 / 2, 149 / 256 / 3, 261 / 257 / 2, 289 / 258 / 3, 183 / 259 / 2, 280 / 260 / 2, 276 / 261 / 2, 1 / 262 / 2, 174 / 263 / 2, 146 / 264 / 2, 59 / 265 / 3, 268 / 266 / 2, 355 / 267 / 3, 347 / 268 / 2, 43 / 269 / 3, 220 / 270 / 2, 120 / 271 / 2, 125 / 272 / 3, 84 / 273 / 2, 30 / 274 / 2, 115 / 275 / 2, 297 / 276 / 2, 110 / 277 / 2, 304 / 278 / 2, 119 / 279 / 2, 4 / 280 / 2, 17 / 281 / 3, 236 / 282 / 2, 158 / 283 / 2, 89 / 284 / 2, 351 / 285 / 3, 87 / 286 / 2, 360 / 287 / 2, 154 / 288 / 3, 54 / 289 / 2, 182 / 290 / 3, 207 / 291 / 2, 58 / 292 / 2, 330 / 293 / 3, 362 / 294 / 2, 93 / 295 / 2, 36 / 296 / 2, 197 / 297 / 2, 28 / 298 / 2, 129 / 299 / 2, 155 / 300 / 2, 315 / 301 / 3, 143 / 302 / 2, 137 / 303 / 2, 41 / 304 / 4, 73 / 305 / 2, 147 / 306 / 2, 135 / 307 / 3, 153 / 308 / 2, 62 / 309 / 3, 47 / 310 / 2, 299 / 311 / 2, 94 / 312 / 3, 23 / 313 / 2, 368 / 314 / 6, 216 / 315 / 2, 71 / 316 / 2, 170 / 317 / 3, 123 / 318 / 2, 298 / 319 / 3, 198 / 320 / 2, 21 / 321 / 3, 366 / 322 / 2, 205 / 323 / 2, 132 / 324 / 4, 319 / 325 / 2, 235 / 326 / 2, 141 / 327 / 2, 39 / 328 / 4, 117 / 329 / 2, 271 / 330 / 3, 133 / 331 / 2, 214 / 332 / 5, 131 / 333 / 2, 243 / 334 / 2, 5 / 335 / 2, 2 / 336 / 2, 63 / 337 / 2, 130 / 338 / 2, 98 / 339 / 2, 46 / 340 / 3, 74 / 341 / 2, 127 / 342 / 3, 221 / 343 / 2, 370 / 344 / 2, 139 / 345 / 3, 223 / 346 / 2, 99 / 347 / 2, 317 / 348 / 3, 156 / 349 / 2, 353 / 350 / 5, 339 / 351 / 2, 167 / 352 / 3, 227 / 353 / 2, 359 / 354 / 4, 202 / 355 / 2, 78 / 356 / 2, 357 / 357 / 5, 109 / 358 / 2, 22 / 359 / 3, 81 / 360 / 2, 246 / 361 / 2, 14 / 362 / 2, 333 / 363 / 2, 102 / 364 / 3, 247 / 365 / 2, 343 / 366 / 2, 325 / 367 / 2, 318 / 368 / 2, 195 / 369 / 2, 108 / 370 / 5, 218 / 371 / 2, 76 / 372 / 2, 302 / 373 / 2, 105 / 374 / 5
doublecenter-alpha_1-4-n5.txt, 1, 1, 5, 461.76, 18, 13, 5, 4,2 / 1 / 2, 4 / 2 / 5, 3 / 3 / 2, 1 / 4 / 2
doublecenter-alpha_1-40-n8.txt, 1, 1, 8, 633.222, 45, 37, 8, 7,1 / 1 / 3, 4 / 2 / 2, 6 / 3 / 2, 3 / 4 / 8, 2 / 5 / 2, 7 / 6 / 2, 5 / 7 / 4
doublecenter-alpha_1-41-n9.txt, 1, 1, 9, 832.906, 50, 41, 6, 8,5 / 1 / 3, 6 / 2 / 2, 3 / 3 / 6, 7 / 4 / 2, 4 / 5 / 2, 1 / 6 / 3, 2 / 7 / 2, 8 / 8 / 3
doublecenter-alpha_1-42-n9.txt, 1, 1, 9, 815.544, 52, 43, 6, 8,8 / 1 / 2, 5 / 2 / 2, 7 / 3 / 4, 1 / 4 / 2, 4 / 5 / 2, 3 / 6 / 6, 6 / 7 / 2, 2 / 8 / 2
doublecenter-alpha_1-43-n9.txt, 1, 1, 9, 631.901, 50, 41, 4, 8,6 / 1 / 3, 4 / 2 / 2, 3 / 3 / 2, 1 / 4 / 2, 5 / 5 / 4, 2 / 6 / 2, 8 / 7 / 2, 7 / 8 / 4
doublecenter-alpha_1-44-n9.txt, 1, 1, 9, 820.718, 53, 44, 6, 8,8 / 1 / 2, 4 / 2 / 6, 2 / 3 / 2, 1 / 4 / 3, 7 / 5 / 2, 6 / 6 / 2, 5 / 7 / 6, 3 / 8 / 2
doublecenter-alpha_1-45-n9.txt, 1, 1, 9, 566.44, 52, 43, 5, 8,4 / 1 / 5, 6 / 2 / 2, 3 / 3 / 2, 8 / 4 / 2, 1 / 5 / 2, 5 / 6 / 3, 7 / 7 / 2, 2 / 8 / 3
doublecenter-alpha_1-46-n9.txt, 1, 1, 9, 573.931, 47, 38, 5, 8,2 / 1 / 4, 3 / 2 / 2, 6 / 3 / 2, 1 / 4 / 3, 8 / 5 / 2, 4 / 6 / 5, 7 / 7 / 2, 5 / 8 / 2
doublecenter-alpha_1-47-n9.txt, 1, 1, 9, 776.837, 42, 33, 3, 8,4 / 1 / 3, 8 / 2 / 2, 3 / 3 / 2, 2 / 4 / 2, 1 / 5 / 2, 6 / 6 / 3, 7 / 7 / 2, 5 / 8 / 3
doublecenter-alpha_1-48-n9.txt, 1, 1, 9, 526.727, 53, 44, 6, 8,8 / 1 / 2, 1 / 2 / 6, 4 / 3 / 2, 7 / 4 / 2, 3 / 5 / 4, 2 / 6 / 2, 6 / 7 / 2, 5 / 8 / 4
doublecenter-alpha_1-49-n9.txt, 1, 1, 9, 501.537, 46, 37, 9, 8,3 / 1 / 2, 4 / 2 / 2, 1 / 3 / 2, 5 / 4 / 2, 6 / 5 / 3, 8 / 6 / 2, 2 / 7 / 2, 7 / 8 / 9
doublecenter-alpha_1-5-n250.txt, 1, 1, 250, 3406.77, 2082, 1832, 9, 249,7 / 1 / 3, 68 / 2 / 2, 231 / 3 / 3, 129 / 4 / 2, 87 / 5 / 3, 35 / 6 / 2, 111 / 7 / 2, 21 / 8 / 3, 103 / 9 / 2, 243 / 10 / 3, 207 / 11 / 2, 115 / 12 / 4, 108 / 13 / 2, 6 / 14 / 2, 137 / 15 / 3, 127 / 16 / 2, 204 / 17 / 2, 61 / 18 / 2, 82 / 19 / 6, 241 / 20 / 2, 117 / 21 / 2, 56 / 22 / 2, 66 / 23 / 3, 112 / 24 / 2, 176 / 25 / 2, 136 / 26 / 2, 165 / 27 / 3, 121 / 28 / 2, 49 / 29 / 2, 168 / 30 / 2, 55 / 31 / 3, 88 / 32 / 2, 97 / 33 / 2, 9 / 34 / 6, 1 / 35 / 2, 146 / 36 / 2, 104 / 37 / 2, 183 / 38 / 2, 8 / 39 / 6, 177 / 40 / 2, 95 / 41 / 2, 152 / 42 / 2, 84 / 43 / 4, 30 / 44 / 2, 38 / 45 / 2, 41 / 46 / 3, 13 / 47 / 2, 17 / 48 / 2, 54 / 49 / 2, 158 / 50 / 4, 118 / 51 / 2, 101 / 52 / 2, 222 / 53 / 2, 174 / 54 / 3, 224 / 55 / 2, 202 / 56 / 2, 98 / 57 / 2, 51 / 58 / 3, 203 / 59 / 2, 22 / 60 / 2, 44 / 61 / 2, 161 / 62 / 3, 181 / 63 / 2, 37 / 64 / 3, 208 / 65 / 2, 166 / 66 / 3, 32 / 67 / 2, 189 / 68 / 2, 155 / 69 / 2, 69 / 70 / 4, 148 / 71 / 2, 89 / 72 / 3, 90 / 73 / 2, 24 / 74 / 3, 15 / 75 / 2, 94 / 76 / 2, 93 / 77 / 2, 219 / 78 / 2, 188 / 79 / 2, 48 / 80 / 2, 59 / 81 / 2, 247 / 82 / 2, 141 / 83 / 3, 157 / 84 / 2, 92 / 85 / 2, 226 / 86 / 2, 164 / 87 / 4, 178 / 88 / 2, 74 / 89 / 2, 187 / 90 / 2, 143 / 91 / 5, 238 / 92 / 2, 4 / 93 / 2, 139 / 94 / 2, 71 / 95 / 3, 107 / 96 / 2, 86 / 97 / 3, 227 / 98 / 2, 119 / 99 / 2, 216 / 100 / 2, 151 / 101 / 3, 72 / 102 / 2, 172 / 103 / 2, 130 / 104 / 3, 120 / 105 / 2, 198 / 106 / 2, 77 / 107 / 4, 193 / 108 / 2, 153 / 109 / 2, 220 / 110 / 4, 3 / 111 / 2, 23 / 112 / 3, 27 / 113 / 2, 80 / 114 / 3, 124 / 115 / 2, 16 / 116 / 2, 167 / 117 / 3, 40 / 118 / 2, 150 / 119 / 2, 195 / 120 / 3, 225 / 121 / 2, 58 / 122 / 2, 128 / 123 / 2, 159 / 124 / 2, 105 / 125 / 2, 14 / 126 / 3, 192 / 127 / 2, 223 / 128 / 2, 42 / 129 / 4, 34 / 130 / 2, 96 / 131 / 2, 134 / 132 / 2, 234 / 133 / 4, 28 / 134 / 2, 133 / 135 / 3, 237 / 136 / 2, 123 / 137 / 2, 19 / 138 / 4, 156 / 139 / 2, 169 / 140 / 2, 215 / 141 / 6, 116 / 142 / 2, 200 / 143 / 3, 73 / 144 / 2, 33 / 145 / 2, 210 / 146 / 4, 230 / 147 / 2, 39 / 148 / 2, 109 / 149 / 4, 113 / 150 / 2, 102 / 151 / 2, 190 / 152 / 2, 186 / 153 / 2, 63 / 154 / 4, 162 / 155 / 2, 211 / 156 / 3, 126 / 157 / 2, 132 / 158 / 3, 46 / 159 / 2, 138 / 160 / 2, 175 / 161 / 3, 245 / 162 / 2, 122 / 163 / 3, 20 / 164 / 2, 196 / 165 / 2, 106 / 166 / 2, 229 / 167 / 3, 232 / 168 / 2, 209 / 169 / 2, 10 / 170 / 3, 173 / 171 / 2, 60 / 172 / 2, 197 / 173 / 3, 45 / 174 / 2, 239 / 175 / 2, 160 / 176 / 2, 52 / 177 / 2, 149 / 178 / 2, 11 / 179 / 5, 236 / 180 / 2, 191 / 181 / 2, 78 / 182 / 2, 114 / 183 / 3, 76 / 184 / 2, 53 / 185 / 2, 228 / 186 / 3, 201 / 187 / 2, 85 / 188 / 2, 199 / 189 / 2, 99 / 190 / 2, 64 / 191 / 2, 206 / 192 / 2, 249 / 193 / 2, 180 / 194 / 2, 144 / 195 / 2, 18 / 196 / 3, 43 / 197 / 2, 233 / 198 / 9, 235 / 199 / 2, 110 / 200 / 3, 12 / 201 / 2, 171 / 202 / 2, 81 / 203 / 2, 31 / 204 / 3, 57 / 205 / 2, 91 / 206 / 3, 154 / 207 / 2, 5 / 208 / 3, 36 / 209 / 2, 79 / 210 / 2, 62 / 211 / 2, 248 / 212 / 2, 242 / 213 / 3, 135 / 214 / 2, 75 / 215 / 2, 140 / 216 / 2, 185 / 217 / 3, 221 / 218 / 2, 246 / 219 / 4, 213 / 220 / 2, 25 / 221 / 3, 65 / 222 / 2, 214 / 223 / 2, 194 / 224 / 5, 163 / 225 / 2, 131 / 226 / 2, 244 / 227 / 2, 50 / 228 / 3, 125 / 229 / 2, 67 / 230 / 2, 212 / 231 / 3, 70 / 232 / 2, 184 / 233 / 2, 145 / 234 / 2, 2 / 235 / 5, 240 / 236 / 2, 147 / 237 / 3, 83 / 238 / 2, 205 / 239 / 2, 179 / 240 / 2, 218 / 241 / 3, 100 / 242 / 2, 182 / 243 / 3, 217 / 244 / 2, 142 / 245 / 3, 26 / 246 / 2, 170 / 247 / 2, 29 / 248 / 4, 47 / 249 / 2
doublecenter-alpha_1-5-n5.txt, 1, 1, 5, 578.79, 19, 14, 5, 4,4 / 1 / 2, 2 / 2 / 5, 1 / 3 / 2, 3 / 4 / 3
doublecenter-alpha_1-5-n500.txt, 1, 1, 500, 4305.34, 3916, 3416, 7, 499,99 / 1 / 3, 125 / 2 / 2, 229 / 3 / 2, 377 / 4 / 7, 351 / 5 / 2, 98 / 6 / 2, 11 / 7 / 2, 339 / 8 / 2, 400 / 9 / 3, 106 / 10 / 2, 225 / 11 / 3, 42 / 12 / 2, 458 / 13 / 2, 453 / 14 / 3, 342 / 15 / 2, 268 / 16 / 2, 222 / 17 / 4, 242 / 18 / 2, 110 / 19 / 2, 178 / 20 / 4, 173 / 21 / 2, 117 / 22 / 2, 33 / 23 / 4, 134 / 24 / 2, 78 / 25 / 2, 236 / 26 / 2, 18 / 27 / 2, 440 / 28 / 5, 34 / 29 / 2, 290 / 30 / 2, 59 / 31 / 2, 27 / 32 / 5, 238 / 33 / 2, 88 / 34 / 2, 115 / 35 / 3, 126 / 36 / 2, 420 / 37 / 4, 367 / 38 / 2, 208 / 39 / 2, 52 / 40 / 2, 306 / 41 / 2, 176 / 42 / 2, 363 / 43 / 5, 263 / 44 / 2, 41 / 45 / 2, 122 / 46 / 2, 466 / 47 / 4, 206 / 48 / 2, 184 / 49 / 3, 217 / 50 / 2, 148 / 51 / 3, 9 / 52 / 2, 12 / 53 / 2, 272 / 54 / 2, 107 / 55 / 5, 47 / 56 / 2, 260 / 57 / 2, 443 / 58 / 3, 159 / 59 / 2, 264 / 60 / 4, 221 / 61 / 2, 91 / 62 / 2, 215 / 63 / 4, 308 / 64 / 2, 16 / 65 / 2, 409 / 66 / 2, 201 / 67 / 2, 385 / 68 / 6, 43 / 69 / 2, 163 / 70 / 2, 429 / 71 / 2, 459 / 72 / 2, 168 / 73 / 2, 403 / 74 / 3, 267 / 75 / 2, 55 / 76 / 3, 482 / 77 / 2, 386 / 78 / 2, 96 / 79 / 2, 451 / 80 / 2, 39 / 81 / 4, 494 / 82 / 2, 119 / 83 / 2, 314 / 84 / 2, 70 / 85 / 3, 32 / 86 / 2, 362 / 87 / 2, 248 / 88 / 3, 448 / 89 / 2, 282 / 90 / 3, 353 / 91 / 2, 253 / 92 / 3, 446 / 93 / 2, 369 / 94 / 2, 4 / 95 / 2, 189 / 96 / 2, 307 / 97 / 4, 214 / 98 / 2, 155 / 99 / 2, 21 / 100 / 2, 390 / 101 / 4, 292 / 102 / 2, 71 / 103 / 2, 418 / 104 / 4, 360 / 105 / 2, 87 / 106 / 2, 179 / 107 / 2, 435 / 108 / 2, 397 / 109 / 3, 279 / 110 / 2, 394 / 111 / 3, 395 / 112 / 2, 48 / 113 / 2, 370 / 114 / 2, 284 / 115 / 4, 182 / 116 / 2, 245 / 117 / 2, 265 / 118 / 4, 304 / 119 / 2, 44 / 120 / 2, 416 / 121 / 2, 315 / 122 / 2, 447 / 123 / 2, 120 / 124 / 2, 36 / 125 / 2, 452 / 126 / 3, 283 / 127 / 2, 273 / 128 / 2, 266 / 129 / 2, 294 / 130 / 2, 22 / 131 / 2, 483 / 132 / 2, 495 / 133 / 2, 473 / 134 / 2, 135 / 135 / 2, 68 / 136 / 2, 127 / 137 / 2, 97 / 138 / 3, 249 / 139 / 2, 40 / 140 / 3, 320 / 141 / 2, 50 / 142 / 2, 237 / 143 / 3, 295 / 144 / 2, 398 / 145 / 2, 131 / 146 / 2, 357 / 147 / 2, 210 / 148 / 2, 289 / 149 / 3, 167 / 150 / 2, 216 / 151 / 2, 380 / 152 / 3, 424 / 153 / 2, 468 / 154 / 2, 296 / 155 / 2, 335 / 156 / 2, 327 / 157 / 2, 490 / 158 / 3, 333 / 159 / 2, 233 / 160 / 2, 422 / 161 / 2, 53 / 162 / 5, 161 / 163 / 2, 75 / 164 / 2, 73 / 165 / 3, 128 / 166 / 2, 427 / 167 / 2, 476 / 168 / 4, 129 / 169 / 2, 256 / 170 / 2, 324 / 171 / 4, 423 / 172 / 2, 84 / 173 / 2, 450 / 174 / 3, 243 / 175 / 2, 404 / 176 / 4, 408 / 177 / 2, 67 / 178 / 2, 417 / 179 / 3, 481 / 180 / 2, 169 / 181 / 2, 381 / 182 / 3, 220 / 183 / 2, 261 / 184 / 3, 124 / 185 / 2, 326 / 186 / 2, 111 / 187 / 2, 6 / 188 / 2, 444 / 189 / 2, 434 / 190 / 2, 325 / 191 / 4, 462 / 192 / 2, 280 / 193 / 2, 218 / 194 / 3, 56 / 195 / 2, 257 / 196 / 3, 162 / 197 / 2, 61 / 198 / 3, 497 / 199 / 2, 270 / 200 / 2, 486 / 201 / 2, 207 / 202 / 5, 411 / 203 / 2, 19 / 204 / 3, 392 / 205 / 2, 477 / 206 / 2, 428 / 207 / 3, 227 / 208 / 2, 355 / 209 / 2, 303 / 210 / 4, 193 / 211 / 2, 499 / 212 / 2, 371 / 213 / 2, 86 / 214 / 3, 177 / 215 / 2, 69 / 216 / 2, 376 / 217 / 6, 348 / 218 / 2, 205 / 219 / 2, 164 / 220 / 2, 49 / 221 / 2, 204 / 222 / 6, 100 / 223 / 2, 31 / 224 / 3, 244 / 225 / 2, 63 / 226 / 3, 64 / 227 / 2, 147 / 228 / 2, 421 / 229 / 2, 415 / 230 / 3, 1 / 231 / 2, 77 / 232 / 2, 37 / 233 / 5, 457 / 234 / 2, 382 / 235 / 2, 235 / 236 / 3, 219 / 237 / 2, 102 / 238 / 3, 485 / 239 / 2, 166 / 240 / 3, 109 / 241 / 2, 396 / 242 / 3, 496 / 243 / 2, 478 / 244 / 2, 461 / 245 / 2, 410 / 246 / 2, 142 / 247 / 2, 278 / 248 / 3, 383 / 249 / 2, 334 / 250 / 2, 291 / 251 / 2, 191 / 252 / 2, 332 / 253 / 2, 108 / 254 / 3, 373 / 255 / 2, 74 / 256 / 2, 175 / 257 / 2, 171 / 258 / 2, 318 / 259 / 2, 240 / 260 / 2, 343 / 261 / 4, 368 / 262 / 2, 152 / 263 / 2, 430 / 264 / 2, 388 / 265 / 3, 389 / 266 / 2, 25 / 267 / 2, 181 / 268 / 3, 165 / 269 / 2, 310 / 270 / 2, 372 / 271 / 2, 498 / 272 / 3, 57 / 273 / 2, 438 / 274 / 3, 464 / 275 / 2, 14 / 276 / 3, 30 / 277 / 2, 151 / 278 / 3, 85 / 279 / 2, 328 / 280 / 2, 330 / 281 / 3, 338 / 282 / 2, 138 / 283 / 3, 347 / 284 / 2, 133 / 285 / 3, 299 / 286 / 2, 344 / 287 / 2, 232 / 288 / 3, 38 / 289 / 2, 319 / 290 / 3, 212 / 291 / 2, 286 / 292 / 3, 281 / 293 / 2, 149 / 294 / 2, 341 / 295 / 3, 146 / 296 / 2, 407 / 297 / 4, 255 / 298 / 2, 405 / 299 / 2, 143 / 300 / 4, 140 / 301 / 2, 441 / 302 / 2, 250 / 303 / 3, 309 / 304 / 2, 209 / 305 / 2, 66 / 306 / 3, 195 / 307 / 2, 172 / 308 / 2, 302 / 309 / 2, 213 / 310 / 2, 197 / 311 / 5, 136 / 312 / 2, 79 / 313 / 2, 301 / 314 / 3, 82 / 315 / 2, 276 / 316 / 2, 414 / 317 / 3, 89 / 318 / 2, 491 / 319 / 2, 456 / 320 / 2, 65 / 321 / 2, 145 / 322 / 2, 112 / 323 / 2, 312 / 324 / 3, 194 / 325 / 2, 467 / 326 / 3, 141 / 327 / 2, 399 / 328 / 2, 387 / 329 / 2, 24 / 330 / 2, 101 / 331 / 4, 28 / 332 / 2, 17 / 333 / 2, 29 / 334 / 3, 132 / 335 / 2, 46 / 336 / 3, 300 / 337 / 2, 186 / 338 / 2, 150 / 339 / 3, 10 / 340 / 2, 361 / 341 / 2, 455 / 342 / 3, 230 / 343 / 2, 15 / 344 / 3, 470 / 345 / 2, 354 / 346 / 2, 13 / 347 / 3, 277 / 348 / 2, 51 / 349 / 3, 472 / 350 / 2, 200 / 351 / 3, 426 / 352 / 2, 469 / 353 / 3, 305 / 354 / 2, 488 / 355 / 2, 345 / 356 / 2, 105 / 357 / 4, 413 / 358 / 2, 139 / 359 / 2, 202 / 360 / 3, 287 / 361 / 2, 393 / 362 / 3, 160 / 363 / 2, 224 / 364 / 2, 275 / 365 / 2, 288 / 366 / 2, 274 / 367 / 2, 436 / 368 / 2, 35 / 369 / 2, 412 / 370 / 3, 185 / 371 / 2, 349 / 372 / 3, 402 / 373 / 2, 5 / 374 / 2, 378 / 375 / 3, 374 / 376 / 2, 474 / 377 / 2, 484 / 378 / 2, 20 / 379 / 3, 95 / 380 / 2, 331 / 381 / 3, 190 / 382 / 2, 239 / 383 / 3, 113 / 384 / 2, 83 / 385 / 3, 170 / 386 / 2, 246 / 387 / 2, 358 / 388 / 2, 379 / 389 / 4, 62 / 390 / 2, 406 / 391 / 2, 439 / 392 / 2, 93 / 393 / 2, 336 / 394 / 3, 81 / 395 / 2, 45 / 396 / 5, 54 / 397 / 2, 254 / 398 / 2, 157 / 399 / 2, 114 / 400 / 3, 350 / 401 / 2, 442 / 402 / 3, 271 / 403 / 2, 228 / 404 / 2, 329 / 405 / 4, 103 / 406 / 2, 321 / 407 / 2, 366 / 408 / 2, 433 / 409 / 5, 298 / 410 / 2, 241 / 411 / 2, 130 / 412 / 2, 3 / 413 / 2, 269 / 414 / 2, 2 / 415 / 3, 297 / 416 / 2, 259 / 417 / 3, 80 / 418 / 2, 471 / 419 / 3, 72 / 420 / 2, 154 / 421 / 7, 285 / 422 / 2, 7 / 423 / 2, 340 / 424 / 2, 454 / 425 / 2, 180 / 426 / 2, 192 / 427 / 2, 26 / 428 / 4, 323 / 429 / 2, 226 / 430 / 2, 252 / 431 / 3, 104 / 432 / 2, 198 / 433 / 2, 156 / 434 / 2, 153 / 435 / 5, 365 / 436 / 2, 58 / 437 / 2, 487 / 438 / 2, 174 / 439 / 2, 60 / 440 / 6, 251 / 441 / 2, 247 / 442 / 3, 121 / 443 / 2, 158 / 444 / 2, 313 / 445 / 2, 116 / 446 / 3, 137 / 447 / 2, 311 / 448 / 2, 437 / 449 / 3, 293 / 450 / 2, 479 / 451 / 2, 92 / 452 / 2, 123 / 453 / 2, 384 / 454 / 4, 258 / 455 / 2, 364 / 456 / 2, 493 / 457 / 3, 463 / 458 / 2, 445 / 459 / 2, 211 / 460 / 2, 460 / 461 / 2, 425 / 462 / 2, 8 / 463 / 2, 118 / 464 / 2, 465 / 465 / 2, 346 / 466 / 2, 419 / 467 / 2, 94 / 468 / 4, 231 / 469 / 2, 183 / 470 / 2, 23 / 471 / 3, 317 / 472 / 2, 337 / 473 / 6, 475 / 474 / 2, 322 / 475 / 2, 449 / 476 / 3, 431 / 477 / 2, 492 / 478 / 3, 391 / 479 / 2, 375 / 480 / 4, 90 / 481 / 2, 188 / 482 / 2, 199 / 483 / 2, 76 / 484 / 4, 316 / 485 / 2, 234 / 486 / 2, 356 / 487 / 2, 480 / 488 / 2, 196 / 489 / 2, 489 / 490 / 3, 223 / 491 / 2, 352 / 492 / 3, 203 / 493 / 2, 359 / 494 / 2, 187 / 495 / 2, 401 / 496 / 5, 144 / 497 / 2, 432 / 498 / 3, 262 / 499 / 2
doublecenter-alpha_1-50-n9.txt, 1, 1, 9, 603.274, 54, 45, 9, 8,4 / 1 / 3, 5 / 2 / 2, 8 / 3 / 9, 3 / 4 / 2, 2 / 5 / 2, 6 / 6 / 2, 7 / 7 / 2, 1 / 8 / 4
doublecenter-alpha_1-51-n10.txt, 1, 1, 10, 617.979, 62, 52, 4, 9,4 / 1 / 2, 9 / 2 / 2, 7 / 3 / 3, 8 / 4 / 2, 2 / 5 / 4, 6 / 6 / 2, 5 / 7 / 3, 3 / 8 / 2, 1 / 9 / 2
doublecenter-alpha_1-52-n10.txt, 1, 1, 10, 480.483, 55, 45, 6, 9,9 / 1 / 6, 8 / 2 / 2, 7 / 3 / 2, 5 / 4 / 3, 3 / 5 / 2, 2 / 6 / 3, 6 / 7 / 2, 1 / 8 / 3, 4 / 9 / 2
doublecenter-alpha_1-53-n10.txt, 1, 1, 10, 839.44, 55, 45, 6, 9,6 / 1 / 2, 4 / 2 / 6, 2 / 3 / 2, 5 / 4 / 2, 8 / 5 / 2, 9 / 6 / 2, 7 / 7 / 2, 1 / 8 / 2, 3 / 9 / 3
doublecenter-alpha_1-54-n10.txt, 1, 1, 10, 596.774, 58, 48, 7, 9,7 / 1 / 5, 2 / 2 / 2, 5 / 3 / 2, 4 / 4 / 2, 1 / 5 / 3, 9 / 6 / 2, 8 / 7 / 2, 3 / 8 / 2, 6 / 9 / 7
doublecenter-alpha_1-55-n10.txt, 1, 1, 10, 911.349, 66, 56, 10, 9,4 / 1 / 2, 1 / 2 / 6, 8 / 3 / 2, 7 / 4 / 2, 6 / 5 / 2, 9 / 6 / 2, 5 / 7 / 10, 3 / 8 / 2, 2 / 9 / 2
doublecenter-alpha_1-56-n10.txt, 1, 1, 10, 770.484, 60, 50, 10, 9,6 / 1 / 2, 2 / 2 / 10, 8 / 3 / 2, 7 / 4 / 2, 4 / 5 / 3, 1 / 6 / 2, 5 / 7 / 2, 3 / 8 / 2, 9 / 9 / 5
doublecenter-alpha_1-57-n10.txt, 1, 1, 10, 753.952, 58, 48, 5, 9,5 / 1 / 2, 2 / 2 / 2, 9 / 3 / 5, 6 / 4 / 2, 8 / 5 / 2, 4 / 6 / 4, 3 / 7 / 2, 7 / 8 / 2, 1 / 9 / 3
doublecenter-alpha_1-58-n10.txt, 1, 1, 10, 776.617, 56, 46, 4, 9,5 / 1 / 2, 1 / 2 / 2, 7 / 3 / 2, 9 / 4 / 2, 6 / 5 / 4, 4 / 6 / 2, 3 / 7 / 3, 8 / 8 / 2, 2 / 9 / 3
doublecenter-alpha_1-59-n10.txt, 1, 1, 10, 842.195, 46, 36, 4, 9,7 / 1 / 4, 8 / 2 / 2, 5 / 3 / 3, 6 / 4 / 2, 3 / 5 / 2, 4 / 6 / 2, 1 / 7 / 2, 9 / 8 / 2, 2 / 9 / 3
doublecenter-alpha_1-6-n250.txt, 1, 1, 250, 2799.04, 1885, 1635, 7, 249,18 / 1 / 2, 140 / 2 / 2, 157 / 3 / 2, 132 / 4 / 2, 19 / 5 / 3, 44 / 6 / 2, 58 / 7 / 2, 80 / 8 / 2, 234 / 9 / 2, 244 / 10 / 3, 240 / 11 / 2, 221 / 12 / 2, 219 / 13 / 2, 8 / 14 / 3, 104 / 15 / 2, 119 / 16 / 3, 85 / 17 / 2, 187 / 18 / 2, 124 / 19 / 2, 169 / 20 / 3, 117 / 21 / 2, 12 / 22 / 2, 94 / 23 / 2, 76 / 24 / 3, 177 / 25 / 2, 166 / 26 / 2, 205 / 27 / 4, 172 / 28 / 2, 53 / 29 / 3, 57 / 30 / 2, 217 / 31 / 2, 228 / 32 / 2, 184 / 33 / 2, 97 / 34 / 2, 61 / 35 / 4, 214 / 36 / 2, 110 / 37 / 2, 202 / 38 / 4, 182 / 39 / 2, 21 / 40 / 2, 88 / 41 / 2, 4 / 42 / 3, 15 / 43 / 2, 175 / 44 / 2, 101 / 45 / 3, 127 / 46 / 2, 86 / 47 / 2, 54 / 48 / 2, 115 / 49 / 5, 65 / 50 / 2, 161 / 51 / 2, 9 / 52 / 2, 91 / 53 / 2, 50 / 54 / 4, 72 / 55 / 2, 100 / 56 / 3, 20 / 57 / 2, 32 / 58 / 4, 116 / 59 / 2, 174 / 60 / 2, 31 / 61 / 2, 92 / 62 / 3, 62 / 63 / 2, 225 / 64 / 2, 1 / 65 / 2, 74 / 66 / 2, 82 / 67 / 2, 156 / 68 / 2, 89 / 69 / 4, 236 / 70 / 2, 206 / 71 / 2, 216 / 72 / 3, 144 / 73 / 2, 227 / 74 / 4, 83 / 75 / 2, 113 / 76 / 2, 14 / 77 / 2, 52 / 78 / 3, 118 / 79 / 2, 188 / 80 / 4, 39 / 81 / 2, 191 / 82 / 2, 201 / 83 / 4, 136 / 84 / 2, 67 / 85 / 2, 230 / 86 / 4, 154 / 87 / 2, 48 / 88 / 2, 141 / 89 / 2, 213 / 90 / 4, 208 / 91 / 2, 159 / 92 / 2, 49 / 93 / 2, 51 / 94 / 2, 149 / 95 / 3, 145 / 96 / 2, 47 / 97 / 2, 71 / 98 / 2, 131 / 99 / 2, 243 / 100 / 2, 247 / 101 / 2, 196 / 102 / 2, 204 / 103 / 2, 165 / 104 / 2, 11 / 105 / 3, 122 / 106 / 2, 108 / 107 / 2, 106 / 108 / 2, 138 / 109 / 2, 168 / 110 / 2, 181 / 111 / 2, 90 / 112 / 2, 33 / 113 / 2, 60 / 114 / 3, 171 / 115 / 2, 23 / 116 / 2, 173 / 117 / 2, 162 / 118 / 2, 231 / 119 / 2, 226 / 120 / 3, 68 / 121 / 2, 17 / 122 / 2, 147 / 123 / 2, 35 / 124 / 3, 10 / 125 / 2, 220 / 126 / 2, 5 / 127 / 2, 38 / 128 / 2, 36 / 129 / 2, 43 / 130 / 3, 133 / 131 / 2, 105 / 132 / 2, 151 / 133 / 2, 163 / 134 / 3, 198 / 135 / 2, 121 / 136 / 2, 167 / 137 / 7, 248 / 138 / 2, 232 / 139 / 2, 96 / 140 / 2, 93 / 141 / 3, 84 / 142 / 2, 176 / 143 / 2, 102 / 144 / 3, 130 / 145 / 2, 233 / 146 / 2, 24 / 147 / 2, 190 / 148 / 2, 239 / 149 / 2, 215 / 150 / 2, 77 / 151 / 3, 189 / 152 / 2, 170 / 153 / 2, 22 / 154 / 2, 125 / 155 / 3, 229 / 156 / 2, 2 / 157 / 2, 41 / 158 / 2, 224 / 159 / 2, 218 / 160 / 3, 152 / 161 / 2, 63 / 162 / 3, 246 / 163 / 2, 30 / 164 / 3, 245 / 165 / 2, 126 / 166 / 2, 99 / 167 / 2, 160 / 168 / 4, 42 / 169 / 2, 158 / 170 / 3, 27 / 171 / 2, 64 / 172 / 5, 210 / 173 / 2, 197 / 174 / 3, 3 / 175 / 2, 199 / 176 / 3, 235 / 177 / 2, 78 / 178 / 3, 155 / 179 / 2, 107 / 180 / 3, 183 / 181 / 2, 195 / 182 / 3, 212 / 183 / 2, 55 / 184 / 2, 237 / 185 / 4, 129 / 186 / 2, 26 / 187 / 2, 223 / 188 / 2, 98 / 189 / 2, 109 / 190 / 2, 28 / 191 / 2, 123 / 192 / 3, 70 / 193 / 2, 29 / 194 / 2, 192 / 195 / 3, 146 / 196 / 2, 25 / 197 / 3, 186 / 198 / 2, 59 / 199 / 2, 148 / 200 / 3, 211 / 201 / 2, 193 / 202 / 4, 179 / 203 / 2, 87 / 204 / 2, 7 / 205 / 4, 16 / 206 / 2, 6 / 207 / 2, 137 / 208 / 4, 139 / 209 / 2, 114 / 210 / 2, 164 / 211 / 3, 209 / 212 / 2, 222 / 213 / 2, 180 / 214 / 2, 241 / 215 / 2, 200 / 216 / 5, 185 / 217 / 2, 45 / 218 / 2, 103 / 219 / 2, 112 / 220 / 3, 40 / 221 / 2, 203 / 222 / 2, 13 / 223 / 3, 153 / 224 / 2, 142 / 225 / 2, 207 / 226 / 4, 46 / 227 / 2, 75 / 228 / 2, 34 / 229 / 3, 194 / 230 / 2, 128 / 231 / 2, 81 / 232 / 2, 135 / 233 / 2, 120 / 234 / 2, 66 / 235 / 2, 95 / 236 / 2, 111 / 237 / 2, 143 / 238 / 2, 69 / 239 / 5, 79 / 240 / 2, 238 / 241 / 3, 249 / 242 / 2, 37 / 243 / 4, 56 / 244 / 2, 242 / 245 / 3, 150 / 246 / 2, 178 / 247 / 3, 134 / 248 / 2, 73 / 249 / 2
doublecenter-alpha_1-6-n5.txt, 1, 1, 5, 459.872, 19, 14, 5, 4,1 / 1 / 3, 3 / 2 / 2, 4 / 3 / 5, 2 / 4 / 2
doublecenter-alpha_1-6-n500.txt, 1, 1, 500, 4008.75, 3887, 3387, 10, 499,271 / 1 / 2, 25 / 2 / 2, 440 / 3 / 2, 136 / 4 / 2, 192 / 5 / 2, 133 / 6 / 2, 412 / 7 / 3, 209 / 8 / 2, 191 / 9 / 2, 94 / 10 / 2, 10 / 11 / 3, 222 / 12 / 2, 51 / 13 / 2, 196 / 14 / 4, 396 / 15 / 2, 338 / 16 / 2, 176 / 17 / 4, 76 / 18 / 2, 488 / 19 / 2, 47 / 20 / 2, 34 / 21 / 2, 458 / 22 / 2, 499 / 23 / 2, 72 / 24 / 2, 26 / 25 / 3, 299 / 26 / 2, 53 / 27 / 2, 446 / 28 / 3, 186 / 29 / 2, 147 / 30 / 2, 274 / 31 / 3, 214 / 32 / 2, 225 / 33 / 2, 372 / 34 / 2, 244 / 35 / 3, 173 / 36 / 2, 144 / 37 / 2, 177 / 38 / 2, 472 / 39 / 2, 50 / 40 / 4, 316 / 41 / 2, 156 / 42 / 2, 451 / 43 / 4, 395 / 44 / 2, 23 / 45 / 2, 132 / 46 / 2, 210 / 47 / 3, 393 / 48 / 2, 207 / 49 / 2, 344 / 50 / 2, 357 / 51 / 4, 128 / 52 / 2, 14 / 53 / 2, 399 / 54 / 2, 319 / 55 / 3, 146 / 56 / 2, 148 / 57 / 2, 127 / 58 / 2, 12 / 59 / 2, 421 / 60 / 2, 295 / 61 / 6, 335 / 62 / 2, 336 / 63 / 2, 115 / 64 / 3, 24 / 65 / 2, 263 / 66 / 2, 313 / 67 / 2, 9 / 68 / 4, 416 / 69 / 2, 391 / 70 / 2, 15 / 71 / 2, 343 / 72 / 3, 437 / 73 / 2, 113 / 74 / 3, 37 / 75 / 2, 54 / 76 / 3, 300 / 77 / 2, 212 / 78 / 3, 230 / 79 / 2, 231 / 80 / 2, 215 / 81 / 3, 92 / 82 / 2, 381 / 83 / 3, 303 / 84 / 2, 112 / 85 / 2, 405 / 86 / 2, 288 / 87 / 2, 361 / 88 / 2, 193 / 89 / 2, 262 / 90 / 5, 419 / 91 / 2, 253 / 92 / 2, 464 / 93 / 2, 431 / 94 / 3, 22 / 95 / 2, 285 / 96 / 2, 142 / 97 / 3, 323 / 98 / 2, 140 / 99 / 3, 74 / 100 / 2, 184 / 101 / 2, 167 / 102 / 10, 371 / 103 / 2, 462 / 104 / 2, 415 / 105 / 2, 486 / 106 / 4, 321 / 107 / 2, 223 / 108 / 2, 106 / 109 / 2, 269 / 110 / 2, 189 / 111 / 2, 291 / 112 / 6, 241 / 113 / 2, 272 / 114 / 2, 143 / 115 / 3, 317 / 116 / 2, 429 / 117 / 2, 329 / 118 / 4, 217 / 119 / 2, 404 / 120 / 2, 277 / 121 / 3, 141 / 122 / 2, 477 / 123 / 2, 125 / 124 / 3, 227 / 125 / 2, 256 / 126 / 3, 318 / 127 / 2, 331 / 128 / 3, 88 / 129 / 2, 248 / 130 / 3, 347 / 131 / 2, 158 / 132 / 3, 91 / 133 / 2, 373 / 134 / 3, 118 / 135 / 2, 172 / 136 / 5, 400 / 137 / 2, 354 / 138 / 2, 444 / 139 / 2, 368 / 140 / 2, 235 / 141 / 2, 178 / 142 / 2, 328 / 143 / 2, 439 / 144 / 2, 374 / 145 / 2, 28 / 146 / 3, 42 / 147 / 2, 369 / 148 / 3, 195 / 149 / 2, 387 / 150 / 5, 107 / 151 / 2, 247 / 152 / 2, 89 / 153 / 2, 481 / 154 / 2, 490 / 155 / 3, 111 / 156 / 2, 275 / 157 / 3, 64 / 158 / 2, 103 / 159 / 3, 445 / 160 / 2, 280 / 161 / 3, 409 / 162 / 2, 348 / 163 / 3, 266 / 164 / 2, 497 / 165 / 2, 152 / 166 / 4, 251 / 167 / 2, 406 / 168 / 2, 383 / 169 / 2, 83 / 170 / 4, 480 / 171 / 2, 350 / 172 / 2, 311 / 173 / 2, 8 / 174 / 2, 99 / 175 / 2, 102 / 176 / 2, 185 / 177 / 2, 163 / 178 / 2, 413 / 179 / 3, 93 / 180 / 2, 129 / 181 / 2, 154 / 182 / 2, 308 / 183 / 3, 382 / 184 / 2, 305 / 185 / 2, 44 / 186 / 3, 367 / 187 / 2, 388 / 188 / 3, 454 / 189 / 2, 96 / 190 / 2, 194 / 191 / 3, 376 / 192 / 2, 408 / 193 / 2, 137 / 194 / 2, 87 / 195 / 2, 257 / 196 / 3, 90 / 197 / 2, 62 / 198 / 3, 2 / 199 / 2, 276 / 200 / 3, 153 / 201 / 2, 52 / 202 / 2, 460 / 203 / 3, 443 / 204 / 2, 197 / 205 / 2, 243 / 206 / 3, 198 / 207 / 2, 478 / 208 / 3, 327 / 209 / 2, 150 / 210 / 2, 471 / 211 / 2, 205 / 212 / 5, 449 / 213 / 2, 98 / 214 / 3, 86 / 215 / 2, 485 / 216 / 3, 1 / 217 / 2, 292 / 218 / 2, 339 / 219 / 2, 394 / 220 / 4, 179 / 221 / 2, 130 / 222 / 2, 171 / 223 / 3, 270 / 224 / 2, 297 / 225 / 2, 168 / 226 / 2, 422 / 227 / 2, 320 / 228 / 2, 68 / 229 / 3, 273 / 230 / 2, 49 / 231 / 2, 470 / 232 / 2, 16 / 233 / 3, 84 / 234 / 2, 246 / 235 / 4, 424 / 236 / 2, 491 / 237 / 2, 240 / 238 / 3, 121 / 239 / 2, 360 / 240 / 3, 124 / 241 / 2, 40 / 242 / 3, 218 / 243 / 2, 31 / 244 / 3, 204 / 245 / 2, 430 / 246 / 3, 438 / 247 / 2, 333 / 248 / 3, 261 / 249 / 2, 289 / 250 / 2, 57 / 251 / 4, 234 / 252 / 2, 122 / 253 / 2, 402 / 254 / 4, 131 / 255 / 2, 108 / 256 / 2, 174 / 257 / 4, 340 / 258 / 2, 287 / 259 / 2, 380 / 260 / 2, 258 / 261 / 3, 135 / 262 / 2, 410 / 263 / 2, 301 / 264 / 2, 220 / 265 / 2, 43 / 266 / 3, 245 / 267 / 2, 67 / 268 / 2, 496 / 269 / 2, 332 / 270 / 2, 492 / 271 / 2, 448 / 272 / 3, 48 / 273 / 2, 378 / 274 / 3, 483 / 275 / 2, 151 / 276 / 4, 484 / 277 / 2, 20 / 278 / 2, 33 / 279 / 2, 465 / 280 / 2, 211 / 281 / 2, 56 / 282 / 2, 265 / 283 / 2, 123 / 284 / 3, 370 / 285 / 2, 206 / 286 / 2, 27 / 287 / 3, 403 / 288 / 2, 365 / 289 / 2, 138 / 290 / 3, 359 / 291 / 2, 337 / 292 / 3, 417 / 293 / 2, 453 / 294 / 3, 175 / 295 / 2, 134 / 296 / 3, 85 / 297 / 2, 304 / 298 / 4, 162 / 299 / 2, 390 / 300 / 2, 302 / 301 / 2, 182 / 302 / 4, 71 / 303 / 2, 487 / 304 / 2, 314 / 305 / 4, 117 / 306 / 2, 296 / 307 / 2, 160 / 308 / 2, 161 / 309 / 2, 447 / 310 / 2, 494 / 311 / 2, 164 / 312 / 2, 324 / 313 / 3, 351 / 314 / 2, 21 / 315 / 3, 459 / 316 / 2, 455 / 317 / 4, 268 / 318 / 2, 65 / 319 / 2, 221 / 320 / 2, 126 / 321 / 2, 114 / 322 / 2, 312 / 323 / 2, 322 / 324 / 2, 81 / 325 / 4, 385 / 326 / 2, 468 / 327 / 2, 202 / 328 / 2, 389 / 329 / 3, 149 / 330 / 2, 310 / 331 / 4, 250 / 332 / 2, 32 / 333 / 2, 69 / 334 / 3, 249 / 335 / 2, 407 / 336 / 2, 434 / 337 / 2, 45 / 338 / 2, 278 / 339 / 2, 473 / 340 / 2, 255 / 341 / 2, 342 / 342 / 3, 482 / 343 / 2, 476 / 344 / 2, 3 / 345 / 2, 110 / 346 / 2, 341 / 347 / 2, 442 / 348 / 4, 309 / 349 / 2, 461 / 350 / 2, 41 / 351 / 4, 366 / 352 / 2, 392 / 353 / 2, 180 / 354 / 2, 236 / 355 / 3, 450 / 356 / 2, 208 / 357 / 3, 426 / 358 / 2, 36 / 359 / 2, 232 / 360 / 2, 224 / 361 / 3, 66 / 362 / 2, 411 / 363 / 2, 139 / 364 / 2, 5 / 365 / 4, 13 / 366 / 2, 70 / 367 / 2, 441 / 368 / 4, 294 / 369 / 2, 199 / 370 / 2, 279 / 371 / 2, 4 / 372 / 2, 78 / 373 / 4, 109 / 374 / 2, 330 / 375 / 2, 281 / 376 / 2, 353 / 377 / 2, 334 / 378 / 2, 35 / 379 / 3, 157 / 380 / 2, 493 / 381 / 5, 475 / 382 / 2, 362 / 383 / 3, 290 / 384 / 2, 97 / 385 / 4, 119 / 386 / 2, 423 / 387 / 2, 433 / 388 / 2, 495 / 389 / 2, 213 / 390 / 2, 187 / 391 / 6, 116 / 392 / 2, 456 / 393 / 2, 155 / 394 / 3, 307 / 395 / 2, 386 / 396 / 2, 356 / 397 / 3, 165 / 398 / 2, 384 / 399 / 2, 377 / 400 / 2, 436 / 401 / 2, 219 / 402 / 2, 77 / 403 / 2, 467 / 404 / 2, 145 / 405 / 3, 435 / 406 / 2, 229 / 407 / 2, 201 / 408 / 2, 427 / 409 / 3, 398 / 410 / 2, 414 / 411 / 2, 237 / 412 / 3, 95 / 413 / 2, 59 / 414 / 2, 352 / 415 / 2, 401 / 416 / 3, 264 / 417 / 2, 286 / 418 / 2, 30 / 419 / 2, 363 / 420 / 5, 457 / 421 / 2, 364 / 422 / 2, 101 / 423 / 2, 61 / 424 / 2, 283 / 425 / 2, 200 / 426 / 2, 38 / 427 / 2, 82 / 428 / 3, 326 / 429 / 2, 120 / 430 / 2, 466 / 431 / 2, 18 / 432 / 3, 75 / 433 / 2, 60 / 434 / 2, 79 / 435 / 3, 315 / 436 / 2, 346 / 437 / 2, 233 / 438 / 3, 284 / 439 / 2, 239 / 440 / 2, 188 / 441 / 2, 474 / 442 / 2, 7 / 443 / 2, 104 / 444 / 2, 73 / 445 / 3, 226 / 446 / 2, 418 / 447 / 2, 306 / 448 / 2, 425 / 449 / 2, 100 / 450 / 4, 375 / 451 / 2, 169 / 452 / 2, 479 / 453 / 3, 238 / 454 / 2, 58 / 455 / 2, 11 / 456 / 3, 55 / 457 / 2, 6 / 458 / 2, 397 / 459 / 2, 379 / 460 / 4, 428 / 461 / 2, 181 / 462 / 2, 259 / 463 / 2, 17 / 464 / 2, 228 / 465 / 4, 80 / 466 / 2, 267 / 467 / 2, 46 / 468 / 3, 183 / 469 / 2, 282 / 470 / 2, 358 / 471 / 3, 298 / 472 / 2, 170 / 473 / 3, 105 / 474 / 2, 452 / 475 / 3, 355 / 476 / 2, 39 / 477 / 4, 63 / 478 / 2, 159 / 479 / 2, 166 / 480 / 2, 254 / 481 / 2, 432 / 482 / 3, 29 / 483 / 2, 498 / 484 / 2, 252 / 485 / 2, 349 / 486 / 2, 216 / 487 / 2, 345 / 488 / 2, 489 / 489 / 2, 260 / 490 / 4, 325 / 491 / 2, 420 / 492 / 2, 293 / 493 / 2, 19 / 494 / 2, 203 / 495 / 3, 463 / 496 / 2, 190 / 497 / 3, 469 / 498 / 2, 242 / 499 / 3
doublecenter-alpha_1-60-n10.txt, 1, 1, 10, 874.85, 53, 43, 5, 9,7 / 1 / 5, 5 / 2 / 2, 4 / 3 / 2, 6 / 4 / 2, 1 / 5 / 2, 9 / 6 / 2, 3 / 7 / 3, 2 / 8 / 2, 8 / 9 / 3
doublecenter-alpha_1-61-n20.txt, 1, 1, 20, 894.912, 162, 142, 6, 19,17 / 1 / 3, 15 / 2 / 2, 2 / 3 / 6, 10 / 4 / 2, 19 / 5 / 2, 8 / 6 / 2, 13 / 7 / 3, 12 / 8 / 2, 11 / 9 / 2, 9 / 10 / 5, 3 / 11 / 2, 5 / 12 / 3, 16 / 13 / 2, 4 / 14 / 4, 6 / 15 / 2, 7 / 16 / 3, 1 / 17 / 2, 18 / 18 / 2, 14 / 19 / 4
doublecenter-alpha_1-62-n20.txt, 1, 1, 20, 844.106, 178, 158, 7, 19,19 / 1 / 2, 2 / 2 / 2, 9 / 3 / 2, 3 / 4 / 2, 14 / 5 / 2, 11 / 6 / 2, 6 / 7 / 2, 16 / 8 / 2, 1 / 9 / 7, 12 / 10 / 2, 13 / 11 / 2, 8 / 12 / 2, 17 / 13 / 2, 18 / 14 / 2, 4 / 15 / 7, 7 / 16 / 2, 10 / 17 / 2, 5 / 18 / 2, 15 / 19 / 5
doublecenter-alpha_1-63-n20.txt, 1, 1, 20, 1070.2, 145, 125, 7, 19,4 / 1 / 2, 17 / 2 / 7, 14 / 3 / 2, 3 / 4 / 2, 7 / 5 / 2, 1 / 6 / 3, 19 / 7 / 2, 12 / 8 / 6, 16 / 9 / 2, 5 / 10 / 3, 2 / 11 / 2, 9 / 12 / 2, 8 / 13 / 2, 6 / 14 / 2, 18 / 15 / 2, 10 / 16 / 2, 11 / 17 / 2, 13 / 18 / 5, 15 / 19 / 2
doublecenter-alpha_1-64-n20.txt, 1, 1, 20, 1142.86, 132, 112, 6, 19,1 / 1 / 2, 18 / 2 / 6, 8 / 3 / 2, 5 / 4 / 2, 6 / 5 / 3, 10 / 6 / 2, 7 / 7 / 2, 9 / 8 / 3, 19 / 9 / 2, 17 / 10 / 3, 3 / 11 / 2, 2 / 12 / 2, 16 / 13 / 2, 13 / 14 / 2, 4 / 15 / 2, 12 / 16 / 2, 15 / 17 / 4, 11 / 18 / 2, 14 / 19 / 3
doublecenter-alpha_1-65-n20.txt, 1, 1, 20, 810.562, 112, 92, 5, 19,3 / 1 / 2, 9 / 2 / 3, 5 / 3 / 2, 19 / 4 / 3, 8 / 5 / 2, 1 / 6 / 2, 12 / 7 / 3, 4 / 8 / 2, 16 / 9 / 2, 6 / 10 / 2, 14 / 11 / 2, 15 / 12 / 2, 2 / 13 / 2, 13 / 14 / 3, 10 / 15 / 2, 18 / 16 / 3, 17 / 17 / 2, 7 / 18 / 2, 11 / 19 / 5
doublecenter-alpha_1-66-n20.txt, 1, 1, 20, 756.625, 162, 142, 5, 19,12 / 1 / 2, 10 / 2 / 2, 16 / 3 / 4, 9 / 4 / 2, 17 / 5 / 2, 7 / 6 / 4, 4 / 7 / 2, 5 / 8 / 3, 14 / 9 / 2, 13 / 10 / 2, 15 / 11 / 2, 2 / 12 / 5, 8 / 13 / 2, 6 / 14 / 3, 18 / 15 / 2, 11 / 16 / 3, 19 / 17 / 2, 3 / 18 / 2, 1 / 19 / 3
doublecenter-alpha_1-67-n20.txt, 1, 1, 20, 814.52, 144, 124, 6, 19,18 / 1 / 3, 7 / 2 / 2, 12 / 3 / 2, 9 / 4 / 2, 1 / 5 / 2, 3 / 6 / 3, 13 / 7 / 2, 19 / 8 / 2, 16 / 9 / 4, 5 / 10 / 2, 15 / 11 / 2, 10 / 12 / 2, 8 / 13 / 2, 11 / 14 / 3, 14 / 15 / 2, 17 / 16 / 6, 2 / 17 / 2, 6 / 18 / 2, 4 / 19 / 2
doublecenter-alpha_1-68-n20.txt, 1, 1, 20, 777.888, 135, 115, 6, 19,17 / 1 / 6, 2 / 2 / 2, 16 / 3 / 2, 14 / 4 / 3, 4 / 5 / 2, 10 / 6 / 2, 9 / 7 / 2, 11 / 8 / 2, 15 / 9 / 2, 18 / 10 / 4, 19 / 11 / 2, 1 / 12 / 2, 5 / 13 / 2, 3 / 14 / 2, 7 / 15 / 4, 6 / 16 / 2, 8 / 17 / 2, 12 / 18 / 3, 13 / 19 / 2
doublecenter-alpha_1-69-n20.txt, 1, 1, 20, 788.595, 121, 101, 3, 19,3 / 1 / 3, 4 / 2 / 2, 15 / 3 / 2, 17 / 4 / 2, 2 / 5 / 2, 19 / 6 / 3, 16 / 7 / 2, 9 / 8 / 3, 5 / 9 / 2, 11 / 10 / 2, 13 / 11 / 3, 12 / 12 / 2, 8 / 13 / 2, 1 / 14 / 3, 18 / 15 / 2, 14 / 16 / 3, 7 / 17 / 2, 6 / 18 / 2, 10 / 19 / 3
doublecenter-alpha_1-7-n250.txt, 1, 1, 250, 2887.81, 2099, 1849, 10, 249,108 / 1 / 5, 183 / 2 / 2, 112 / 3 / 2, 220 / 4 / 2, 208 / 5 / 2, 9 / 6 / 2, 185 / 7 / 2, 200 / 8 / 2, 84 / 9 / 2, 1 / 10 / 5, 177 / 11 / 2, 222 / 12 / 2, 135 / 13 / 3, 21 / 14 / 2, 143 / 15 / 4, 13 / 16 / 2, 125 / 17 / 2, 105 / 18 / 4, 79 / 19 / 2, 35 / 20 / 2, 91 / 21 / 4, 172 / 22 / 2, 44 / 23 / 2, 63 / 24 / 3, 47 / 25 / 2, 49 / 26 / 2, 39 / 27 / 2, 60 / 28 / 3, 32 / 29 / 2, 43 / 30 / 2, 187 / 31 / 3, 169 / 32 / 2, 224 / 33 / 2, 205 / 34 / 3, 58 / 35 / 2, 12 / 36 / 4, 203 / 37 / 2, 221 / 38 / 2, 24 / 39 / 2, 149 / 40 / 3, 20 / 41 / 2, 40 / 42 / 3, 86 / 43 / 2, 146 / 44 / 2, 107 / 45 / 3, 23 / 46 / 2, 11 / 47 / 3, 152 / 48 / 2, 110 / 49 / 2, 101 / 50 / 3, 171 / 51 / 2, 204 / 52 / 3, 199 / 53 / 2, 217 / 54 / 2, 66 / 55 / 2, 133 / 56 / 2, 236 / 57 / 2, 151 / 58 / 2, 174 / 59 / 2, 213 / 60 / 4, 128 / 61 / 2, 233 / 62 / 3, 102 / 63 / 2, 178 / 64 / 2, 114 / 65 / 4, 18 / 66 / 2, 119 / 67 / 3, 104 / 68 / 2, 227 / 69 / 2, 70 / 70 / 4, 81 / 71 / 2, 57 / 72 / 2, 153 / 73 / 4, 145 / 74 / 2, 14 / 75 / 2, 138 / 76 / 3, 37 / 77 / 2, 235 / 78 / 2, 184 / 79 / 2, 28 / 80 / 2, 150 / 81 / 2, 94 / 82 / 2, 168 / 83 / 3, 50 / 84 / 2, 45 / 85 / 3, 179 / 86 / 2, 124 / 87 / 2, 122 / 88 / 2, 160 / 89 / 2, 41 / 90 / 3, 73 / 91 / 2, 82 / 92 / 2, 118 / 93 / 3, 27 / 94 / 2, 144 / 95 / 3, 209 / 96 / 2, 95 / 97 / 2, 142 / 98 / 2, 115 / 99 / 4, 121 / 100 / 2, 59 / 101 / 2, 195 / 102 / 2, 42 / 103 / 3, 67 / 104 / 2, 93 / 105 / 2, 15 / 106 / 2, 230 / 107 / 3, 158 / 108 / 2, 237 / 109 / 3, 80 / 110 / 2, 111 / 111 / 3, 157 / 112 / 2, 247 / 113 / 3, 206 / 114 / 2, 54 / 115 / 3, 175 / 116 / 2, 215 / 117 / 2, 244 / 118 / 4, 167 / 119 / 2, 4 / 120 / 2, 131 / 121 / 4, 196 / 122 / 2, 189 / 123 / 2, 192 / 124 / 3, 202 / 125 / 2, 61 / 126 / 3, 6 / 127 / 2, 25 / 128 / 2, 75 / 129 / 4, 83 / 130 / 2, 191 / 131 / 2, 31 / 132 / 2, 214 / 133 / 3, 62 / 134 / 2, 19 / 135 / 2, 64 / 136 / 2, 130 / 137 / 2, 87 / 138 / 2, 166 / 139 / 2, 156 / 140 / 3, 90 / 141 / 2, 231 / 142 / 3, 176 / 143 / 2, 36 / 144 / 3, 2 / 145 / 2, 242 / 146 / 3, 139 / 147 / 2, 229 / 148 / 2, 193 / 149 / 5, 55 / 150 / 2, 22 / 151 / 2, 216 / 152 / 2, 120 / 153 / 2, 8 / 154 / 2, 69 / 155 / 2, 136 / 156 / 2, 71 / 157 / 4, 29 / 158 / 2, 140 / 159 / 2, 113 / 160 / 3, 210 / 161 / 2, 141 / 162 / 2, 92 / 163 / 2, 239 / 164 / 3, 245 / 165 / 2, 100 / 166 / 2, 117 / 167 / 2, 33 / 168 / 2, 240 / 169 / 2, 34 / 170 / 3, 181 / 171 / 2, 186 / 172 / 3, 30 / 173 / 2, 7 / 174 / 8, 56 / 175 / 2, 46 / 176 / 2, 109 / 177 / 2, 97 / 178 / 3, 219 / 179 / 2, 226 / 180 / 2, 161 / 181 / 2, 218 / 182 / 3, 165 / 183 / 2, 249 / 184 / 2, 88 / 185 / 2, 72 / 186 / 5, 48 / 187 / 2, 173 / 188 / 3, 234 / 189 / 2, 188 / 190 / 3, 228 / 191 / 2, 225 / 192 / 3, 106 / 193 / 2, 129 / 194 / 2, 182 / 195 / 4, 127 / 196 / 2, 10 / 197 / 2, 164 / 198 / 2, 163 / 199 / 2, 5 / 200 / 3, 180 / 201 / 2, 148 / 202 / 2, 68 / 203 / 2, 77 / 204 / 10, 76 / 205 / 2, 170 / 206 / 2, 246 / 207 / 2, 116 / 208 / 2, 190 / 209 / 3, 194 / 210 / 2, 154 / 211 / 2, 98 / 212 / 4, 3 / 213 / 2, 126 / 214 / 2, 207 / 215 / 2, 223 / 216 / 2, 162 / 217 / 2, 96 / 218 / 2, 132 / 219 / 7, 232 / 220 / 2, 238 / 221 / 2, 65 / 222 / 4, 147 / 223 / 2, 241 / 224 / 2, 17 / 225 / 2, 201 / 226 / 3, 248 / 227 / 2, 99 / 228 / 3, 134 / 229 / 2, 137 / 230 / 6, 89 / 231 / 2, 103 / 232 / 2, 51 / 233 / 4, 85 / 234 / 2, 197 / 235 / 2, 74 / 236 / 2, 155 / 237 / 3, 53 / 238 / 2, 198 / 239 / 2, 52 / 240 / 2, 211 / 241 / 3, 26 / 242 / 2, 38 / 243 / 3, 16 / 244 / 2, 243 / 245 / 2, 78 / 246 / 3, 212 / 247 / 2, 123 / 248 / 3, 159 / 249 / 2
doublecenter-alpha_1-7-n5.txt, 1, 1, 5, 541.405, 18, 13, 5, 4,3 / 1 / 2, 4 / 2 / 5, 1 / 3 / 2, 2 / 4 / 2
doublecenter-alpha_1-7-n500.txt, 1, 1, 500, 4373.28, 3781, 3281, 6, 499,24 / 1 / 3, 488 / 2 / 2, 173 / 3 / 3, 243 / 4 / 2, 330 / 5 / 2, 217 / 6 / 4, 298 / 7 / 2, 413 / 8 / 2, 418 / 9 / 2, 494 / 10 / 2, 323 / 11 / 2, 222 / 12 / 2, 400 / 13 / 3, 156 / 14 / 2, 57 / 15 / 2, 160 / 16 / 2, 133 / 17 / 2, 317 / 18 / 2, 16 / 19 / 2, 224 / 20 / 2, 29 / 21 / 5, 205 / 22 / 2, 273 / 23 / 2, 90 / 24 / 3, 344 / 25 / 2, 188 / 26 / 2, 144 / 27 / 3, 438 / 28 / 2, 267 / 29 / 3, 313 / 30 / 2, 213 / 31 / 2, 39 / 32 / 2, 163 / 33 / 2, 149 / 34 / 2, 250 / 35 / 3, 388 / 36 / 2, 137 / 37 / 2, 498 / 38 / 2, 284 / 39 / 3, 45 / 40 / 2, 132 / 41 / 2, 416 / 42 / 2, 78 / 43 / 2, 356 / 44 / 2, 385 / 45 / 2, 294 / 46 / 2, 215 / 47 / 2, 122 / 48 / 2, 281 / 49 / 4, 190 / 50 / 2, 105 / 51 / 2, 185 / 52 / 2, 241 / 53 / 2, 55 / 54 / 2, 202 / 55 / 3, 26 / 56 / 2, 245 / 57 / 2, 7 / 58 / 2, 334 / 59 / 2, 256 / 60 / 2, 218 / 61 / 4, 59 / 62 / 2, 44 / 63 / 2, 107 / 64 / 2, 199 / 65 / 2, 263 / 66 / 3, 101 / 67 / 2, 454 / 68 / 2, 312 / 69 / 3, 362 / 70 / 2, 171 / 71 / 2, 407 / 72 / 3, 402 / 73 / 2, 239 / 74 / 2, 348 / 75 / 4, 65 / 76 / 2, 166 / 77 / 2, 81 / 78 / 3, 28 / 79 / 2, 364 / 80 / 2, 333 / 81 / 5, 358 / 82 / 2, 108 / 83 / 3, 207 / 84 / 2, 68 / 85 / 3, 446 / 86 / 2, 192 / 87 / 2, 10 / 88 / 2, 468 / 89 / 4, 1 / 90 / 2, 40 / 91 / 2, 315 / 92 / 2, 33 / 93 / 2, 346 / 94 / 2, 209 / 95 / 3, 118 / 96 / 2, 319 / 97 / 3, 304 / 98 / 2, 331 / 99 / 3, 12 / 100 / 2, 291 / 101 / 2, 288 / 102 / 2, 268 / 103 / 3, 236 / 104 / 2, 212 / 105 / 4, 320 / 106 / 2, 216 / 107 / 2, 79 / 108 / 2, 289 / 109 / 2, 296 / 110 / 2, 58 / 111 / 4, 231 / 112 / 2, 14 / 113 / 2, 309 / 114 / 2, 201 / 115 / 2, 458 / 116 / 2, 115 / 117 / 3, 421 / 118 / 2, 82 / 119 / 2, 151 / 120 / 4, 285 / 121 / 2, 335 / 122 / 2, 324 / 123 / 3, 300 / 124 / 2, 318 / 125 / 5, 406 / 126 / 2, 327 / 127 / 2, 290 / 128 / 4, 370 / 129 / 2, 230 / 130 / 2, 240 / 131 / 3, 89 / 132 / 2, 287 / 133 / 3, 113 / 134 / 2, 360 / 135 / 2, 131 / 136 / 2, 232 / 137 / 4, 409 / 138 / 2, 110 / 139 / 2, 172 / 140 / 4, 381 / 141 / 2, 148 / 142 / 3, 255 / 143 / 2, 351 / 144 / 2, 460 / 145 / 2, 182 / 146 / 4, 484 / 147 / 2, 343 / 148 / 2, 432 / 149 / 2, 447 / 150 / 3, 227 / 151 / 2, 303 / 152 / 2, 235 / 153 / 2, 98 / 154 / 2, 147 / 155 / 3, 211 / 156 / 2, 419 / 157 / 3, 480 / 158 / 2, 326 / 159 / 3, 332 / 160 / 2, 462 / 161 / 3, 41 / 162 / 2, 189 / 163 / 2, 375 / 164 / 3, 455 / 165 / 2, 102 / 166 / 2, 426 / 167 / 2, 496 / 168 / 3, 214 / 169 / 2, 260 / 170 / 2, 109 / 171 / 3, 449 / 172 / 2, 292 / 173 / 2, 134 / 174 / 4, 434 / 175 / 2, 203 / 176 / 2, 457 / 177 / 4, 392 / 178 / 2, 83 / 179 / 2, 479 / 180 / 3, 206 / 181 / 2, 19 / 182 / 3, 275 / 183 / 2, 34 / 184 / 2, 473 / 185 / 5, 377 / 186 / 2, 193 / 187 / 2, 380 / 188 / 2, 96 / 189 / 3, 477 / 190 / 2, 354 / 191 / 2, 265 / 192 / 4, 395 / 193 / 2, 367 / 194 / 2, 234 / 195 / 4, 259 / 196 / 2, 94 / 197 / 2, 497 / 198 / 2, 393 / 199 / 2, 123 / 200 / 2, 126 / 201 / 2, 305 / 202 / 2, 329 / 203 / 2, 283 / 204 / 2, 430 / 205 / 2, 401 / 206 / 3, 427 / 207 / 2, 164 / 208 / 2, 252 / 209 / 2, 433 / 210 / 2, 374 / 211 / 2, 481 / 212 / 2, 372 / 213 / 4, 76 / 214 / 2, 436 / 215 / 2, 154 / 216 / 4, 254 / 217 / 2, 499 / 218 / 2, 489 / 219 / 3, 77 / 220 / 2, 170 / 221 / 3, 72 / 222 / 2, 51 / 223 / 2, 247 / 224 / 2, 237 / 225 / 3, 476 / 226 / 2, 27 / 227 / 2, 485 / 228 / 2, 451 / 229 / 4, 197 / 230 / 2, 80 / 231 / 2, 159 / 232 / 2, 43 / 233 / 2, 371 / 234 / 3, 270 / 235 / 2, 398 / 236 / 2, 410 / 237 / 2, 61 / 238 / 3, 52 / 239 / 2, 92 / 240 / 2, 459 / 241 / 2, 492 / 242 / 2, 336 / 243 / 2, 251 / 244 / 4, 325 / 245 / 2, 117 / 246 / 2, 435 / 247 / 4, 376 / 248 / 2, 21 / 249 / 2, 141 / 250 / 3, 2 / 251 / 2, 140 / 252 / 2, 146 / 253 / 5, 221 / 254 / 2, 387 / 255 / 3, 328 / 256 / 2, 338 / 257 / 5, 42 / 258 / 2, 181 / 259 / 2, 316 / 260 / 3, 208 / 261 / 2, 487 / 262 / 3, 5 / 263 / 2, 195 / 264 / 3, 63 / 265 / 2, 223 / 266 / 3, 30 / 267 / 2, 66 / 268 / 2, 363 / 269 / 2, 424 / 270 / 3, 11 / 271 / 2, 306 / 272 / 2, 490 / 273 / 2, 220 / 274 / 2, 441 / 275 / 3, 261 / 276 / 2, 420 / 277 / 3, 448 / 278 / 2, 121 / 279 / 3, 54 / 280 / 2, 139 / 281 / 2, 74 / 282 / 2, 467 / 283 / 2, 120 / 284 / 2, 368 / 285 / 2, 463 / 286 / 2, 295 / 287 / 2, 69 / 288 / 2, 486 / 289 / 2, 86 / 290 / 2, 4 / 291 / 3, 248 / 292 / 2, 145 / 293 / 2, 46 / 294 / 2, 297 / 295 / 2, 124 / 296 / 2, 31 / 297 / 3, 469 / 298 / 2, 345 / 299 / 2, 352 / 300 / 3, 229 / 301 / 2, 373 / 302 / 5, 478 / 303 / 2, 210 / 304 / 2, 264 / 305 / 2, 165 / 306 / 3, 85 / 307 / 2, 456 / 308 / 3, 311 / 309 / 2, 138 / 310 / 2, 415 / 311 / 2, 242 / 312 / 2, 50 / 313 / 2, 71 / 314 / 2, 95 / 315 / 2, 384 / 316 / 2, 111 / 317 / 2, 35 / 318 / 2, 99 / 319 / 2, 196 / 320 / 2, 219 / 321 / 2, 495 / 322 / 3, 423 / 323 / 2, 355 / 324 / 2, 425 / 325 / 2, 269 / 326 / 2, 244 / 327 / 2, 452 / 328 / 4, 278 / 329 / 2, 67 / 330 / 2, 142 / 331 / 4, 322 / 332 / 2, 357 / 333 / 2, 359 / 334 / 4, 465 / 335 / 2, 158 / 336 / 2, 130 / 337 / 4, 491 / 338 / 2, 88 / 339 / 2, 493 / 340 / 4, 176 / 341 / 2, 150 / 342 / 2, 321 / 343 / 2, 187 / 344 / 2, 249 / 345 / 5, 22 / 346 / 2, 464 / 347 / 2, 127 / 348 / 2, 13 / 349 / 3, 280 / 350 / 2, 307 / 351 / 3, 349 / 352 / 2, 226 / 353 / 3, 389 / 354 / 2, 440 / 355 / 2, 116 / 356 / 4, 308 / 357 / 2, 276 / 358 / 2, 238 / 359 / 2, 337 / 360 / 3, 175 / 361 / 2, 161 / 362 / 3, 382 / 363 / 2, 340 / 364 / 2, 422 / 365 / 2, 429 / 366 / 5, 93 / 367 / 2, 408 / 368 / 2, 272 / 369 / 2, 97 / 370 / 2, 153 / 371 / 4, 279 / 372 / 2, 204 / 373 / 2, 443 / 374 / 2, 32 / 375 / 3, 48 / 376 / 2, 414 / 377 / 3, 471 / 378 / 2, 257 / 379 / 2, 162 / 380 / 2, 112 / 381 / 3, 482 / 382 / 2, 439 / 383 / 4, 404 / 384 / 2, 411 / 385 / 2, 179 / 386 / 3, 75 / 387 / 2, 274 / 388 / 3, 87 / 389 / 2, 369 / 390 / 2, 73 / 391 / 2, 177 / 392 / 3, 378 / 393 / 2, 397 / 394 / 3, 302 / 395 / 2, 472 / 396 / 2, 191 / 397 / 4, 70 / 398 / 2, 405 / 399 / 2, 136 / 400 / 2, 246 / 401 / 2, 271 / 402 / 2, 442 / 403 / 2, 341 / 404 / 2, 461 / 405 / 3, 453 / 406 / 2, 483 / 407 / 3, 293 / 408 / 2, 37 / 409 / 3, 178 / 410 / 2, 128 / 411 / 2, 396 / 412 / 4, 143 / 413 / 2, 49 / 414 / 2, 9 / 415 / 3, 403 / 416 / 2, 314 / 417 / 2, 15 / 418 / 2, 342 / 419 / 4, 91 / 420 / 2, 180 / 421 / 2, 6 / 422 / 2, 470 / 423 / 3, 8 / 424 / 2, 282 / 425 / 3, 168 / 426 / 2, 60 / 427 / 3, 391 / 428 / 2, 84 / 429 / 2, 228 / 430 / 3, 365 / 431 / 2, 3 / 432 / 2, 399 / 433 / 2, 56 / 434 / 2, 390 / 435 / 5, 266 / 436 / 2, 366 / 437 / 2, 125 / 438 / 4, 129 / 439 / 2, 444 / 440 / 2, 445 / 441 / 3, 167 / 442 / 2, 277 / 443 / 2, 386 / 444 / 2, 174 / 445 / 3, 186 / 446 / 2, 169 / 447 / 2, 412 / 448 / 2, 200 / 449 / 2, 428 / 450 / 2, 225 / 451 / 3, 466 / 452 / 2, 64 / 453 / 2, 286 / 454 / 2, 394 / 455 / 2, 47 / 456 / 2, 100 / 457 / 2, 36 / 458 / 2, 474 / 459 / 4, 299 / 460 / 2, 475 / 461 / 2, 361 / 462 / 2, 106 / 463 / 2, 347 / 464 / 2, 183 / 465 / 2, 339 / 466 / 3, 353 / 467 / 2, 184 / 468 / 2, 383 / 469 / 4, 103 / 470 / 2, 437 / 471 / 3, 23 / 472 / 2, 431 / 473 / 2, 38 / 474 / 2, 25 / 475 / 3, 152 / 476 / 2, 20 / 477 / 3, 253 / 478 / 2, 417 / 479 / 6, 135 / 480 / 2, 350 / 481 / 2, 379 / 482 / 2, 119 / 483 / 2, 450 / 484 / 3, 194 / 485 / 2, 104 / 486 / 2, 114 / 487 / 3, 301 / 488 / 2, 262 / 489 / 3, 310 / 490 / 2, 157 / 491 / 2, 155 / 492 / 3, 18 / 493 / 2, 53 / 494 / 2, 17 / 495 / 3, 258 / 496 / 2, 62 / 497 / 3, 198 / 498 / 2, 233 / 499 / 2
doublecenter-alpha_1-70-n20.txt, 1, 1, 20, 872.721, 118, 98, 6, 19,12 / 1 / 6, 19 / 2 / 2, 4 / 3 / 2, 11 / 4 / 2, 8 / 5 / 2, 9 / 6 / 2, 3 / 7 / 3, 18 / 8 / 2, 13 / 9 / 3, 7 / 10 / 2, 1 / 11 / 2, 17 / 12 / 2, 16 / 13 / 2, 15 / 14 / 3, 2 / 15 / 2, 14 / 16 / 3, 6 / 17 / 2, 10 / 18 / 2, 5 / 19 / 3
doublecenter-alpha_1-71-n50.txt, 1, 1, 50, 1571.49, 474, 424, 7, 49,33 / 1 / 3, 24 / 2 / 2, 18 / 3 / 3, 47 / 4 / 2, 15 / 5 / 2, 16 / 6 / 7, 17 / 7 / 2, 39 / 8 / 2, 2 / 9 / 3, 1 / 10 / 2, 12 / 11 / 2, 7 / 12 / 4, 26 / 13 / 2, 34 / 14 / 2, 13 / 15 / 3, 42 / 16 / 2, 10 / 17 / 3, 46 / 18 / 2, 21 / 19 / 3, 30 / 20 / 2, 28 / 21 / 7, 45 / 22 / 2, 5 / 23 / 2, 11 / 24 / 3, 23 / 25 / 2, 20 / 26 / 2, 27 / 27 / 2, 44 / 28 / 2, 3 / 29 / 2, 48 / 30 / 6, 32 / 31 / 2, 40 / 32 / 3, 36 / 33 / 2, 29 / 34 / 2, 31 / 35 / 2, 22 / 36 / 5, 9 / 37 / 2, 6 / 38 / 3, 37 / 39 / 2, 25 / 40 / 3, 4 / 41 / 2, 49 / 42 / 2, 14 / 43 / 2, 19 / 44 / 2, 38 / 45 / 2, 35 / 46 / 2, 43 / 47 / 3, 8 / 48 / 2, 41 / 49 / 3
doublecenter-alpha_1-72-n50.txt, 1, 1, 50, 1362.09, 410, 360, 5, 49,19 / 1 / 2, 38 / 2 / 5, 33 / 3 / 2, 7 / 4 / 2, 42 / 5 / 2, 40 / 6 / 5, 28 / 7 / 2, 26 / 8 / 2, 24 / 9 / 2, 27 / 10 / 3, 32 / 11 / 2, 22 / 12 / 3, 1 / 13 / 2, 30 / 14 / 2, 47 / 15 / 2, 35 / 16 / 3, 13 / 17 / 2, 14 / 18 / 2, 8 / 19 / 3, 39 / 20 / 2, 44 / 21 / 2, 34 / 22 / 5, 45 / 23 / 2, 37 / 24 / 2, 23 / 25 / 2, 21 / 26 / 2, 20 / 27 / 3, 25 / 28 / 2, 15 / 29 / 2, 5 / 30 / 4, 18 / 31 / 2, 31 / 32 / 2, 17 / 33 / 2, 12 / 34 / 2, 9 / 35 / 2, 16 / 36 / 3, 41 / 37 / 2, 3 / 38 / 3, 4 / 39 / 2, 29 / 40 / 2, 48 / 41 / 3, 6 / 42 / 2, 2 / 43 / 2, 43 / 44 / 2, 49 / 45 / 3, 11 / 46 / 2, 36 / 47 / 3, 46 / 48 / 2, 10 / 49 / 4
doublecenter-alpha_1-73-n50.txt, 1, 1, 50, 1279.27, 388, 338, 5, 49,10 / 1 / 2, 37 / 2 / 3, 30 / 3 / 2, 48 / 4 / 2, 25 / 5 / 4, 29 / 6 / 2, 14 / 7 / 2, 26 / 8 / 4, 16 / 9 / 2, 45 / 10 / 2, 22 / 11 / 2, 15 / 12 / 3, 31 / 13 / 2, 43 / 14 / 5, 11 / 15 / 2, 24 / 16 / 2, 46 / 17 / 3, 18 / 18 / 2, 33 / 19 / 2, 44 / 20 / 2, 32 / 21 / 2, 6 / 22 / 2, 38 / 23 / 2, 34 / 24 / 3, 42 / 25 / 2, 9 / 26 / 2, 7 / 27 / 2, 2 / 28 / 2, 19 / 29 / 2, 47 / 30 / 2, 12 / 31 / 2, 20 / 32 / 2, 40 / 33 / 2, 3 / 34 / 3, 49 / 35 / 2, 27 / 36 / 3, 39 / 37 / 2, 41 / 38 / 3, 23 / 39 / 2, 8 / 40 / 2, 13 / 41 / 5, 35 / 42 / 2, 17 / 43 / 2, 1 / 44 / 2, 28 / 45 / 3, 36 / 46 / 2, 5 / 47 / 3, 21 / 48 / 2, 4 / 49 / 3
doublecenter-alpha_1-74-n50.txt, 1, 1, 50, 1189.89, 401, 351, 10, 49,41 / 1 / 3, 23 / 2 / 2, 17 / 3 / 2, 24 / 4 / 2, 5 / 5 / 2, 9 / 6 / 2, 22 / 7 / 4, 18 / 8 / 2, 2 / 9 / 2, 38 / 10 / 3, 16 / 11 / 2, 27 / 12 / 2, 7 / 13 / 2, 48 / 14 / 2, 49 / 15 / 2, 6 / 16 / 5, 20 / 17 / 2, 33 / 18 / 2, 3 / 19 / 2, 26 / 20 / 2, 13 / 21 / 2, 37 / 22 / 5, 44 / 23 / 2, 29 / 24 / 2, 25 / 25 / 2, 45 / 26 / 2, 1 / 27 / 2, 32 / 28 / 2, 47 / 29 / 4, 21 / 30 / 2, 14 / 31 / 2, 46 / 32 / 2, 30 / 33 / 5, 43 / 34 / 2, 15 / 35 / 2, 35 / 36 / 2, 4 / 37 / 3, 34 / 38 / 2, 8 / 39 / 4, 36 / 40 / 2, 31 / 41 / 3, 39 / 42 / 2, 42 / 43 / 2, 10 / 44 / 3, 28 / 45 / 2, 11 / 46 / 2, 12 / 47 / 2, 19 / 48 / 2, 40 / 49 / 10
doublecenter-alpha_1-75-n50.txt, 1, 1, 50, 1365.93, 461, 411, 10, 49,33 / 1 / 2, 36 / 2 / 8, 30 / 3 / 2, 23 / 4 / 2, 25 / 5 / 2, 32 / 6 / 2, 11 / 7 / 3, 42 / 8 / 2, 28 / 9 / 3, 37 / 10 / 2, 19 / 11 / 2, 44 / 12 / 2, 7 / 13 / 5, 21 / 14 / 2, 17 / 15 / 2, 22 / 16 / 2, 4 / 17 / 2, 39 / 18 / 2, 29 / 19 / 3, 10 / 20 / 2, 13 / 21 / 2, 31 / 22 / 3, 49 / 23 / 2, 12 / 24 / 2, 45 / 25 / 2, 27 / 26 / 10, 47 / 27 / 2, 15 / 28 / 2, 48 / 29 / 4, 3 / 30 / 2, 46 / 31 / 2, 43 / 32 / 3, 5 / 33 / 2, 40 / 34 / 2, 6 / 35 / 3, 24 / 36 / 2, 18 / 37 / 2, 38 / 38 / 3, 20 / 39 / 2, 1 / 40 / 2, 9 / 41 / 3, 16 / 42 / 2, 41 / 43 / 2, 34 / 44 / 5, 14 / 45 / 2, 26 / 46 / 2, 2 / 47 / 2, 35 / 48 / 2, 8 / 49 / 5
doublecenter-alpha_1-76-n50.txt, 1, 1, 50, 1479.27, 384, 334, 5, 49,15 / 1 / 4, 17 / 2 / 2, 25 / 3 / 2, 37 / 4 / 2, 6 / 5 / 3, 41 / 6 / 2, 39 / 7 / 2, 7 / 8 / 2, 31 / 9 / 2, 12 / 10 / 2, 47 / 11 / 2, 28 / 12 / 3, 49 / 13 / 2, 42 / 14 / 4, 9 / 15 / 2, 32 / 16 / 3, 34 / 17 / 2, 8 / 18 / 2, 20 / 19 / 3, 23 / 20 / 2, 3 / 21 / 2, 26 / 22 / 3, 10 / 23 / 2, 11 / 24 / 3, 40 / 25 / 2, 27 / 26 / 3, 13 / 27 / 2, 21 / 28 / 2, 36 / 29 / 2, 14 / 30 / 2, 48 / 31 / 3, 5 / 32 / 2, 4 / 33 / 2, 38 / 34 / 5, 46 / 35 / 2, 35 / 36 / 3, 19 / 37 / 2, 22 / 38 / 2, 24 / 39 / 3, 33 / 40 / 2, 30 / 41 / 3, 16 / 42 / 2, 1 / 43 / 3, 43 / 44 / 2, 44 / 45 / 2, 2 / 46 / 2, 45 / 47 / 2, 18 / 48 / 2, 29 / 49 / 2
doublecenter-alpha_1-77-n50.txt, 1, 1, 50, 1313.26, 418, 368, 9, 49,30 / 1 / 2, 38 / 2 / 2, 24 / 3 / 2, 29 / 4 / 9, 8 / 5 / 2, 40 / 6 / 2, 19 / 7 / 2, 27 / 8 / 3, 18 / 9 / 2, 7 / 10 / 3, 42 / 11 / 2, 15 / 12 / 2, 46 / 13 / 3, 4 / 14 / 2, 6 / 15 / 2, 44 / 16 / 2, 22 / 17 / 5, 28 / 18 / 2, 20 / 19 / 3, 41 / 20 / 2, 12 / 21 / 3, 16 / 22 / 2, 5 / 23 / 2, 3 / 24 / 2, 35 / 25 / 2, 17 / 26 / 4, 39 / 27 / 2, 26 / 28 / 2, 14 / 29 / 2, 23 / 30 / 3, 13 / 31 / 2, 11 / 32 / 5, 47 / 33 / 2, 36 / 34 / 2, 21 / 35 / 2, 33 / 36 / 2, 48 / 37 / 2, 10 / 38 / 2, 32 / 39 / 5, 9 / 40 / 2, 1 / 41 / 2, 37 / 42 / 2, 34 / 43 / 2, 31 / 44 / 3, 43 / 45 / 2, 2 / 46 / 3, 45 / 47 / 2, 49 / 48 / 2, 25 / 49 / 2
doublecenter-alpha_1-78-n50.txt, 1, 1, 50, 1362.47, 415, 365, 7, 49,29 / 1 / 2, 4 / 2 / 6, 17 / 3 / 2, 16 / 4 / 2, 18 / 5 / 2, 34 / 6 / 2, 14 / 7 / 6, 33 / 8 / 2, 48 / 9 / 2, 36 / 10 / 4, 8 / 11 / 2, 31 / 12 / 2, 2 / 13 / 4, 25 / 14 / 2, 42 / 15 / 2, 47 / 16 / 2, 43 / 17 / 3, 20 / 18 / 2, 37 / 19 / 2, 35 / 20 / 2, 1 / 21 / 4, 44 / 22 / 2, 24 / 23 / 2, 12 / 24 / 4, 30 / 25 / 2, 23 / 26 / 3, 11 / 27 / 2, 21 / 28 / 3, 49 / 29 / 2, 27 / 30 / 2, 22 / 31 / 4, 45 / 32 / 2, 19 / 33 / 2, 26 / 34 / 2, 7 / 35 / 3, 41 / 36 / 2, 40 / 37 / 2, 38 / 38 / 3, 9 / 39 / 2, 3 / 40 / 3, 39 / 41 / 2, 32 / 42 / 2, 28 / 43 / 3, 46 / 44 / 2, 5 / 45 / 3, 15 / 46 / 2, 6 / 47 / 7, 10 / 48 / 2, 13 / 49 / 2
doublecenter-alpha_1-79-n50.txt, 1, 1, 50, 1253.1, 382, 332, 7, 49,34 / 1 / 7, 10 / 2 / 2, 6 / 3 / 2, 7 / 4 / 2, 1 / 5 / 3, 15 / 6 / 2, 20 / 7 / 3, 12 / 8 / 2, 41 / 9 / 2, 45 / 10 / 3, 31 / 11 / 2, 23 / 12 / 3, 2 / 13 / 2, 42 / 14 / 4, 38 / 15 / 2, 9 / 16 / 2, 30 / 17 / 2, 37 / 18 / 3, 43 / 19 / 2, 35 / 20 / 2, 25 / 21 / 3, 36 / 22 / 2, 16 / 23 / 3, 39 / 24 / 2, 28 / 25 / 2, 18 / 26 / 5, 32 / 27 / 2, 17 / 28 / 2, 44 / 29 / 3, 14 / 30 / 2, 27 / 31 / 2, 33 / 32 / 4, 19 / 33 / 2, 5 / 34 / 3, 29 / 35 / 2, 26 / 36 / 2, 13 / 37 / 4, 22 / 38 / 2, 11 / 39 / 2, 8 / 40 / 3, 21 / 41 / 2, 47 / 42 / 2, 40 / 43 / 3, 24 / 44 / 2, 49 / 45 / 2, 4 / 46 / 2, 48 / 47 / 2, 46 / 48 / 5, 3 / 49 / 2
doublecenter-alpha_1-8-n250.txt, 1, 1, 250, 2950.04, 1819, 1569, 5, 249,148 / 1 / 2, 199 / 2 / 5, 25 / 3 / 2, 88 / 4 / 3, 170 / 5 / 2, 222 / 6 / 2, 172 / 7 / 4, 39 / 8 / 2, 81 / 9 / 2, 60 / 10 / 3, 195 / 11 / 2, 2 / 12 / 3, 90 / 13 / 2, 117 / 14 / 3, 174 / 15 / 2, 5 / 16 / 3, 119 / 17 / 2, 151 / 18 / 2, 27 / 19 / 2, 107 / 20 / 4, 85 / 21 / 2, 166 / 22 / 2, 19 / 23 / 2, 63 / 24 / 3, 64 / 25 / 2, 191 / 26 / 3, 108 / 27 / 2, 120 / 28 / 3, 13 / 29 / 2, 165 / 30 / 2, 162 / 31 / 2, 233 / 32 / 3, 152 / 33 / 2, 116 / 34 / 3, 105 / 35 / 2, 228 / 36 / 2, 111 / 37 / 3, 89 / 38 / 2, 158 / 39 / 2, 129 / 40 / 2, 121 / 41 / 2, 61 / 42 / 2, 149 / 43 / 2, 77 / 44 / 2, 139 / 45 / 3, 229 / 46 / 2, 217 / 47 / 2, 7 / 48 / 3, 201 / 49 / 2, 211 / 50 / 3, 106 / 51 / 2, 157 / 52 / 3, 71 / 53 / 2, 212 / 54 / 3, 197 / 55 / 2, 171 / 56 / 3, 57 / 57 / 2, 48 / 58 / 3, 65 / 59 / 2, 185 / 60 / 2, 30 / 61 / 2, 150 / 62 / 2, 161 / 63 / 5, 115 / 64 / 2, 34 / 65 / 3, 163 / 66 / 2, 225 / 67 / 3, 42 / 68 / 2, 103 / 69 / 2, 167 / 70 / 4, 92 / 71 / 2, 160 / 72 / 3, 237 / 73 / 2, 183 / 74 / 2, 97 / 75 / 3, 238 / 76 / 2, 10 / 77 / 3, 102 / 78 / 2, 155 / 79 / 2, 12 / 80 / 3, 98 / 81 / 2, 122 / 82 / 3, 40 / 83 / 2, 28 / 84 / 2, 240 / 85 / 2, 206 / 86 / 2, 186 / 87 / 2, 136 / 88 / 2, 37 / 89 / 2, 49 / 90 / 2, 193 / 91 / 3, 203 / 92 / 2, 187 / 93 / 2, 189 / 94 / 2, 118 / 95 / 3, 159 / 96 / 2, 41 / 97 / 2, 221 / 98 / 2, 35 / 99 / 3, 79 / 100 / 2, 192 / 101 / 4, 145 / 102 / 2, 16 / 103 / 2, 196 / 104 / 2, 14 / 105 / 5, 46 / 106 / 2, 244 / 107 / 2, 198 / 108 / 2, 8 / 109 / 2, 216 / 110 / 2, 242 / 111 / 2, 53 / 112 / 4, 247 / 113 / 2, 58 / 114 / 3, 69 / 115 / 2, 130 / 116 / 3, 31 / 117 / 2, 224 / 118 / 3, 51 / 119 / 2, 142 / 120 / 2, 141 / 121 / 2, 96 / 122 / 3, 209 / 123 / 2, 146 / 124 / 2, 137 / 125 / 5, 177 / 126 / 2, 178 / 127 / 3, 138 / 128 / 2, 1 / 129 / 2, 84 / 130 / 3, 231 / 131 / 2, 4 / 132 / 2, 56 / 133 / 3, 62 / 134 / 2, 100 / 135 / 2, 44 / 136 / 3, 11 / 137 / 2, 143 / 138 / 2, 36 / 139 / 2, 78 / 140 / 4, 54 / 141 / 2, 6 / 142 / 2, 32 / 143 / 4, 239 / 144 / 2, 132 / 145 / 2, 190 / 146 / 5, 87 / 147 / 2, 15 / 148 / 2, 83 / 149 / 2, 214 / 150 / 3, 104 / 151 / 2, 194 / 152 / 2, 218 / 153 / 2, 113 / 154 / 4, 21 / 155 / 2, 112 / 156 / 2, 227 / 157 / 3, 74 / 158 / 2, 73 / 159 / 3, 67 / 160 / 2, 3 / 161 / 2, 22 / 162 / 2, 75 / 163 / 2, 38 / 164 / 2, 169 / 165 / 4, 234 / 166 / 2, 153 / 167 / 2, 50 / 168 / 2, 126 / 169 / 3, 110 / 170 / 2, 176 / 171 / 2, 20 / 172 / 2, 101 / 173 / 3, 23 / 174 / 2, 123 / 175 / 2, 207 / 176 / 4, 33 / 177 / 2, 133 / 178 / 2, 26 / 179 / 2, 134 / 180 / 3, 99 / 181 / 2, 200 / 182 / 2, 243 / 183 / 3, 135 / 184 / 2, 246 / 185 / 3, 205 / 186 / 2, 70 / 187 / 2, 125 / 188 / 2, 173 / 189 / 3, 76 / 190 / 2, 249 / 191 / 3, 181 / 192 / 2, 226 / 193 / 2, 236 / 194 / 2, 66 / 195 / 2, 91 / 196 / 2, 124 / 197 / 3, 114 / 198 / 2, 175 / 199 / 2, 154 / 200 / 3, 223 / 201 / 2, 9 / 202 / 2, 208 / 203 / 2, 140 / 204 / 2, 24 / 205 / 2, 47 / 206 / 3, 95 / 207 / 2, 184 / 208 / 3, 147 / 209 / 2, 156 / 210 / 2, 29 / 211 / 4, 52 / 212 / 2, 109 / 213 / 2, 82 / 214 / 2, 131 / 215 / 3, 93 / 216 / 2, 180 / 217 / 3, 45 / 218 / 2, 164 / 219 / 2, 55 / 220 / 3, 213 / 221 / 2, 188 / 222 / 3, 219 / 223 / 2, 235 / 224 / 4, 210 / 225 / 2, 241 / 226 / 2, 182 / 227 / 3, 144 / 228 / 2, 59 / 229 / 3, 220 / 230 / 2, 128 / 231 / 2, 168 / 232 / 3, 80 / 233 / 2, 43 / 234 / 2, 204 / 235 / 3, 72 / 236 / 2, 215 / 237 / 2, 202 / 238 / 3, 179 / 239 / 2, 68 / 240 / 2, 230 / 241 / 4, 18 / 242 / 2, 127 / 243 / 2, 17 / 244 / 4, 248 / 245 / 2, 94 / 246 / 2, 86 / 247 / 2, 245 / 248 / 3, 232 / 249 / 2
doublecenter-alpha_1-8-n5.txt, 1, 1, 5, 710.08, 17, 12, 3, 4,1 / 1 / 2, 4 / 2 / 2, 3 / 3 / 2, 2 / 4 / 3
doublecenter-alpha_1-8-n500.txt, 1, 1, 500, 4207.99, 3894, 3394, 9, 499,129 / 1 / 2, 397 / 2 / 3, 357 / 3 / 2, 417 / 4 / 3, 173 / 5 / 2, 191 / 6 / 3, 303 / 7 / 2, 324 / 8 / 2, 34 / 9 / 3, 5 / 10 / 2, 200 / 11 / 2, 232 / 12 / 5, 128 / 13 / 2, 76 / 14 / 2, 414 / 15 / 2, 340 / 16 / 2, 105 / 17 / 2, 244 / 18 / 3, 321 / 19 / 2, 186 / 20 / 3, 236 / 21 / 2, 420 / 22 / 2, 424 / 23 / 3, 91 / 24 / 2, 17 / 25 / 2, 21 / 26 / 2, 245 / 27 / 2, 265 / 28 / 3, 135 / 29 / 2, 481 / 30 / 2, 322 / 31 / 2, 225 / 32 / 2, 393 / 33 / 2, 446 / 34 / 2, 108 / 35 / 3, 16 / 36 / 2, 198 / 37 / 2, 152 / 38 / 2, 44 / 39 / 2, 222 / 40 / 2, 332 / 41 / 2, 10 / 42 / 2, 30 / 43 / 3, 342 / 44 / 2, 147 / 45 / 3, 334 / 46 / 2, 376 / 47 / 2, 166 / 48 / 2, 144 / 49 / 2, 492 / 50 / 2, 484 / 51 / 3, 460 / 52 / 2, 268 / 53 / 2, 391 / 54 / 2, 75 / 55 / 2, 13 / 56 / 2, 257 / 57 / 3, 85 / 58 / 2, 43 / 59 / 3, 274 / 60 / 2, 295 / 61 / 3, 443 / 62 / 2, 122 / 63 / 2, 318 / 64 / 2, 224 / 65 / 2, 339 / 66 / 2, 283 / 67 / 2, 52 / 68 / 2, 438 / 69 / 2, 330 / 70 / 3, 350 / 71 / 2, 39 / 72 / 2, 386 / 73 / 2, 136 / 74 / 3, 261 / 75 / 2, 310 / 76 / 2, 309 / 77 / 2, 315 / 78 / 4, 178 / 79 / 2, 396 / 80 / 3, 266 / 81 / 2, 359 / 82 / 3, 476 / 83 / 2, 60 / 84 / 2, 90 / 85 / 3, 55 / 86 / 2, 159 / 87 / 2, 478 / 88 / 3, 112 / 89 / 2, 353 / 90 / 2, 349 / 91 / 2, 462 / 92 / 3, 423 / 93 / 2, 356 / 94 / 5, 260 / 95 / 2, 338 / 96 / 2, 375 / 97 / 2, 242 / 98 / 2, 204 / 99 / 5, 394 / 100 / 2, 311 / 101 / 3, 278 / 102 / 2, 168 / 103 / 3, 247 / 104 / 2, 14 / 105 / 4, 201 / 106 / 2, 408 / 107 / 2, 473 / 108 / 3, 385 / 109 / 2, 367 / 110 / 3, 33 / 111 / 2, 254 / 112 / 2, 79 / 113 / 4, 370 / 114 / 2, 240 / 115 / 2, 351 / 116 / 2, 195 / 117 / 2, 97 / 118 / 2, 9 / 119 / 2, 139 / 120 / 2, 298 / 121 / 2, 389 / 122 / 4, 174 / 123 / 2, 154 / 124 / 2, 372 / 125 / 3, 452 / 126 / 2, 211 / 127 / 2, 308 / 128 / 3, 163 / 129 / 2, 355 / 130 / 2, 398 / 131 / 2, 167 / 132 / 3, 301 / 133 / 2, 228 / 134 / 2, 337 / 135 / 9, 202 / 136 / 2, 192 / 137 / 3, 36 / 138 / 2, 387 / 139 / 2, 94 / 140 / 2, 366 / 141 / 2, 401 / 142 / 2, 169 / 143 / 2, 493 / 144 / 3, 65 / 145 / 2, 220 / 146 / 3, 223 / 147 / 2, 138 / 148 / 2, 26 / 149 / 2, 248 / 150 / 2, 208 / 151 / 2, 213 / 152 / 2, 435 / 153 / 2, 297 / 154 / 3, 118 / 155 / 2, 453 / 156 / 3, 12 / 157 / 2, 251 / 158 / 3, 327 / 159 / 2, 127 / 160 / 2, 194 / 161 / 3, 381 / 162 / 2, 87 / 163 / 4, 380 / 164 / 2, 335 / 165 / 3, 474 / 166 / 2, 190 / 167 / 2, 146 / 168 / 2, 50 / 169 / 3, 111 / 170 / 2, 6 / 171 / 3, 345 / 172 / 2, 58 / 173 / 2, 276 / 174 / 2, 203 / 175 / 2, 409 / 176 / 2, 499 / 177 / 2, 188 / 178 / 3, 495 / 179 / 2, 365 / 180 / 3, 230 / 181 / 2, 70 / 182 / 2, 403 / 183 / 2, 3 / 184 / 6, 286 / 185 / 2, 182 / 186 / 2, 237 / 187 / 2, 395 / 188 / 2, 358 / 189 / 2, 37 / 190 / 3, 482 / 191 / 2, 485 / 192 / 3, 390 / 193 / 2, 24 / 194 / 4, 413 / 195 / 2, 132 / 196 / 3, 312 / 197 / 2, 437 / 198 / 2, 8 / 199 / 2, 464 / 200 / 3, 206 / 201 / 2, 267 / 202 / 3, 165 / 203 / 2, 189 / 204 / 2, 471 / 205 / 2, 288 / 206 / 2, 305 / 207 / 3, 49 / 208 / 2, 124 / 209 / 2, 451 / 210 / 3, 148 / 211 / 2, 449 / 212 / 2, 400 / 213 / 2, 45 / 214 / 3, 102 / 215 / 2, 25 / 216 / 2, 432 / 217 / 4, 69 / 218 / 2, 197 / 219 / 2, 300 / 220 / 2, 51 / 221 / 5, 419 / 222 / 2, 388 / 223 / 3, 329 / 224 / 2, 402 / 225 / 3, 354 / 226 / 2, 407 / 227 / 3, 164 / 228 / 2, 38 / 229 / 2, 259 / 230 / 5, 378 / 231 / 2, 415 / 232 / 2, 221 / 233 / 2, 155 / 234 / 5, 193 / 235 / 2, 143 / 236 / 3, 179 / 237 / 2, 250 / 238 / 3, 425 / 239 / 2, 140 / 240 / 2, 125 / 241 / 2, 15 / 242 / 2, 209 / 243 / 3, 67 / 244 / 2, 331 / 245 / 2, 57 / 246 / 3, 113 / 247 / 2, 405 / 248 / 3, 282 / 249 / 2, 233 / 250 / 2, 241 / 251 / 3, 360 / 252 / 2, 491 / 253 / 3, 115 / 254 / 2, 66 / 255 / 2, 347 / 256 / 2, 348 / 257 / 4, 234 / 258 / 2, 430 / 259 / 2, 20 / 260 / 3, 469 / 261 / 2, 333 / 262 / 3, 497 / 263 / 2, 107 / 264 / 2, 1 / 265 / 2, 275 / 266 / 4, 89 / 267 / 2, 28 / 268 / 2, 448 / 269 / 2, 280 / 270 / 5, 483 / 271 / 2, 172 / 272 / 3, 153 / 273 / 2, 323 / 274 / 2, 176 / 275 / 2, 226 / 276 / 3, 450 / 277 / 2, 296 / 278 / 6, 468 / 279 / 2, 281 / 280 / 2, 210 / 281 / 2, 68 / 282 / 3, 81 / 283 / 2, 253 / 284 / 2, 325 / 285 / 3, 371 / 286 / 2, 317 / 287 / 3, 185 / 288 / 2, 227 / 289 / 3, 352 / 290 / 2, 263 / 291 / 2, 279 / 292 / 3, 63 / 293 / 2, 399 / 294 / 3, 84 / 295 / 2, 183 / 296 / 3, 40 / 297 / 2, 252 / 298 / 3, 466 / 299 / 2, 196 / 300 / 2, 496 / 301 / 3, 404 / 302 / 2, 184 / 303 / 3, 126 / 304 / 2, 62 / 305 / 3, 61 / 306 / 2, 373 / 307 / 3, 344 / 308 / 2, 256 / 309 / 5, 374 / 310 / 2, 379 / 311 / 2, 157 / 312 / 4, 116 / 313 / 2, 158 / 314 / 2, 302 / 315 / 3, 490 / 316 / 2, 22 / 317 / 2, 271 / 318 / 2, 459 / 319 / 2, 187 / 320 / 2, 361 / 321 / 2, 231 / 322 / 2, 431 / 323 / 2, 120 / 324 / 4, 170 / 325 / 2, 418 / 326 / 3, 103 / 327 / 2, 467 / 328 / 4, 314 / 329 / 2, 377 / 330 / 2, 447 / 331 / 3, 215 / 332 / 2, 472 / 333 / 6, 27 / 334 / 2, 439 / 335 / 2, 299 / 336 / 2, 218 / 337 / 2, 433 / 338 / 2, 411 / 339 / 3, 100 / 340 / 2, 436 / 341 / 2, 130 / 342 / 3, 465 / 343 / 2, 416 / 344 / 5, 457 / 345 / 2, 133 / 346 / 2, 422 / 347 / 2, 42 / 348 / 2, 156 / 349 / 2, 362 / 350 / 2, 199 / 351 / 2, 427 / 352 / 2, 71 / 353 / 3, 99 / 354 / 2, 101 / 355 / 6, 29 / 356 / 2, 181 / 357 / 2, 149 / 358 / 3, 239 / 359 / 2, 180 / 360 / 2, 73 / 361 / 4, 162 / 362 / 2, 235 / 363 / 3, 382 / 364 / 2, 123 / 365 / 2, 93 / 366 / 3, 255 / 367 / 2, 177 / 368 / 2, 368 / 369 / 2, 384 / 370 / 3, 19 / 371 / 2, 293 / 372 / 5, 445 / 373 / 2, 475 / 374 / 2, 494 / 375 / 2, 292 / 376 / 2, 7 / 377 / 4, 205 / 378 / 2, 498 / 379 / 2, 56 / 380 / 2, 410 / 381 / 3, 258 / 382 / 2, 428 / 383 / 2, 444 / 384 / 2, 18 / 385 / 2, 92 / 386 / 2, 32 / 387 / 2, 48 / 388 / 2, 95 / 389 / 2, 272 / 390 / 4, 455 / 391 / 2, 287 / 392 / 2, 434 / 393 / 3, 463 / 394 / 2, 246 / 395 / 4, 31 / 396 / 2, 406 / 397 / 2, 421 / 398 / 2, 161 / 399 / 3, 110 / 400 / 2, 426 / 401 / 2, 96 / 402 / 3, 82 / 403 / 2, 243 / 404 / 2, 145 / 405 / 3, 117 / 406 / 2, 458 / 407 / 3, 74 / 408 / 2, 151 / 409 / 2, 119 / 410 / 3, 78 / 411 / 2, 392 / 412 / 2, 270 / 413 / 2, 141 / 414 / 2, 83 / 415 / 2, 489 / 416 / 2, 262 / 417 / 2, 4 / 418 / 2, 23 / 419 / 2, 306 / 420 / 3, 488 / 421 / 2, 104 / 422 / 3, 137 / 423 / 2, 442 / 424 / 2, 150 / 425 / 5, 461 / 426 / 2, 477 / 427 / 2, 72 / 428 / 2, 47 / 429 / 2, 364 / 430 / 4, 86 / 431 / 2, 53 / 432 / 2, 429 / 433 / 3, 441 / 434 / 2, 470 / 435 / 2, 264 / 436 / 5, 341 / 437 / 2, 249 / 438 / 3, 217 / 439 / 2, 46 / 440 / 3, 64 / 441 / 2, 269 / 442 / 5, 456 / 443 / 2, 294 / 444 / 3, 316 / 445 / 2, 2 / 446 / 3, 320 / 447 / 2, 11 / 448 / 2, 412 / 449 / 2, 142 / 450 / 6, 291 / 451 / 2, 212 / 452 / 2, 109 / 453 / 3, 35 / 454 / 2, 219 / 455 / 4, 363 / 456 / 2, 277 / 457 / 3, 114 / 458 / 2, 328 / 459 / 2, 207 / 460 / 2, 134 / 461 / 4, 59 / 462 / 2, 284 / 463 / 2, 238 / 464 / 4, 479 / 465 / 2, 326 / 466 / 3, 290 / 467 / 2, 229 / 468 / 2, 480 / 469 / 3, 273 / 470 / 2, 319 / 471 / 6, 98 / 472 / 2, 346 / 473 / 2, 440 / 474 / 2, 175 / 475 / 2, 160 / 476 / 3, 88 / 477 / 2, 383 / 478 / 2, 304 / 479 / 3, 216 / 480 / 2, 41 / 481 / 2, 171 / 482 / 2, 106 / 483 / 2, 307 / 484 / 2, 285 / 485 / 2, 80 / 486 / 2, 77 / 487 / 2, 289 / 488 / 3, 121 / 489 / 2, 131 / 490 / 2, 369 / 491 / 4, 343 / 492 / 2, 486 / 493 / 2, 313 / 494 / 4, 454 / 495 / 2, 214 / 496 / 2, 487 / 497 / 2, 54 / 498 / 2, 336 / 499 / 2
doublecenter-alpha_1-80-n50.txt, 1, 1, 50, 1544.67, 351, 301, 4, 49,19 / 1 / 2, 13 / 2 / 2, 49 / 3 / 3, 29 / 4 / 2, 42 / 5 / 3, 32 / 6 / 2, 12 / 7 / 3, 2 / 8 / 2, 46 / 9 / 2, 45 / 10 / 3, 40 / 11 / 2, 37 / 12 / 2, 39 / 13 / 2, 8 / 14 / 2, 27 / 15 / 2, 11 / 16 / 2, 17 / 17 / 2, 26 / 18 / 2, 34 / 19 / 2, 48 / 20 / 4, 24 / 21 / 2, 36 / 22 / 2, 18 / 23 / 3, 31 / 24 / 2, 10 / 25 / 3, 25 / 26 / 2, 14 / 27 / 2, 38 / 28 / 2, 35 / 29 / 3, 47 / 30 / 2, 23 / 31 / 2, 15 / 32 / 2, 20 / 33 / 4, 28 / 34 / 2, 4 / 35 / 2, 16 / 36 / 3, 7 / 37 / 2, 21 / 38 / 3, 44 / 39 / 2, 33 / 40 / 2, 1 / 41 / 3, 30 / 42 / 2, 5 / 43 / 2, 3 / 44 / 3, 6 / 45 / 2, 43 / 46 / 2, 9 / 47 / 2, 41 / 48 / 4, 22 / 49 / 2
doublecenter-alpha_1-81-n75.txt, 1, 1, 75, 1531.51, 600, 525, 12, 74,4 / 1 / 3, 11 / 2 / 2, 47 / 3 / 12, 65 / 4 / 2, 51 / 5 / 2, 73 / 6 / 2, 23 / 7 / 3, 42 / 8 / 2, 3 / 9 / 2, 31 / 10 / 2, 26 / 11 / 3, 35 / 12 / 2, 52 / 13 / 2, 71 / 14 / 2, 74 / 15 / 4, 21 / 16 / 2, 53 / 17 / 2, 44 / 18 / 2, 36 / 19 / 2, 57 / 20 / 5, 28 / 21 / 2, 10 / 22 / 2, 29 / 23 / 2, 13 / 24 / 3, 1 / 25 / 2, 20 / 26 / 2, 68 / 27 / 2, 17 / 28 / 3, 60 / 29 / 2, 5 / 30 / 4, 62 / 31 / 2, 12 / 32 / 2, 14 / 33 / 4, 55 / 34 / 2, 58 / 35 / 2, 37 / 36 / 3, 33 / 37 / 2, 59 / 38 / 2, 24 / 39 / 2, 2 / 40 / 2, 7 / 41 / 2, 18 / 42 / 2, 69 / 43 / 2, 27 / 44 / 2, 67 / 45 / 3, 70 / 46 / 2, 16 / 47 / 2, 43 / 48 / 3, 49 / 49 / 2, 45 / 50 / 3, 32 / 51 / 2, 22 / 52 / 4, 40 / 53 / 2, 46 / 54 / 2, 25 / 55 / 4, 34 / 56 / 2, 56 / 57 / 3, 48 / 58 / 2, 50 / 59 / 3, 61 / 60 / 2, 30 / 61 / 2, 72 / 62 / 2, 9 / 63 / 3, 66 / 64 / 2, 19 / 65 / 3, 64 / 66 / 2, 63 / 67 / 3, 39 / 68 / 2, 8 / 69 / 2, 6 / 70 / 4, 54 / 71 / 2, 41 / 72 / 3, 38 / 73 / 2, 15 / 74 / 3
doublecenter-alpha_1-82-n75.txt, 1, 1, 75, 1614.81, 730, 655, 13, 74,47 / 1 / 3, 46 / 2 / 2, 70 / 3 / 3, 57 / 4 / 2, 52 / 5 / 2, 56 / 6 / 3, 50 / 7 / 2, 2 / 8 / 2, 23 / 9 / 3, 48 / 10 / 2, 73 / 11 / 2, 51 / 12 / 2, 69 / 13 / 2, 43 / 14 / 2, 62 / 15 / 5, 58 / 16 / 2, 32 / 17 / 2, 5 / 18 / 2, 33 / 19 / 4, 41 / 20 / 2, 17 / 21 / 3, 6 / 22 / 2, 4 / 23 / 4, 65 / 24 / 2, 45 / 25 / 2, 72 / 26 / 3, 24 / 27 / 2, 18 / 28 / 2, 34 / 29 / 2, 28 / 30 / 2, 71 / 31 / 4, 13 / 32 / 2, 68 / 33 / 2, 40 / 34 / 3, 60 / 35 / 2, 35 / 36 / 2, 22 / 37 / 2, 54 / 38 / 2, 7 / 39 / 13, 27 / 40 / 2, 21 / 41 / 2, 29 / 42 / 2, 9 / 43 / 3, 20 / 44 / 2, 36 / 45 / 2, 16 / 46 / 2, 66 / 47 / 2, 3 / 48 / 2, 8 / 49 / 2, 31 / 50 / 3, 12 / 51 / 2, 67 / 52 / 3, 42 / 53 / 2, 10 / 54 / 2, 61 / 55 / 2, 63 / 56 / 2, 53 / 57 / 2, 59 / 58 / 3, 44 / 59 / 2, 11 / 60 / 2, 64 / 61 / 2, 15 / 62 / 3, 74 / 63 / 2, 19 / 64 / 2, 14 / 65 / 2, 37 / 66 / 2, 38 / 67 / 3, 26 / 68 / 2, 55 / 69 / 2, 49 / 70 / 3, 1 / 71 / 2, 30 / 72 / 3, 39 / 73 / 2, 25 / 74 / 2
doublecenter-alpha_1-83-n75.txt, 1, 1, 75, 1537.2, 957, 882, 13, 74,5 / 1 / 2, 46 / 2 / 3, 48 / 3 / 2, 23 / 4 / 2, 20 / 5 / 2, 17 / 6 / 3, 1 / 7 / 2, 34 / 8 / 3, 19 / 9 / 2, 13 / 10 / 7, 12 / 11 / 2, 45 / 12 / 3, 4 / 13 / 2, 25 / 14 / 2, 66 / 15 / 2, 55 / 16 / 3, 57 / 17 / 2, 50 / 18 / 2, 41 / 19 / 2, 16 / 20 / 2, 43 / 21 / 4, 33 / 22 / 2, 52 / 23 / 2, 73 / 24 / 2, 36 / 25 / 3, 24 / 26 / 2, 59 / 27 / 2, 74 / 28 / 13, 28 / 29 / 2, 21 / 30 / 2, 64 / 31 / 4, 63 / 32 / 2, 30 / 33 / 2, 7 / 34 / 2, 71 / 35 / 3, 42 / 36 / 2, 22 / 37 / 2, 14 / 38 / 2, 58 / 39 / 2, 60 / 40 / 4, 3 / 41 / 2, 65 / 42 / 2, 44 / 43 / 2, 38 / 44 / 3, 69 / 45 / 2, 2 / 46 / 2, 39 / 47 / 2, 49 / 48 / 2, 31 / 49 / 2, 32 / 50 / 2, 27 / 51 / 2, 47 / 52 / 2, 6 / 53 / 5, 56 / 54 / 2, 8 / 55 / 2, 53 / 56 / 2, 26 / 57 / 4, 68 / 58 / 2, 40 / 59 / 2, 37 / 60 / 2, 35 / 61 / 2, 18 / 62 / 2, 29 / 63 / 2, 72 / 64 / 2, 10 / 65 / 13, 15 / 66 / 2, 51 / 67 / 2, 70 / 68 / 2, 9 / 69 / 2, 61 / 70 / 4, 54 / 71 / 2, 62 / 72 / 2, 11 / 73 / 2, 67 / 74 / 5
doublecenter-alpha_1-84-n75.txt, 1, 1, 75, 1949.6, 550, 475, 7, 74,36 / 1 / 2, 10 / 2 / 2, 56 / 3 / 2, 55 / 4 / 3, 47 / 5 / 2, 1 / 6 / 2, 14 / 7 / 2, 41 / 8 / 3, 60 / 9 / 2, 46 / 10 / 3, 42 / 11 / 2, 29 / 12 / 3, 35 / 13 / 2, 52 / 14 / 2, 24 / 15 / 2, 12 / 16 / 6, 71 / 17 / 2, 70 / 18 / 2, 53 / 19 / 2, 32 / 20 / 2, 54 / 21 / 7, 69 / 22 / 2, 20 / 23 / 2, 33 / 24 / 2, 57 / 25 / 3, 61 / 26 / 2, 45 / 27 / 3, 44 / 28 / 2, 25 / 29 / 2, 30 / 30 / 2, 13 / 31 / 3, 6 / 32 / 2, 63 / 33 / 2, 28 / 34 / 2, 66 / 35 / 3, 64 / 36 / 2, 73 / 37 / 2, 26 / 38 / 2, 50 / 39 / 2, 5 / 40 / 2, 16 / 41 / 2, 23 / 42 / 3, 48 / 43 / 2, 19 / 44 / 2, 22 / 45 / 2, 67 / 46 / 2, 9 / 47 / 2, 17 / 48 / 2, 27 / 49 / 3, 39 / 50 / 2, 58 / 51 / 3, 31 / 52 / 2, 8 / 53 / 2, 40 / 54 / 2, 38 / 55 / 2, 62 / 56 / 2, 7 / 57 / 2, 18 / 58 / 3, 68 / 59 / 2, 21 / 60 / 2, 11 / 61 / 2, 72 / 62 / 4, 59 / 63 / 2, 49 / 64 / 2, 34 / 65 / 3, 65 / 66 / 2, 2 / 67 / 2, 3 / 68 / 6, 15 / 69 / 2, 4 / 70 / 3, 43 / 71 / 2, 51 / 72 / 2, 37 / 73 / 6, 74 / 74 / 2
doublecenter-alpha_1-85-n75.txt, 1, 1, 75, 1964.89, 618, 543, 6, 74,30 / 1 / 2, 31 / 2 / 2, 14 / 3 / 2, 72 / 4 / 2, 56 / 5 / 2, 27 / 6 / 2, 11 / 7 / 3, 20 / 8 / 2, 38 / 9 / 3, 66 / 10 / 2, 40 / 11 / 2, 49 / 12 / 2, 16 / 13 / 3, 51 / 14 / 2, 21 / 15 / 2, 25 / 16 / 3, 5 / 17 / 2, 63 / 18 / 2, 29 / 19 / 4, 67 / 20 / 2, 65 / 21 / 2, 60 / 22 / 2, 26 / 23 / 2, 2 / 24 / 5, 61 / 25 / 2, 12 / 26 / 2, 6 / 27 / 4, 47 / 28 / 2, 3 / 29 / 2, 37 / 30 / 3, 33 / 31 / 2, 70 / 32 / 2, 69 / 33 / 3, 9 / 34 / 2, 34 / 35 / 5, 22 / 36 / 2, 32 / 37 / 2, 68 / 38 / 2, 18 / 39 / 2, 24 / 40 / 2, 36 / 41 / 2, 52 / 42 / 2, 17 / 43 / 4, 28 / 44 / 2, 7 / 45 / 2, 4 / 46 / 2, 57 / 47 / 2, 48 / 48 / 2, 41 / 49 / 3, 59 / 50 / 2, 45 / 51 / 3, 55 / 52 / 2, 15 / 53 / 2, 42 / 54 / 4, 74 / 55 / 2, 39 / 56 / 2, 64 / 57 / 4, 53 / 58 / 2, 62 / 59 / 2, 1 / 60 / 2, 13 / 61 / 2, 8 / 62 / 2, 54 / 63 / 2, 10 / 64 / 2, 44 / 65 / 2, 50 / 66 / 2, 35 / 67 / 3, 73 / 68 / 2, 19 / 69 / 6, 43 / 70 / 2, 58 / 71 / 3, 71 / 72 / 2, 46 / 73 / 2, 23 / 74 / 6
doublecenter-alpha_1-86-n75.txt, 1, 1, 75, 1559.88, 646, 571, 10, 74,26 / 1 / 3, 71 / 2 / 2, 18 / 3 / 3, 13 / 4 / 2, 33 / 5 / 2, 12 / 6 / 2, 59 / 7 / 6, 10 / 8 / 2, 42 / 9 / 2, 46 / 10 / 2, 66 / 11 / 2, 16 / 12 / 2, 68 / 13 / 3, 50 / 14 / 2, 44 / 15 / 2, 23 / 16 / 3, 62 / 17 / 2, 48 / 18 / 2, 30 / 19 / 3, 15 / 20 / 2, 63 / 21 / 5, 74 / 22 / 2, 34 / 23 / 3, 20 / 24 / 2, 36 / 25 / 2, 27 / 26 / 2, 58 / 27 / 6, 64 / 28 / 2, 52 / 29 / 3, 60 / 30 / 2, 45 / 31 / 2, 24 / 32 / 2, 7 / 33 / 2, 29 / 34 / 5, 47 / 35 / 2, 73 / 36 / 3, 70 / 37 / 2, 14 / 38 / 2, 43 / 39 / 2, 2 / 40 / 2, 72 / 41 / 2, 41 / 42 / 2, 55 / 43 / 2, 4 / 44 / 3, 56 / 45 / 2, 54 / 46 / 2, 69 / 47 / 3, 19 / 48 / 2, 8 / 49 / 3, 5 / 50 / 2, 6 / 51 / 2, 1 / 52 / 2, 61 / 53 / 2, 22 / 54 / 3, 21 / 55 / 2, 3 / 56 / 2, 51 / 57 / 4, 38 / 58 / 2, 57 / 59 / 2, 65 / 60 / 2, 37 / 61 / 3, 32 / 62 / 2, 39 / 63 / 2, 9 / 64 / 2, 25 / 65 / 3, 28 / 66 / 2, 49 / 67 / 3, 67 / 68 / 2, 31 / 69 / 10, 35 / 70 / 2, 53 / 71 / 2, 11 / 72 / 2, 40 / 73 / 2, 17 / 74 / 3
doublecenter-alpha_1-87-n75.txt, 1, 1, 75, 1618.62, 553, 478, 5, 74,7 / 1 / 3, 72 / 2 / 2, 2 / 3 / 3, 67 / 4 / 2, 49 / 5 / 3, 73 / 6 / 2, 50 / 7 / 2, 29 / 8 / 3, 21 / 9 / 2, 16 / 10 / 3, 26 / 11 / 2, 45 / 12 / 3, 15 / 13 / 2, 14 / 14 / 3, 57 / 15 / 2, 33 / 16 / 2, 59 / 17 / 3, 8 / 18 / 2, 46 / 19 / 2, 22 / 20 / 3, 5 / 21 / 2, 27 / 22 / 3, 34 / 23 / 2, 61 / 24 / 3, 48 / 25 / 2, 19 / 26 / 3, 24 / 27 / 2, 65 / 28 / 2, 39 / 29 / 3, 71 / 30 / 2, 32 / 31 / 3, 17 / 32 / 2, 74 / 33 / 4, 36 / 34 / 2, 42 / 35 / 2, 13 / 36 / 3, 62 / 37 / 2, 25 / 38 / 3, 6 / 39 / 2, 40 / 40 / 2, 43 / 41 / 5, 11 / 42 / 2, 58 / 43 / 3, 30 / 44 / 2, 69 / 45 / 2, 38 / 46 / 2, 63 / 47 / 2, 68 / 48 / 2, 52 / 49 / 2, 51 / 50 / 2, 4 / 51 / 2, 66 / 52 / 4, 44 / 53 / 2, 37 / 54 / 2, 18 / 55 / 3, 3 / 56 / 2, 10 / 57 / 3, 35 / 58 / 2, 47 / 59 / 3, 56 / 60 / 2, 23 / 61 / 2, 1 / 62 / 2, 31 / 63 / 2, 9 / 64 / 2, 64 / 65 / 3, 60 / 66 / 2, 12 / 67 / 2, 28 / 68 / 2, 55 / 69 / 2, 70 / 70 / 4, 54 / 71 / 2, 53 / 72 / 2, 20 / 73 / 3, 41 / 74 / 2
doublecenter-alpha_1-88-n75.txt, 1, 1, 75, 2044.71, 630, 555, 6, 74,19 / 1 / 3, 20 / 2 / 2, 33 / 3 / 2, 73 / 4 / 4, 64 / 5 / 2, 71 / 6 / 2, 47 / 7 / 2, 61 / 8 / 2, 44 / 9 / 3, 62 / 10 / 2, 5 / 11 / 3, 56 / 12 / 2, 66 / 13 / 2, 29 / 14 / 2, 72 / 15 / 2, 58 / 16 / 2, 9 / 17 / 3, 32 / 18 / 2, 54 / 19 / 3, 50 / 20 / 2, 43 / 21 / 3, 51 / 22 / 2, 37 / 23 / 5, 63 / 24 / 2, 35 / 25 / 2, 27 / 26 / 2, 26 / 27 / 2, 59 / 28 / 4, 68 / 29 / 2, 34 / 30 / 2, 46 / 31 / 4, 48 / 32 / 2, 40 / 33 / 2, 13 / 34 / 2, 55 / 35 / 2, 12 / 36 / 2, 49 / 37 / 2, 25 / 38 / 2, 8 / 39 / 2, 36 / 40 / 2, 14 / 41 / 3, 39 / 42 / 2, 38 / 43 / 3, 28 / 44 / 2, 11 / 45 / 2, 23 / 46 / 2, 2 / 47 / 2, 24 / 48 / 2, 6 / 49 / 2, 18 / 50 / 2, 67 / 51 / 4, 52 / 52 / 2, 10 / 53 / 2, 70 / 54 / 3, 60 / 55 / 2, 53 / 56 / 6, 45 / 57 / 2, 4 / 58 / 2, 17 / 59 / 2, 69 / 60 / 2, 21 / 61 / 3, 15 / 62 / 2, 57 / 63 / 2, 16 / 64 / 6, 65 / 65 / 2, 1 / 66 / 2, 22 / 67 / 2, 31 / 68 / 5, 41 / 69 / 2, 30 / 70 / 3, 7 / 71 / 2, 42 / 72 / 2, 3 / 73 / 2, 74 / 74 / 4
doublecenter-alpha_1-89-n75.txt, 1, 1, 75, 1836.91, 551, 476, 5, 74,74 / 1 / 3, 9 / 2 / 2, 56 / 3 / 2, 28 / 4 / 3, 7 / 5 / 2, 51 / 6 / 3, 67 / 7 / 2, 18 / 8 / 2, 35 / 9 / 2, 43 / 10 / 3, 16 / 11 / 2, 10 / 12 / 3, 45 / 13 / 2, 73 / 14 / 2, 1 / 15 / 3, 53 / 16 / 2, 22 / 17 / 2, 14 / 18 / 2, 32 / 19 / 3, 55 / 20 / 2, 66 / 21 / 3, 49 / 22 / 2, 6 / 23 / 3, 15 / 24 / 2, 27 / 25 / 2, 50 / 26 / 2, 29 / 27 / 2, 23 / 28 / 2, 52 / 29 / 2, 31 / 30 / 2, 58 / 31 / 2, 39 / 32 / 2, 57 / 33 / 2, 37 / 34 / 2, 17 / 35 / 2, 5 / 36 / 2, 68 / 37 / 2, 60 / 38 / 2, 48 / 39 / 2, 19 / 40 / 2, 40 / 41 / 2, 13 / 42 / 2, 70 / 43 / 2, 59 / 44 / 4, 20 / 45 / 2, 42 / 46 / 2, 62 / 47 / 2, 25 / 48 / 5, 63 / 49 / 2, 46 / 50 / 2, 33 / 51 / 2, 44 / 52 / 2, 30 / 53 / 2, 24 / 54 / 2, 64 / 55 / 2, 26 / 56 / 2, 41 / 57 / 2, 21 / 58 / 2, 36 / 59 / 2, 69 / 60 / 2, 61 / 61 / 3, 65 / 62 / 2, 4 / 63 / 3, 71 / 64 / 2, 38 / 65 / 2, 3 / 66 / 2, 11 / 67 / 3, 47 / 68 / 2, 72 / 69 / 3, 12 / 70 / 2, 34 / 71 / 2, 8 / 72 / 3, 2 / 73 / 2, 54 / 74 / 3
doublecenter-alpha_1-9-n250.txt, 1, 1, 250, 3311.07, 2200, 1950, 11, 249,93 / 1 / 3, 159 / 2 / 2, 245 / 3 / 2, 79 / 4 / 2, 109 / 5 / 5, 41 / 6 / 2, 224 / 7 / 3, 248 / 8 / 2, 54 / 9 / 3, 20 / 10 / 2, 82 / 11 / 3, 178 / 12 / 2, 132 / 13 / 2, 210 / 14 / 2, 236 / 15 / 5, 233 / 16 / 2, 140 / 17 / 3, 222 / 18 / 2, 53 / 19 / 4, 193 / 20 / 2, 136 / 21 / 2, 16 / 22 / 2, 24 / 23 / 2, 156 / 24 / 2, 188 / 25 / 4, 18 / 26 / 2, 48 / 27 / 2, 70 / 28 / 3, 13 / 29 / 2, 116 / 30 / 3, 225 / 31 / 2, 227 / 32 / 3, 90 / 33 / 2, 244 / 34 / 3, 36 / 35 / 2, 176 / 36 / 2, 247 / 37 / 2, 160 / 38 / 11, 81 / 39 / 2, 10 / 40 / 2, 182 / 41 / 2, 183 / 42 / 2, 229 / 43 / 2, 154 / 44 / 3, 34 / 45 / 2, 51 / 46 / 2, 21 / 47 / 4, 168 / 48 / 2, 145 / 49 / 2, 149 / 50 / 2, 113 / 51 / 2, 35 / 52 / 5, 219 / 53 / 2, 226 / 54 / 2, 240 / 55 / 2, 235 / 56 / 2, 52 / 57 / 2, 99 / 58 / 2, 77 / 59 / 2, 166 / 60 / 3, 56 / 61 / 2, 118 / 62 / 2, 129 / 63 / 2, 161 / 64 / 2, 198 / 65 / 2, 239 / 66 / 3, 205 / 67 / 2, 157 / 68 / 3, 242 / 69 / 2, 207 / 70 / 2, 164 / 71 / 3, 135 / 72 / 2, 150 / 73 / 4, 92 / 74 / 2, 146 / 75 / 3, 112 / 76 / 2, 204 / 77 / 2, 221 / 78 / 3, 97 / 79 / 2, 76 / 80 / 3, 11 / 81 / 2, 22 / 82 / 3, 126 / 83 / 2, 125 / 84 / 3, 238 / 85 / 2, 89 / 86 / 2, 8 / 87 / 2, 25 / 88 / 4, 122 / 89 / 2, 27 / 90 / 2, 66 / 91 / 3, 106 / 92 / 2, 128 / 93 / 3, 177 / 94 / 2, 80 / 95 / 3, 212 / 96 / 2, 31 / 97 / 3, 78 / 98 / 2, 110 / 99 / 2, 197 / 100 / 4, 94 / 101 / 2, 200 / 102 / 2, 26 / 103 / 2, 158 / 104 / 3, 47 / 105 / 2, 174 / 106 / 2, 5 / 107 / 3, 29 / 108 / 2, 7 / 109 / 2, 96 / 110 / 4, 59 / 111 / 2, 163 / 112 / 3, 170 / 113 / 2, 69 / 114 / 3, 23 / 115 / 2, 195 / 116 / 2, 55 / 117 / 3, 120 / 118 / 2, 206 / 119 / 3, 216 / 120 / 2, 12 / 121 / 2, 6 / 122 / 2, 141 / 123 / 4, 121 / 124 / 2, 14 / 125 / 2, 232 / 126 / 6, 104 / 127 / 2, 123 / 128 / 2, 181 / 129 / 2, 165 / 130 / 3, 143 / 131 / 2, 43 / 132 / 3, 142 / 133 / 2, 9 / 134 / 2, 62 / 135 / 2, 65 / 136 / 2, 60 / 137 / 3, 85 / 138 / 2, 191 / 139 / 2, 218 / 140 / 2, 185 / 141 / 2, 107 / 142 / 6, 33 / 143 / 2, 131 / 144 / 2, 32 / 145 / 2, 15 / 146 / 2, 180 / 147 / 2, 71 / 148 / 2, 228 / 149 / 3, 237 / 150 / 2, 215 / 151 / 2, 190 / 152 / 3, 46 / 153 / 2, 95 / 154 / 2, 199 / 155 / 2, 124 / 156 / 4, 44 / 157 / 2, 30 / 158 / 3, 167 / 159 / 2, 196 / 160 / 5, 73 / 161 / 2, 105 / 162 / 2, 144 / 163 / 2, 230 / 164 / 3, 171 / 165 / 2, 217 / 166 / 5, 1 / 167 / 2, 61 / 168 / 3, 17 / 169 / 2, 187 / 170 / 2, 130 / 171 / 3, 115 / 172 / 2, 103 / 173 / 2, 57 / 174 / 2, 134 / 175 / 2, 49 / 176 / 5, 42 / 177 / 2, 84 / 178 / 2, 72 / 179 / 3, 186 / 180 / 2, 175 / 181 / 2, 148 / 182 / 3, 74 / 183 / 2, 231 / 184 / 4, 155 / 185 / 2, 45 / 186 / 2, 246 / 187 / 2, 214 / 188 / 3, 91 / 189 / 2, 137 / 190 / 4, 201 / 191 / 2, 87 / 192 / 2, 234 / 193 / 4, 203 / 194 / 2, 184 / 195 / 2, 63 / 196 / 3, 108 / 197 / 2, 75 / 198 / 3, 172 / 199 / 2, 127 / 200 / 3, 152 / 201 / 2, 189 / 202 / 4, 162 / 203 / 2, 211 / 204 / 3, 119 / 205 / 2, 58 / 206 / 2, 153 / 207 / 3, 86 / 208 / 2, 179 / 209 / 2, 111 / 210 / 8, 39 / 211 / 2, 151 / 212 / 2, 139 / 213 / 2, 28 / 214 / 4, 169 / 215 / 2, 208 / 216 / 2, 173 / 217 / 3, 88 / 218 / 2, 249 / 219 / 2, 3 / 220 / 2, 102 / 221 / 3, 68 / 222 / 2, 202 / 223 / 3, 133 / 224 / 2, 147 / 225 / 2, 192 / 226 / 3, 67 / 227 / 2, 243 / 228 / 3, 100 / 229 / 2, 117 / 230 / 3, 37 / 231 / 2, 209 / 232 / 2, 4 / 233 / 3, 101 / 234 / 2, 38 / 235 / 2, 40 / 236 / 2, 64 / 237 / 5, 138 / 238 / 2, 220 / 239 / 2, 83 / 240 / 2, 241 / 241 / 3, 50 / 242 / 2, 194 / 243 / 3, 19 / 244 / 2, 2 / 245 / 2, 213 / 246 / 2, 223 / 247 / 3, 98 / 248 / 2, 114 / 249 / 3
doublecenter-alpha_1-9-n5.txt, 1, 1, 5, 617.658, 18, 13, 5, 4,4 / 1 / 2, 1 / 2 / 2, 2 / 3 / 5, 3 / 4 / 2
doublecenter-alpha_1-9-n500.txt, 1, 1, 500, 4504.42, 3998, 3498, 8, 499,39 / 1 / 4, 254 / 2 / 2, 400 / 3 / 2, 432 / 4 / 3, 99 / 5 / 2, 64 / 6 / 3, 402 / 7 / 2, 177 / 8 / 3, 144 / 9 / 2, 460 / 10 / 3, 203 / 11 / 2, 496 / 12 / 3, 281 / 13 / 2, 456 / 14 / 2, 152 / 15 / 2, 174 / 16 / 6, 147 / 17 / 2, 372 / 18 / 2, 36 / 19 / 2, 261 / 20 / 2, 289 / 21 / 2, 130 / 22 / 3, 133 / 23 / 2, 178 / 24 / 2, 8 / 25 / 3, 246 / 26 / 2, 37 / 27 / 3, 201 / 28 / 2, 396 / 29 / 2, 196 / 30 / 3, 287 / 31 / 2, 323 / 32 / 3, 29 / 33 / 2, 57 / 34 / 2, 96 / 35 / 2, 270 / 36 / 3, 155 / 37 / 2, 231 / 38 / 3, 482 / 39 / 2, 233 / 40 / 2, 88 / 41 / 2, 373 / 42 / 3, 5 / 43 / 2, 154 / 44 / 3, 238 / 45 / 2, 321 / 46 / 3, 250 / 47 / 2, 81 / 48 / 2, 283 / 49 / 4, 108 / 50 / 2, 199 / 51 / 2, 153 / 52 / 2, 6 / 53 / 2, 477 / 54 / 2, 397 / 55 / 2, 333 / 56 / 2, 435 / 57 / 3, 94 / 58 / 2, 366 / 59 / 2, 112 / 60 / 2, 190 / 61 / 3, 365 / 62 / 2, 465 / 63 / 2, 277 / 64 / 4, 324 / 65 / 2, 44 / 66 / 2, 273 / 67 / 4, 212 / 68 / 2, 498 / 69 / 2, 113 / 70 / 2, 2 / 71 / 2, 226 / 72 / 4, 207 / 73 / 2, 268 / 74 / 2, 470 / 75 / 2, 320 / 76 / 3, 239 / 77 / 2, 466 / 78 / 2, 106 / 79 / 2, 391 / 80 / 4, 453 / 81 / 2, 51 / 82 / 2, 339 / 83 / 2, 284 / 84 / 2, 368 / 85 / 2, 26 / 86 / 4, 256 / 87 / 2, 335 / 88 / 2, 487 / 89 / 2, 313 / 90 / 2, 27 / 91 / 5, 416 / 92 / 2, 86 / 93 / 2, 134 / 94 / 2, 68 / 95 / 5, 345 / 96 / 2, 299 / 97 / 2, 443 / 98 / 2, 468 / 99 / 2, 475 / 100 / 5, 55 / 101 / 2, 97 / 102 / 2, 82 / 103 / 2, 452 / 104 / 2, 282 / 105 / 2, 479 / 106 / 2, 411 / 107 / 2, 445 / 108 / 2, 344 / 109 / 2, 379 / 110 / 2, 12 / 111 / 2, 116 / 112 / 2, 473 / 113 / 2, 225 / 114 / 2, 440 / 115 / 2, 486 / 116 / 2, 187 / 117 / 2, 91 / 118 / 8, 151 / 119 / 2, 488 / 120 / 2, 45 / 121 / 2, 148 / 122 / 4, 266 / 123 / 2, 327 / 124 / 3, 217 / 125 / 2, 21 / 126 / 3, 7 / 127 / 2, 341 / 128 / 2, 348 / 129 / 4, 176 / 130 / 2, 54 / 131 / 2, 262 / 132 / 4, 383 / 133 / 2, 87 / 134 / 2, 58 / 135 / 2, 267 / 136 / 2, 437 / 137 / 2, 394 / 138 / 2, 288 / 139 / 4, 206 / 140 / 2, 222 / 141 / 3, 139 / 142 / 2, 343 / 143 / 2, 446 / 144 / 2, 17 / 145 / 2, 331 / 146 / 3, 195 / 147 / 2, 49 / 148 / 2, 412 / 149 / 3, 109 / 150 / 2, 124 / 151 / 3, 38 / 152 / 2, 275 / 153 / 8, 189 / 154 / 2, 223 / 155 / 2, 93 / 156 / 2, 377 / 157 / 2, 251 / 158 / 2, 156 / 159 / 3, 312 / 160 / 2, 424 / 161 / 3, 406 / 162 / 2, 216 / 163 / 3, 179 / 164 / 2, 167 / 165 / 2, 285 / 166 / 2, 117 / 167 / 3, 290 / 168 / 2, 243 / 169 / 2, 355 / 170 / 3, 427 / 171 / 2, 325 / 172 / 2, 182 / 173 / 2, 53 / 174 / 2, 306 / 175 / 2, 311 / 176 / 2, 180 / 177 / 4, 20 / 178 / 2, 24 / 179 / 2, 419 / 180 / 3, 73 / 181 / 2, 423 / 182 / 3, 286 / 183 / 2, 209 / 184 / 2, 303 / 185 / 2, 451 / 186 / 2, 204 / 187 / 2, 31 / 188 / 2, 1 / 189 / 2, 188 / 190 / 4, 41 / 191 / 2, 491 / 192 / 2, 352 / 193 / 2, 449 / 194 / 2, 75 / 195 / 2, 429 / 196 / 2, 297 / 197 / 2, 220 / 198 / 2, 162 / 199 / 3, 398 / 200 / 2, 378 / 201 / 3, 434 / 202 / 2, 338 / 203 / 3, 414 / 204 / 2, 120 / 205 / 2, 467 / 206 / 3, 165 / 207 / 2, 107 / 208 / 2, 127 / 209 / 3, 244 / 210 / 2, 181 / 211 / 3, 298 / 212 / 2, 415 / 213 / 2, 461 / 214 / 3, 146 / 215 / 2, 271 / 216 / 3, 442 / 217 / 2, 362 / 218 / 2, 40 / 219 / 3, 353 / 220 / 2, 115 / 221 / 2, 489 / 222 / 2, 235 / 223 / 3, 309 / 224 / 2, 166 / 225 / 2, 48 / 226 / 2, 340 / 227 / 2, 224 / 228 / 2, 367 / 229 / 6, 469 / 230 / 2, 4 / 231 / 2, 95 / 232 / 3, 457 / 233 / 2, 25 / 234 / 2, 304 / 235 / 3, 136 / 236 / 2, 101 / 237 / 2, 351 / 238 / 2, 328 / 239 / 2, 278 / 240 / 2, 252 / 241 / 2, 232 / 242 / 2, 257 / 243 / 2, 110 / 244 / 2, 79 / 245 / 2, 310 / 246 / 2, 194 / 247 / 2, 354 / 248 / 2, 175 / 249 / 6, 279 / 250 / 2, 105 / 251 / 3, 19 / 252 / 2, 218 / 253 / 2, 42 / 254 / 2, 386 / 255 / 2, 405 / 256 / 2, 360 / 257 / 2, 369 / 258 / 2, 480 / 259 / 2, 28 / 260 / 2, 74 / 261 / 2, 490 / 262 / 4, 409 / 263 / 2, 494 / 264 / 2, 280 / 265 / 2, 319 / 266 / 3, 14 / 267 / 2, 163 / 268 / 3, 444 / 269 / 2, 301 / 270 / 3, 450 / 271 / 2, 413 / 272 / 3, 138 / 273 / 2, 229 / 274 / 3, 458 / 275 / 2, 132 / 276 / 3, 484 / 277 / 2, 33 / 278 / 3, 23 / 279 / 2, 438 / 280 / 3, 145 / 281 / 2, 472 / 282 / 3, 228 / 283 / 2, 193 / 284 / 4, 253 / 285 / 2, 381 / 286 / 2, 200 / 287 / 3, 191 / 288 / 2, 431 / 289 / 3, 407 / 290 / 2, 141 / 291 / 4, 350 / 292 / 2, 80 / 293 / 2, 493 / 294 / 4, 76 / 295 / 2, 454 / 296 / 2, 234 / 297 / 2, 230 / 298 / 2, 168 / 299 / 2, 389 / 300 / 2, 347 / 301 / 4, 63 / 302 / 2, 84 / 303 / 2, 455 / 304 / 2, 236 / 305 / 2, 329 / 306 / 2, 16 / 307 / 2, 9 / 308 / 3, 447 / 309 / 2, 291 / 310 / 2, 417 / 311 / 3, 399 / 312 / 2, 388 / 313 / 3, 272 / 314 / 2, 170 / 315 / 2, 359 / 316 / 2, 485 / 317 / 2, 248 / 318 / 2, 483 / 319 / 3, 227 / 320 / 2, 315 / 321 / 2, 459 / 322 / 3, 474 / 323 / 2, 382 / 324 / 2, 421 / 325 / 3, 317 / 326 / 2, 463 / 327 / 2, 202 / 328 / 2, 361 / 329 / 3, 337 / 330 / 2, 83 / 331 / 2, 197 / 332 / 4, 69 / 333 / 2, 332 / 334 / 2, 392 / 335 / 4, 66 / 336 / 2, 118 / 337 / 2, 385 / 338 / 2, 448 / 339 / 2, 370 / 340 / 2, 241 / 341 / 2, 185 / 342 / 3, 464 / 343 / 2, 186 / 344 / 2, 102 / 345 / 2, 418 / 346 / 2, 52 / 347 / 2, 59 / 348 / 2, 314 / 349 / 3, 294 / 350 / 2, 129 / 351 / 3, 131 / 352 / 2, 71 / 353 / 3, 122 / 354 / 2, 245 / 355 / 3, 11 / 356 / 2, 169 / 357 / 3, 292 / 358 / 2, 358 / 359 / 2, 295 / 360 / 2, 305 / 361 / 2, 143 / 362 / 3, 422 / 363 / 2, 192 / 364 / 2, 126 / 365 / 2, 375 / 366 / 3, 308 / 367 / 2, 211 / 368 / 3, 260 / 369 / 2, 497 / 370 / 2, 184 / 371 / 2, 363 / 372 / 4, 384 / 373 / 2, 43 / 374 / 2, 61 / 375 / 3, 481 / 376 / 2, 255 / 377 / 2, 172 / 378 / 2, 140 / 379 / 2, 242 / 380 / 2, 249 / 381 / 2, 104 / 382 / 2, 142 / 383 / 2, 85 / 384 / 2, 356 / 385 / 2, 401 / 386 / 2, 380 / 387 / 2, 67 / 388 / 4, 371 / 389 / 2, 349 / 390 / 2, 433 / 391 / 3, 198 / 392 / 2, 15 / 393 / 4, 441 / 394 / 2, 219 / 395 / 2, 77 / 396 / 3, 374 / 397 / 2, 492 / 398 / 2, 326 / 399 / 5, 150 / 400 / 2, 364 / 401 / 2, 376 / 402 / 2, 395 / 403 / 2, 135 / 404 / 3, 302 / 405 / 2, 420 / 406 / 2, 34 / 407 / 7, 258 / 408 / 2, 264 / 409 / 2, 425 / 410 / 3, 259 / 411 / 2, 50 / 412 / 2, 157 / 413 / 3, 173 / 414 / 2, 342 / 415 / 2, 90 / 416 / 2, 100 / 417 / 2, 183 / 418 / 2, 428 / 419 / 2, 318 / 420 / 2, 336 / 421 / 2, 471 / 422 / 3, 72 / 423 / 2, 210 / 424 / 2, 237 / 425 / 2, 158 / 426 / 2, 330 / 427 / 3, 137 / 428 / 2, 78 / 429 / 2, 316 / 430 / 4, 46 / 431 / 2, 161 / 432 / 2, 221 / 433 / 2, 307 / 434 / 4, 98 / 435 / 2, 164 / 436 / 2, 462 / 437 / 4, 408 / 438 / 2, 346 / 439 / 2, 334 / 440 / 2, 18 / 441 / 2, 215 / 442 / 3, 404 / 443 / 2, 439 / 444 / 3, 247 / 445 / 2, 3 / 446 / 2, 56 / 447 / 3, 276 / 448 / 2, 322 / 449 / 2, 89 / 450 / 3, 263 / 451 / 2, 32 / 452 / 2, 300 / 453 / 2, 499 / 454 / 3, 387 / 455 / 2, 125 / 456 / 2, 111 / 457 / 3, 296 / 458 / 2, 10 / 459 / 3, 214 / 460 / 2, 62 / 461 / 3, 213 / 462 / 2, 92 / 463 / 3, 265 / 464 / 2, 426 / 465 / 2, 13 / 466 / 3, 403 / 467 / 2, 121 / 468 / 2, 274 / 469 / 3, 114 / 470 / 2, 123 / 471 / 7, 390 / 472 / 2, 476 / 473 / 2, 149 / 474 / 2, 30 / 475 / 4, 171 / 476 / 2, 240 / 477 / 2, 119 / 478 / 2, 393 / 479 / 2, 478 / 480 / 2, 35 / 481 / 3, 22 / 482 / 2, 293 / 483 / 3, 269 / 484 / 2, 208 / 485 / 2, 128 / 486 / 3, 205 / 487 / 2, 495 / 488 / 3, 65 / 489 / 2, 410 / 490 / 2, 430 / 491 / 2, 436 / 492 / 5, 160 / 493 / 2, 60 / 494 / 2, 159 / 495 / 3, 103 / 496 / 2, 70 / 497 / 2, 357 / 498 / 2, 47 / 499 / 6
doublecenter-alpha_1-90-n75.txt, 1, 1, 75, 1564.06, 649, 574, 6, 74,9 / 1 / 2, 1 / 2 / 3, 35 / 3 / 2, 49 / 4 / 3, 31 / 5 / 2, 6 / 6 / 2, 18 / 7 / 2, 72 / 8 / 2, 3 / 9 / 4, 24 / 10 / 2, 67 / 11 / 2, 39 / 12 / 2, 44 / 13 / 2, 60 / 14 / 2, 29 / 15 / 2, 46 / 16 / 3, 12 / 17 / 2, 53 / 18 / 2, 52 / 19 / 2, 34 / 20 / 2, 32 / 21 / 5, 10 / 22 / 2, 19 / 23 / 2, 20 / 24 / 4, 43 / 25 / 2, 65 / 26 / 2, 5 / 27 / 3, 36 / 28 / 2, 21 / 29 / 2, 69 / 30 / 2, 4 / 31 / 2, 55 / 32 / 2, 23 / 33 / 2, 40 / 34 / 2, 45 / 35 / 3, 30 / 36 / 2, 38 / 37 / 2, 66 / 38 / 3, 57 / 39 / 2, 56 / 40 / 3, 41 / 41 / 2, 15 / 42 / 2, 62 / 43 / 5, 73 / 44 / 2, 42 / 45 / 2, 14 / 46 / 2, 59 / 47 / 2, 58 / 48 / 2, 26 / 49 / 4, 54 / 50 / 2, 70 / 51 / 2, 64 / 52 / 4, 8 / 53 / 2, 28 / 54 / 3, 74 / 55 / 2, 63 / 56 / 2, 27 / 57 / 6, 22 / 58 / 2, 16 / 59 / 3, 48 / 60 / 2, 71 / 61 / 3, 13 / 62 / 2, 17 / 63 / 3, 47 / 64 / 2, 61 / 65 / 2, 33 / 66 / 2, 37 / 67 / 2, 25 / 68 / 3, 7 / 69 / 2, 51 / 70 / 2, 68 / 71 / 2, 50 / 72 / 3, 2 / 73 / 2, 11 / 74 / 2
doublecenter-alpha_1-91-n100.txt, 1, 1, 100, 1826.87, 821, 721, 9, 99,49 / 1 / 4, 21 / 2 / 2, 10 / 3 / 2, 47 / 4 / 2, 12 / 5 / 4, 57 / 6 / 2, 58 / 7 / 2, 83 / 8 / 4, 78 / 9 / 2, 33 / 10 / 2, 15 / 11 / 3, 5 / 12 / 2, 65 / 13 / 2, 98 / 14 / 2, 68 / 15 / 3, 77 / 16 / 2, 76 / 17 / 9, 53 / 18 / 2, 82 / 19 / 2, 29 / 20 / 3, 91 / 21 / 2, 52 / 22 / 3, 62 / 23 / 2, 60 / 24 / 3, 37 / 25 / 2, 92 / 26 / 2, 25 / 27 / 3, 11 / 28 / 2, 94 / 29 / 2, 90 / 30 / 2, 86 / 31 / 3, 93 / 32 / 2, 34 / 33 / 2, 24 / 34 / 3, 13 / 35 / 2, 48 / 36 / 2, 80 / 37 / 2, 4 / 38 / 2, 67 / 39 / 2, 27 / 40 / 3, 70 / 41 / 2, 17 / 42 / 2, 39 / 43 / 2, 36 / 44 / 2, 40 / 45 / 4, 51 / 46 / 2, 45 / 47 / 2, 95 / 48 / 4, 41 / 49 / 2, 26 / 50 / 2, 99 / 51 / 5, 1 / 52 / 2, 38 / 53 / 2, 31 / 54 / 3, 69 / 55 / 2, 55 / 56 / 6, 85 / 57 / 2, 97 / 58 / 2, 14 / 59 / 2, 2 / 60 / 2, 64 / 61 / 2, 42 / 62 / 3, 22 / 63 / 2, 3 / 64 / 3, 71 / 65 / 2, 23 / 66 / 2, 18 / 67 / 2, 61 / 68 / 2, 73 / 69 / 3, 79 / 70 / 2, 74 / 71 / 4, 81 / 72 / 2, 43 / 73 / 2, 6 / 74 / 3, 28 / 75 / 2, 75 / 76 / 2, 50 / 77 / 3, 8 / 78 / 2, 59 / 79 / 3, 54 / 80 / 2, 72 / 81 / 2, 32 / 82 / 2, 56 / 83 / 2, 19 / 84 / 3, 89 / 85 / 2, 7 / 86 / 2, 30 / 87 / 2, 35 / 88 / 2, 96 / 89 / 2, 84 / 90 / 2, 44 / 91 / 4, 9 / 92 / 2, 87 / 93 / 2, 88 / 94 / 2, 63 / 95 / 2, 16 / 96 / 4, 20 / 97 / 2, 46 / 98 / 2, 66 / 99 / 7
doublecenter-alpha_1-92-n100.txt, 1, 1, 100, 1832.31, 1003, 903, 10, 99,70 / 1 / 2, 80 / 2 / 4, 79 / 3 / 2, 74 / 4 / 2, 46 / 5 / 3, 49 / 6 / 2, 18 / 7 / 3, 16 / 8 / 2, 32 / 9 / 2, 67 / 10 / 3, 29 / 11 / 2, 25 / 12 / 2, 23 / 13 / 2, 35 / 14 / 2, 55 / 15 / 2, 39 / 16 / 4, 59 / 17 / 2, 12 / 18 / 2, 56 / 19 / 3, 2 / 20 / 2, 30 / 21 / 3, 1 / 22 / 2, 81 / 23 / 3, 65 / 24 / 2, 60 / 25 / 3, 6 / 26 / 2, 90 / 27 / 10, 37 / 28 / 2, 84 / 29 / 2, 61 / 30 / 3, 94 / 31 / 2, 85 / 32 / 2, 71 / 33 / 2, 62 / 34 / 6, 5 / 35 / 2, 31 / 36 / 2, 63 / 37 / 2, 88 / 38 / 2, 97 / 39 / 3, 93 / 40 / 2, 50 / 41 / 3, 26 / 42 / 2, 57 / 43 / 2, 20 / 44 / 2, 51 / 45 / 3, 77 / 46 / 2, 8 / 47 / 2, 21 / 48 / 5, 73 / 49 / 2, 89 / 50 / 2, 75 / 51 / 3, 92 / 52 / 2, 54 / 53 / 3, 95 / 54 / 2, 40 / 55 / 2, 4 / 56 / 3, 64 / 57 / 2, 11 / 58 / 6, 45 / 59 / 2, 68 / 60 / 3, 10 / 61 / 2, 17 / 62 / 2, 19 / 63 / 3, 38 / 64 / 2, 76 / 65 / 2, 44 / 66 / 3, 66 / 67 / 2, 83 / 68 / 5, 9 / 69 / 2, 99 / 70 / 2, 34 / 71 / 2, 13 / 72 / 3, 72 / 73 / 2, 7 / 74 / 4, 96 / 75 / 2, 58 / 76 / 2, 98 / 77 / 4, 52 / 78 / 2, 28 / 79 / 2, 69 / 80 / 2, 24 / 81 / 2, 33 / 82 / 2, 41 / 83 / 3, 22 / 84 / 2, 86 / 85 / 2, 43 / 86 / 2, 15 / 87 / 2, 14 / 88 / 2, 47 / 89 / 2, 87 / 90 / 2, 36 / 91 / 2, 42 / 92 / 4, 78 / 93 / 2, 82 / 94 / 2, 91 / 95 / 3, 3 / 96 / 2, 53 / 97 / 3, 27 / 98 / 2, 48 / 99 / 5
doublecenter-alpha_1-93-n100.txt, 1, 1, 100, 1740.49, 943, 843, 10, 99,92 / 1 / 3, 45 / 2 / 2, 72 / 3 / 3, 56 / 4 / 2, 38 / 5 / 2, 95 / 6 / 4, 32 / 7 / 2, 21 / 8 / 2, 65 / 9 / 5, 30 / 10 / 2, 37 / 11 / 3, 46 / 12 / 2, 14 / 13 / 2, 13 / 14 / 3, 22 / 15 / 2, 96 / 16 / 2, 58 / 17 / 4, 86 / 18 / 2, 40 / 19 / 2, 12 / 20 / 4, 79 / 21 / 2, 15 / 22 / 2, 67 / 23 / 2, 62 / 24 / 3, 59 / 25 / 2, 97 / 26 / 2, 28 / 27 / 2, 50 / 28 / 2, 5 / 29 / 3, 85 / 30 / 2, 53 / 31 / 3, 25 / 32 / 2, 31 / 33 / 2, 78 / 34 / 2, 17 / 35 / 4, 29 / 36 / 2, 94 / 37 / 2, 10 / 38 / 3, 71 / 39 / 2, 7 / 40 / 2, 52 / 41 / 2, 89 / 42 / 2, 44 / 43 / 2, 11 / 44 / 2, 54 / 45 / 5, 20 / 46 / 2, 18 / 47 / 2, 41 / 48 / 2, 35 / 49 / 2, 75 / 50 / 10, 36 / 51 / 2, 66 / 52 / 3, 51 / 53 / 2, 61 / 54 / 2, 26 / 55 / 2, 9 / 56 / 2, 99 / 57 / 2, 33 / 58 / 2, 1 / 59 / 3, 48 / 60 / 2, 70 / 61 / 3, 84 / 62 / 2, 6 / 63 / 2, 16 / 64 / 2, 55 / 65 / 2, 98 / 66 / 7, 93 / 67 / 2, 83 / 68 / 2, 49 / 69 / 3, 34 / 70 / 2, 3 / 71 / 4, 64 / 72 / 2, 8 / 73 / 2, 63 / 74 / 2, 82 / 75 / 3, 68 / 76 / 2, 47 / 77 / 2, 42 / 78 / 3, 57 / 79 / 2, 43 / 80 / 2, 24 / 81 / 2, 88 / 82 / 5, 87 / 83 / 2, 76 / 84 / 2, 81 / 85 / 3, 60 / 86 / 2, 80 / 87 / 3, 19 / 88 / 2, 69 / 89 / 2, 4 / 90 / 2, 27 / 91 / 3, 2 / 92 / 2, 73 / 93 / 2, 77 / 94 / 2, 39 / 95 / 2, 90 / 96 / 3, 23 / 97 / 2, 91 / 98 / 3, 74 / 99 / 2
doublecenter-alpha_1-94-n100.txt, 1, 1, 100, 1863.07, 790, 690, 6, 99,81 / 1 / 2, 41 / 2 / 4, 36 / 3 / 2, 84 / 4 / 2, 7 / 5 / 4, 20 / 6 / 2, 71 / 7 / 2, 35 / 8 / 2, 19 / 9 / 4, 87 / 10 / 2, 88 / 11 / 2, 40 / 12 / 4, 28 / 13 / 2, 13 / 14 / 2, 82 / 15 / 3, 17 / 16 / 2, 6 / 17 / 3, 37 / 18 / 2, 57 / 19 / 2, 53 / 20 / 2, 15 / 21 / 2, 11 / 22 / 2, 56 / 23 / 4, 97 / 24 / 2, 72 / 25 / 2, 98 / 26 / 2, 22 / 27 / 3, 61 / 28 / 2, 92 / 29 / 2, 93 / 30 / 2, 44 / 31 / 4, 16 / 32 / 2, 96 / 33 / 2, 2 / 34 / 2, 29 / 35 / 2, 68 / 36 / 2, 47 / 37 / 2, 9 / 38 / 3, 48 / 39 / 2, 66 / 40 / 2, 63 / 41 / 2, 43 / 42 / 4, 83 / 43 / 2, 55 / 44 / 2, 60 / 45 / 2, 27 / 46 / 3, 59 / 47 / 2, 32 / 48 / 2, 5 / 49 / 2, 38 / 50 / 2, 95 / 51 / 4, 70 / 52 / 2, 65 / 53 / 2, 79 / 54 / 2, 73 / 55 / 2, 1 / 56 / 2, 12 / 57 / 2, 33 / 58 / 2, 91 / 59 / 4, 77 / 60 / 2, 54 / 61 / 2, 34 / 62 / 6, 4 / 63 / 2, 26 / 64 / 3, 76 / 65 / 2, 31 / 66 / 2, 42 / 67 / 2, 58 / 68 / 2, 24 / 69 / 6, 94 / 70 / 2, 90 / 71 / 2, 74 / 72 / 2, 80 / 73 / 2, 23 / 74 / 4, 21 / 75 / 2, 85 / 76 / 2, 49 / 77 / 4, 86 / 78 / 2, 30 / 79 / 2, 51 / 80 / 4, 67 / 81 / 2, 75 / 82 / 2, 62 / 83 / 3, 45 / 84 / 2, 50 / 85 / 3, 89 / 86 / 2, 52 / 87 / 3, 10 / 88 / 2, 99 / 89 / 3, 78 / 90 / 2, 14 / 91 / 3, 8 / 92 / 2, 39 / 93 / 2, 69 / 94 / 2, 64 / 95 / 2, 46 / 96 / 4, 25 / 97 / 2, 18 / 98 / 2, 3 / 99 / 5
doublecenter-alpha_1-95-n100.txt, 1, 1, 100, 2034.93, 883, 783, 6, 99,45 / 1 / 3, 15 / 2 / 2, 87 / 3 / 3, 32 / 4 / 2, 86 / 5 / 2, 56 / 6 / 3, 71 / 7 / 2, 40 / 8 / 2, 8 / 9 / 2, 42 / 10 / 3, 2 / 11 / 2, 49 / 12 / 2, 18 / 13 / 2, 55 / 14 / 2, 54 / 15 / 4, 6 / 16 / 2, 37 / 17 / 2, 36 / 18 / 3, 43 / 19 / 2, 74 / 20 / 2, 47 / 21 / 2, 92 / 22 / 2, 58 / 23 / 6, 79 / 24 / 2, 95 / 25 / 3, 25 / 26 / 2, 33 / 27 / 5, 53 / 28 / 2, 59 / 29 / 3, 64 / 30 / 2, 94 / 31 / 3, 16 / 32 / 2, 76 / 33 / 2, 65 / 34 / 3, 88 / 35 / 2, 35 / 36 / 2, 10 / 37 / 2, 14 / 38 / 3, 97 / 39 / 2, 17 / 40 / 2, 46 / 41 / 3, 90 / 42 / 2, 30 / 43 / 4, 12 / 44 / 2, 22 / 45 / 2, 77 / 46 / 3, 85 / 47 / 2, 44 / 48 / 5, 29 / 49 / 2, 39 / 50 / 3, 51 / 51 / 2, 7 / 52 / 2, 73 / 53 / 6, 75 / 54 / 2, 41 / 55 / 2, 5 / 56 / 2, 26 / 57 / 2, 19 / 58 / 2, 82 / 59 / 3, 80 / 60 / 2, 52 / 61 / 2, 83 / 62 / 2, 60 / 63 / 4, 3 / 64 / 2, 81 / 65 / 2, 9 / 66 / 2, 67 / 67 / 5, 4 / 68 / 2, 13 / 69 / 3, 78 / 70 / 2, 34 / 71 / 3, 20 / 72 / 2, 99 / 73 / 2, 27 / 74 / 2, 62 / 75 / 2, 63 / 76 / 4, 50 / 77 / 2, 98 / 78 / 2, 57 / 79 / 2, 68 / 80 / 2, 84 / 81 / 2, 28 / 82 / 3, 48 / 83 / 2, 89 / 84 / 2, 38 / 85 / 2, 93 / 86 / 2, 61 / 87 / 2, 72 / 88 / 3, 91 / 89 / 2, 21 / 90 / 3, 70 / 91 / 2, 96 / 92 / 3, 11 / 93 / 2, 23 / 94 / 2, 24 / 95 / 3, 1 / 96 / 2, 66 / 97 / 2, 69 / 98 / 3, 31 / 99 / 2
doublecenter-alpha_1-96-n100.txt, 1, 1, 100, 1995.61, 881, 781, 7, 99,82 / 1 / 3, 17 / 2 / 2, 7 / 3 / 2, 58 / 4 / 3, 92 / 5 / 2, 88 / 6 / 2, 75 / 7 / 3, 12 / 8 / 2, 13 / 9 / 3, 81 / 10 / 2, 78 / 11 / 2, 67 / 12 / 4, 86 / 13 / 2, 70 / 14 / 2, 59 / 15 / 2, 64 / 16 / 2, 85 / 17 / 5, 60 / 18 / 2, 28 / 19 / 2, 25 / 20 / 2, 89 / 21 / 5, 24 / 22 / 2, 10 / 23 / 2, 48 / 24 / 2, 44 / 25 / 4, 77 / 26 / 2, 11 / 27 / 2, 33 / 28 / 2, 56 / 29 / 2, 47 / 30 / 2, 57 / 31 / 2, 65 / 32 / 2, 27 / 33 / 2, 19 / 34 / 2, 61 / 35 / 6, 18 / 36 / 2, 96 / 37 / 2, 76 / 38 / 2, 69 / 39 / 2, 93 / 40 / 2, 35 / 41 / 3, 31 / 42 / 2, 2 / 43 / 2, 5 / 44 / 2, 22 / 45 / 3, 43 / 46 / 2, 51 / 47 / 2, 98 / 48 / 2, 38 / 49 / 7, 6 / 50 / 2, 90 / 51 / 3, 91 / 52 / 2, 52 / 53 / 3, 62 / 54 / 2, 3 / 55 / 2, 94 / 56 / 3, 40 / 57 / 2, 32 / 58 / 2, 4 / 59 / 2, 20 / 60 / 6, 14 / 61 / 2, 99 / 62 / 2, 84 / 63 / 4, 42 / 64 / 2, 95 / 65 / 2, 97 / 66 / 4, 63 / 67 / 2, 26 / 68 / 2, 41 / 69 / 3, 73 / 70 / 2, 21 / 71 / 3, 15 / 72 / 2, 16 / 73 / 3, 49 / 74 / 2, 55 / 75 / 2, 1 / 76 / 2, 83 / 77 / 2, 39 / 78 / 2, 36 / 79 / 2, 68 / 80 / 2, 8 / 81 / 2, 50 / 82 / 3, 74 / 83 / 2, 72 / 84 / 2, 54 / 85 / 2, 87 / 86 / 2, 79 / 87 / 2, 34 / 88 / 2, 9 / 89 / 4, 53 / 90 / 2, 29 / 91 / 3, 66 / 92 / 2, 23 / 93 / 6, 71 / 94 / 2, 45 / 95 / 2, 46 / 96 / 2, 80 / 97 / 2, 37 / 98 / 2, 30 / 99 / 4
doublecenter-alpha_1-97-n100.txt, 1, 1, 100, 1975.02, 855, 755, 10, 99,71 / 1 / 2, 63 / 2 / 2, 66 / 3 / 5, 99 / 4 / 2, 17 / 5 / 2, 2 / 6 / 2, 35 / 7 / 10, 87 / 8 / 2, 72 / 9 / 3, 73 / 10 / 2, 68 / 11 / 2, 80 / 12 / 2, 13 / 13 / 2, 81 / 14 / 6, 53 / 15 / 2, 3 / 16 / 2, 34 / 17 / 2, 61 / 18 / 2, 74 / 19 / 2, 52 / 20 / 2, 95 / 21 / 2, 47 / 22 / 2, 75 / 23 / 3, 84 / 24 / 2, 48 / 25 / 3, 14 / 26 / 2, 89 / 27 / 2, 42 / 28 / 4, 20 / 29 / 2, 9 / 30 / 2, 7 / 31 / 2, 50 / 32 / 2, 4 / 33 / 2, 1 / 34 / 3, 18 / 35 / 2, 88 / 36 / 2, 56 / 37 / 4, 30 / 38 / 2, 85 / 39 / 2, 16 / 40 / 2, 21 / 41 / 3, 55 / 42 / 2, 65 / 43 / 2, 43 / 44 / 3, 64 / 45 / 2, 78 / 46 / 5, 19 / 47 / 2, 82 / 48 / 2, 70 / 49 / 2, 25 / 50 / 2, 46 / 51 / 3, 57 / 52 / 2, 36 / 53 / 4, 41 / 54 / 2, 6 / 55 / 2, 12 / 56 / 2, 29 / 57 / 4, 58 / 58 / 2, 49 / 59 / 3, 90 / 60 / 2, 62 / 61 / 4, 28 / 62 / 2, 97 / 63 / 2, 24 / 64 / 3, 32 / 65 / 2, 22 / 66 / 2, 37 / 67 / 3, 93 / 68 / 2, 31 / 69 / 2, 54 / 70 / 2, 79 / 71 / 2, 77 / 72 / 4, 38 / 73 / 2, 69 / 74 / 2, 8 / 75 / 2, 60 / 76 / 2, 94 / 77 / 2, 96 / 78 / 3, 51 / 79 / 2, 10 / 80 / 4, 15 / 81 / 2, 11 / 82 / 2, 83 / 83 / 3, 76 / 84 / 2, 5 / 85 / 2, 91 / 86 / 3, 33 / 87 / 2, 26 / 88 / 3, 92 / 89 / 2, 23 / 90 / 2, 44 / 91 / 2, 40 / 92 / 2, 45 / 93 / 2, 59 / 94 / 3, 98 / 95 / 2, 39 / 96 / 2, 67 / 97 / 2, 27 / 98 / 8, 86 / 99 / 2
doublecenter-alpha_1-98-n100.txt, 1, 1, 100, 1843.55, 750, 650, 5, 99,31 / 1 / 2, 99 / 2 / 3, 90 / 3 / 2, 66 / 4 / 3, 88 / 5 / 2, 75 / 6 / 2, 57 / 7 / 4, 9 / 8 / 2, 71 / 9 / 2, 49 / 10 / 3, 83 / 11 / 2, 48 / 12 / 2, 46 / 13 / 4, 14 / 14 / 2, 47 / 15 / 2, 82 / 16 / 3, 33 / 17 / 2, 69 / 18 / 3, 40 / 19 / 2, 96 / 20 / 2, 28 / 21 / 2, 21 / 22 / 2, 32 / 23 / 3, 64 / 24 / 2, 87 / 25 / 2, 68 / 26 / 2, 67 / 27 / 3, 12 / 28 / 2, 81 / 29 / 2, 55 / 30 / 2, 74 / 31 / 2, 27 / 32 / 5, 80 / 33 / 2, 58 / 34 / 2, 41 / 35 / 2, 52 / 36 / 2, 79 / 37 / 2, 35 / 38 / 2, 22 / 39 / 3, 61 / 40 / 2, 78 / 41 / 2, 30 / 42 / 2, 2 / 43 / 2, 60 / 44 / 4, 97 / 45 / 2, 89 / 46 / 3, 63 / 47 / 2, 24 / 48 / 3, 93 / 49 / 2, 38 / 50 / 2, 4 / 51 / 2, 10 / 52 / 5, 98 / 53 / 2, 50 / 54 / 3, 11 / 55 / 2, 94 / 56 / 2, 25 / 57 / 3, 13 / 58 / 2, 86 / 59 / 3, 45 / 60 / 2, 37 / 61 / 2, 5 / 62 / 3, 29 / 63 / 2, 84 / 64 / 2, 77 / 65 / 5, 91 / 66 / 2, 53 / 67 / 2, 59 / 68 / 2, 42 / 69 / 2, 19 / 70 / 2, 62 / 71 / 3, 85 / 72 / 2, 3 / 73 / 2, 76 / 74 / 2, 43 / 75 / 2, 92 / 76 / 2, 54 / 77 / 2, 73 / 78 / 2, 39 / 79 / 2, 95 / 80 / 4, 17 / 81 / 2, 15 / 82 / 2, 72 / 83 / 2, 56 / 84 / 4, 44 / 85 / 2, 16 / 86 / 2, 26 / 87 / 3, 18 / 88 / 2, 1 / 89 / 3, 8 / 90 / 2, 36 / 91 / 2, 23 / 92 / 2, 34 / 93 / 2, 65 / 94 / 3, 6 / 95 / 2, 20 / 96 / 2, 51 / 97 / 3, 7 / 98 / 2, 70 / 99 / 3
doublecenter-alpha_1-99-n100.txt, 1, 1, 100, 1777.52, 812, 712, 7, 99,34 / 1 / 6, 50 / 2 / 2, 98 / 3 / 2, 75 / 4 / 3, 59 / 5 / 2, 71 / 6 / 6, 18 / 7 / 2, 74 / 8 / 2, 78 / 9 / 2, 90 / 10 / 2, 66 / 11 / 3, 38 / 12 / 2, 44 / 13 / 3, 5 / 14 / 2, 88 / 15 / 2, 97 / 16 / 2, 6 / 17 / 2, 84 / 18 / 2, 76 / 19 / 4, 2 / 20 / 2, 68 / 21 / 3, 64 / 22 / 2, 27 / 23 / 3, 4 / 24 / 2, 87 / 25 / 2, 31 / 26 / 2, 61 / 27 / 4, 22 / 28 / 2, 15 / 29 / 3, 96 / 30 / 2, 13 / 31 / 2, 60 / 32 / 2, 56 / 33 / 4, 43 / 34 / 2, 91 / 35 / 2, 73 / 36 / 2, 21 / 37 / 3, 8 / 38 / 2, 85 / 39 / 3, 72 / 40 / 2, 99 / 41 / 2, 30 / 42 / 2, 10 / 43 / 2, 86 / 44 / 3, 7 / 45 / 2, 67 / 46 / 2, 77 / 47 / 3, 33 / 48 / 2, 23 / 49 / 2, 12 / 50 / 3, 40 / 51 / 2, 39 / 52 / 3, 9 / 53 / 2, 81 / 54 / 2, 94 / 55 / 2, 35 / 56 / 4, 47 / 57 / 2, 29 / 58 / 3, 83 / 59 / 2, 11 / 60 / 2, 53 / 61 / 2, 93 / 62 / 5, 65 / 63 / 2, 62 / 64 / 3, 3 / 65 / 2, 17 / 66 / 5, 16 / 67 / 2, 41 / 68 / 3, 80 / 69 / 2, 20 / 70 / 2, 42 / 71 / 2, 37 / 72 / 3, 19 / 73 / 2, 79 / 74 / 2, 24 / 75 / 2, 69 / 76 / 2, 52 / 77 / 3, 45 / 78 / 2, 28 / 79 / 3, 54 / 80 / 2, 70 / 81 / 3, 32 / 82 / 2, 57 / 83 / 2, 58 / 84 / 4, 14 / 85 / 2, 49 / 86 / 2, 82 / 87 / 2, 63 / 88 / 5, 51 / 89 / 2, 36 / 90 / 2, 95 / 91 / 2, 48 / 92 / 2, 1 / 93 / 5, 46 / 94 / 2, 92 / 95 / 2, 89 / 96 / 3, 26 / 97 / 2, 55 / 98 / 2, 25 / 99 / 7
doublecenter-alpha_3-1-n250.txt, 1, 0.333333, 250, 2989.83, 510, 260, 2, 5,47 / 70 / 2, 179 / 83 / 2, 44 / 86 / 2, 71 / 210 / 2, 197 / 214 / 2
doublecenter-alpha_3-1-n375.txt, 1, 0.333333, 375, 3719.91, 761, 386, 2, 5,316 / 80 / 2, 210 / 116 / 2, 211 / 201 / 2, 144 / 261 / 2, 127 / 309 / 2
doublecenter-alpha_3-1-n5.txt, 1, 0.333333, 5, 519.298, 9, 4, 1, 0,
doublecenter-alpha_3-10-n250.txt, 1, 0.333333, 250, 3145.3, 499, 249, 1, 0,
doublecenter-alpha_3-10-n5.txt, 1, 0.333333, 5, 616.2, 11, 6, 3, 1,2 / 4 / 3
doublecenter-alpha_3-10-n500.txt, 1, 0.333333, 500, 4602.5, 1018, 518, 3, 7,56 / 24 / 2, 495 / 116 / 3, 482 / 199 / 2, 123 / 349 / 2, 68 / 443 / 2, 493 / 478 / 2, 478 / 498 / 2
doublecenter-alpha_3-100-n100.txt, 1, 0.333333, 100, 2039.07, 206, 106, 2, 3,56 / 40 / 2, 99 / 66 / 2, 53 / 76 / 2
doublecenter-alpha_3-101-n175.txt, 1, 0.333333, 175, 2268.14, 353, 178, 2, 2,15 / 95 / 2, 18 / 139 / 2
doublecenter-alpha_3-102-n175.txt, 1, 0.333333, 175, 2475.47, 356, 181, 2, 3,142 / 5 / 2, 2 / 65 / 2, 110 / 84 / 2
doublecenter-alpha_3-103-n175.txt, 1, 0.333333, 175, 2605.88, 353, 178, 2, 2,78 / 121 / 2, 148 / 147 / 2
doublecenter-alpha_3-104-n175.txt, 1, 0.333333, 175, 2790.75, 356, 181, 2, 3,83 / 4 / 2, 69 / 48 / 2, 89 / 81 / 2
doublecenter-alpha_3-105-n175.txt, 1, 0.333333, 175, 2684.29, 372, 197, 2, 6,92 / 49 / 2, 29 / 72 / 2, 162 / 76 / 2, 101 / 94 / 2, 107 / 132 / 2, 122 / 156 / 2
doublecenter-alpha_3-106-n175.txt, 1, 0.333333, 175, 2601.24, 356, 181, 2, 3,134 / 80 / 2, 55 / 86 / 2, 71 / 140 / 2
doublecenter-alpha_3-107-n175.txt, 1, 0.333333, 175, 2274.94, 364, 189, 2, 4,99 / 12 / 2, 103 / 24 / 2, 135 / 45 / 2, 157 / 132 / 2
doublecenter-alpha_3-108-n175.txt, 1, 0.333333, 175, 2556.44, 356, 181, 2, 3,170 / 85 / 2, 6 / 157 / 2, 17 / 170 / 2
doublecenter-alpha_3-109-n175.txt, 1, 0.333333, 175, 2474.29, 351, 176, 2, 1,130 / 50 / 2
doublecenter-alpha_3-11-n375.txt, 1, 0.333333, 375, 3524.58, 760, 385, 2, 5,357 / 36 / 2, 177 / 127 / 2, 64 / 301 / 2, 270 / 317 / 2, 79 / 333 / 2
doublecenter-alpha_3-11-n500.txt, 1, 0.333333, 500, 4537.59, 1013, 513, 2, 5,370 / 179 / 2, 176 / 224 / 2, 159 / 243 / 2, 481 / 274 / 2, 495 / 453 / 2
doublecenter-alpha_3-11-n6.txt, 1, 0.333333, 6, 545.59, 13, 7, 2, 1,3 / 2 / 2
doublecenter-alpha_3-110-n175.txt, 1, 0.333333, 175, 2609.14, 352, 177, 2, 1,78 / 110 / 2
doublecenter-alpha_3-111-n250.txt, 1, 0.333333, 250, 2908.71, 499, 249, 1, 0,
doublecenter-alpha_3-112-n250.txt, 1, 0.333333, 250, 3026.25, 510, 260, 2, 4,152 / 46 / 2, 106 / 169 / 2, 1 / 227 / 2, 97 / 242 / 2
doublecenter-alpha_3-113-n250.txt, 1, 0.333333, 250, 2726.22, 502, 252, 2, 1,60 / 130 / 2
doublecenter-alpha_3-114-n250.txt, 1, 0.333333, 250, 2721.71, 501, 251, 2, 1,186 / 107 / 2
doublecenter-alpha_3-115-n250.txt, 1, 0.333333, 250, 3157.95, 514, 264, 3, 4,22 / 5 / 2, 38 / 110 / 3, 129 / 159 / 2, 203 / 215 / 2
doublecenter-alpha_3-116-n250.txt, 1, 0.333333, 250, 3058.11, 503, 253, 2, 2,60 / 164 / 2, 198 / 183 / 2
doublecenter-alpha_3-117-n250.txt, 1, 0.333333, 250, 3019.4, 503, 253, 2, 2,131 / 4 / 2, 7 / 156 / 2
doublecenter-alpha_3-118-n250.txt, 1, 0.333333, 250, 3595.05, 517, 267, 2, 8,149 / 43 / 2, 17 / 46 / 2, 93 / 89 / 2, 96 / 123 / 2, 126 / 144 / 2, 10 / 147 / 2, 229 / 231 / 2, 59 / 245 / 2
doublecenter-alpha_3-119-n250.txt, 1, 0.333333, 250, 3169.71, 515, 265, 3, 4,78 / 25 / 2, 185 / 134 / 3, 56 / 165 / 2, 226 / 219 / 2
doublecenter-alpha_3-12-n375.txt, 1, 0.333333, 375, 3949.36, 760, 385, 2, 4,279 / 177 / 2, 21 / 246 / 2, 318 / 315 / 2, 147 / 368 / 2
doublecenter-alpha_3-12-n500.txt, 1, 0.333333, 500, 4284.83, 1017, 517, 2, 6,294 / 42 / 2, 146 / 51 / 2, 316 / 181 / 2, 483 / 201 / 2, 155 / 327 / 2, 248 / 357 / 2
doublecenter-alpha_3-12-n6.txt, 1, 0.333333, 6, 561.772, 11, 5, 1, 0,
doublecenter-alpha_3-120-n250.txt, 1, 0.333333, 250, 3096.26, 510, 260, 2, 5,222 / 35 / 2, 183 / 109 / 2, 162 / 154 / 2, 108 / 180 / 2, 201 / 206 / 2
doublecenter-alpha_3-13-n375.txt, 1, 0.333333, 375, 4094.81, 753, 378, 2, 2,75 / 8 / 2, 287 / 229 / 2
doublecenter-alpha_3-13-n500.txt, 1, 0.333333, 500, 4319.16, 1006, 506, 2, 2,376 / 12 / 2, 164 / 357 / 2
doublecenter-alpha_3-13-n6.txt, 1, 0.333333, 6, 701.152, 11, 5, 1, 0,
doublecenter-alpha_3-14-n375.txt, 1, 0.333333, 375, 4010.96, 763, 388, 3, 3,170 / 133 / 3, 128 / 143 / 2, 41 / 311 / 2
doublecenter-alpha_3-14-n500.txt, 1, 0.333333, 500, 4498.98, 1009, 509, 2, 5,184 / 140 / 2, 19 / 214 / 2, 104 / 264 / 2, 474 / 304 / 2, 333 / 329 / 2
doublecenter-alpha_3-14-n6.txt, 1, 0.333333, 6, 641.109, 11, 5, 1, 0,
doublecenter-alpha_3-15-n375.txt, 1, 0.333333, 375, 3895.57, 758, 383, 2, 4,67 / 48 / 2, 76 / 193 / 2, 9 / 274 / 2, 100 / 363 / 2
doublecenter-alpha_3-15-n6.txt, 1, 0.333333, 6, 576.063, 11, 5, 1, 0,
doublecenter-alpha_3-16-n375.txt, 1, 0.333333, 375, 3482.29, 760, 385, 2, 5,306 / 15 / 2, 210 / 105 / 2, 307 / 168 / 2, 107 / 298 / 2, 253 / 356 / 2
doublecenter-alpha_3-16-n6.txt, 1, 0.333333, 6, 584.357, 11, 5, 1, 0,
doublecenter-alpha_3-17-n375.txt, 1, 0.333333, 375, 4185.89, 775, 400, 3, 8,94 / 42 / 3, 337 / 63 / 2, 57 / 75 / 2, 141 / 167 / 2, 246 / 210 / 2, 155 / 295 / 2, 351 / 342 / 2, 198 / 360 / 2
doublecenter-alpha_3-17-n6.txt, 1, 0.333333, 6, 621.071, 11, 5, 1, 0,
doublecenter-alpha_3-18-n375.txt, 1, 0.333333, 375, 4258.82, 766, 391, 2, 7,163 / 17 / 2, 285 / 20 / 2, 302 / 239 / 2, 362 / 280 / 2, 142 / 310 / 2, 38 / 320 / 2, 149 / 363 / 2
doublecenter-alpha_3-18-n6.txt, 1, 0.333333, 6, 598.362, 11, 5, 1, 0,
doublecenter-alpha_3-19-n375.txt, 1, 0.333333, 375, 3739.66, 761, 386, 2, 5,277 / 62 / 2, 234 / 95 / 2, 28 / 193 / 2, 43 / 237 / 2, 7 / 294 / 2
doublecenter-alpha_3-19-n6.txt, 1, 0.333333, 6, 516.415, 17, 11, 3, 1,4 / 2 / 3
doublecenter-alpha_3-2-n250.txt, 1, 0.333333, 250, 2773.06, 507, 257, 2, 4,26 / 80 / 2, 95 / 121 / 2, 41 / 139 / 2, 148 / 224 / 2
doublecenter-alpha_3-2-n375.txt, 1, 0.333333, 375, 3920.79, 778, 403, 4, 3,73 / 24 / 2, 330 / 287 / 4, 95 / 318 / 2
doublecenter-alpha_3-2-n5.txt, 1, 0.333333, 5, 459.018, 10, 5, 2, 1,2 / 1 / 2
doublecenter-alpha_3-20-n375.txt, 1, 0.333333, 375, 3838.71, 751, 376, 2, 1,345 / 227 / 2
doublecenter-alpha_3-20-n6.txt, 1, 0.333333, 6, 486.292, 11, 5, 1, 0,
doublecenter-alpha_3-21-n7.txt, 1, 0.333333, 7, 704.97, 13, 6, 1, 0,
doublecenter-alpha_3-22-n7.txt, 1, 0.333333, 7, 578.001, 13, 6, 1, 0,
doublecenter-alpha_3-23-n7.txt, 1, 0.333333, 7, 625.472, 13, 6, 1, 0,
doublecenter-alpha_3-24-n7.txt, 1, 0.333333, 7, 616.903, 13, 6, 1, 0,
doublecenter-alpha_3-25-n7.txt, 1, 0.333333, 7, 816.052, 13, 6, 1, 0,
doublecenter-alpha_3-26-n7.txt, 1, 0.333333, 7, 536.169, 13, 6, 1, 0,
doublecenter-alpha_3-27-n7.txt, 1, 0.333333, 7, 562.15, 16, 9, 2, 2,5 / 1 / 2, 4 / 4 / 2
doublecenter-alpha_3-28-n7.txt, 1, 0.333333, 7, 670.512, 15, 8, 2, 1,5 / 5 / 2
doublecenter-alpha_3-29-n7.txt, 1, 0.333333, 7, 597.927, 13, 6, 1, 0,
doublecenter-alpha_3-3-n250.txt, 1, 0.333333, 250, 2769.92, 509, 259, 2, 4,194 / 13 / 2, 72 / 98 / 2, 191 / 181 / 2, 204 / 194 / 2
doublecenter-alpha_3-3-n375.txt, 1, 0.333333, 375, 3917.52, 757, 382, 2, 4,132 / 48 / 2, 110 / 236 / 2, 62 / 286 / 2, 357 / 330 / 2
doublecenter-alpha_3-3-n5.txt, 1, 0.333333, 5, 570.096, 14, 9, 4, 2,4 / 1 / 4, 3 / 4 / 3
doublecenter-alpha_3-30-n7.txt, 1, 0.333333, 7, 693.396, 14, 7, 2, 1,3 / 6 / 2
doublecenter-alpha_3-31-n8.txt, 1, 0.333333, 8, 671.781, 15, 7, 1, 0,
doublecenter-alpha_3-32-n8.txt, 1, 0.333333, 8, 635.889, 15, 7, 1, 0,
doublecenter-alpha_3-33-n8.txt, 1, 0.333333, 8, 628.299, 15, 7, 1, 0,
doublecenter-alpha_3-34-n8.txt, 1, 0.333333, 8, 939.994, 15, 7, 1, 0,
doublecenter-alpha_3-35-n8.txt, 1, 0.333333, 8, 616.589, 15, 7, 1, 0,
doublecenter-alpha_3-36-n8.txt, 1, 0.333333, 8, 749.87, 15, 7, 1, 0,
doublecenter-alpha_3-37-n8.txt, 1, 0.333333, 8, 491.172, 15, 7, 1, 0,
doublecenter-alpha_3-38-n8.txt, 1, 0.333333, 8, 754.847, 15, 7, 1, 0,
doublecenter-alpha_3-39-n8.txt, 1, 0.333333, 8, 792.636, 15, 7, 1, 0,
doublecenter-alpha_3-4-n250.txt, 1, 0.333333, 250, 3078.35, 502, 252, 2, 1,40 / 156 / 2
doublecenter-alpha_3-4-n375.txt, 1, 0.333333, 375, 3950.21, 749, 374, 1, 0,
doublecenter-alpha_3-4-n5.txt, 1, 0.333333, 5, 461.76, 9, 4, 1, 0,
doublecenter-alpha_3-40-n8.txt, 1, 0.333333, 8, 678.368, 15, 7, 1, 0,
doublecenter-alpha_3-41-n9.txt, 1, 0.333333, 9, 865.611, 20, 11, 2, 1,3 / 5 / 2
doublecenter-alpha_3-42-n9.txt, 1, 0.333333, 9, 839.407, 17, 8, 1, 0,
doublecenter-alpha_3-43-n9.txt, 1, 0.333333, 9, 633.604, 17, 8, 1, 0,
doublecenter-alpha_3-44-n9.txt, 1, 0.333333, 9, 820.718, 17, 8, 1, 0,
doublecenter-alpha_3-45-n9.txt, 1, 0.333333, 9, 566.44, 17, 8, 1, 0,
doublecenter-alpha_3-46-n9.txt, 1, 0.333333, 9, 584.011, 17, 8, 1, 0,
doublecenter-alpha_3-47-n9.txt, 1, 0.333333, 9, 725.289, 17, 8, 1, 0,
doublecenter-alpha_3-48-n9.txt, 1, 0.333333, 9, 526.727, 19, 10, 2, 1,3 / 5 / 2
doublecenter-alpha_3-49-n9.txt, 1, 0.333333, 9, 455.257, 17, 8, 1, 0,
doublecenter-alpha_3-5-n250.txt, 1, 0.333333, 250, 3118.08, 507, 257, 2, 4,19 / 54 / 2, 153 / 65 / 2, 63 / 129 / 2, 155 / 158 / 2
doublecenter-alpha_3-5-n5.txt, 1, 0.333333, 5, 563.296, 9, 4, 1, 0,
doublecenter-alpha_3-5-n500.txt, 1, 0.333333, 500, 4359.6, 1011, 511, 2, 6,352 / 8 / 2, 179 / 104 / 2, 111 / 167 / 2, 412 / 226 / 2, 79 / 304 / 2, 455 / 314 / 2
doublecenter-alpha_3-50-n9.txt, 1, 0.333333, 9, 604.164, 20, 11, 2, 1,8 / 2 / 2
doublecenter-alpha_3-51-n10.txt, 1, 0.333333, 10, 617.979, 22, 12, 2, 1,2 / 5 / 2
doublecenter-alpha_3-52-n10.txt, 1, 0.333333, 10, 480.483, 19, 9, 1, 0,
doublecenter-alpha_3-53-n10.txt, 1, 0.333333, 10, 877.43, 19, 9, 1, 0,
doublecenter-alpha_3-54-n10.txt, 1, 0.333333, 10, 596.774, 21, 11, 3, 1,6 / 9 / 3
doublecenter-alpha_3-55-n10.txt, 1, 0.333333, 10, 953.958, 23, 13, 2, 2,1 / 2 / 2, 5 / 8 / 2
doublecenter-alpha_3-56-n10.txt, 1, 0.333333, 10, 671.443, 19, 9, 1, 0,
doublecenter-alpha_3-57-n10.txt, 1, 0.333333, 10, 792.45, 21, 11, 2, 1,4 / 3 / 2
doublecenter-alpha_3-58-n10.txt, 1, 0.333333, 10, 776.617, 19, 9, 1, 0,
doublecenter-alpha_3-59-n10.txt, 1, 0.333333, 10, 842.195, 19, 9, 1, 0,
doublecenter-alpha_3-6-n250.txt, 1, 0.333333, 250, 2948.79, 511, 261, 2, 6,79 / 4 / 2, 192 / 11 / 2, 167 / 51 / 2, 235 / 94 / 2, 70 / 112 / 2, 61 / 214 / 2
doublecenter-alpha_3-6-n5.txt, 1, 0.333333, 5, 459.872, 9, 4, 1, 0,
doublecenter-alpha_3-6-n500.txt, 1, 0.333333, 500, 4082.08, 1008, 508, 2, 4,28 / 42 / 2, 405 / 136 / 2, 52 / 185 / 2, 260 / 490 / 2
doublecenter-alpha_3-60-n10.txt, 1, 0.333333, 10, 874.85, 19, 9, 1, 0,
doublecenter-alpha_3-61-n20.txt, 1, 0.333333, 20, 894.912, 39, 19, 1, 0,
doublecenter-alpha_3-62-n20.txt, 1, 0.333333, 20, 855.233, 39, 19, 1, 0,
doublecenter-alpha_3-63-n20.txt, 1, 0.333333, 20, 1018.78, 39, 19, 1, 0,
doublecenter-alpha_3-64-n20.txt, 1, 0.333333, 20, 1153.99, 39, 19, 1, 0,
doublecenter-alpha_3-65-n20.txt, 1, 0.333333, 20, 889.21, 44, 24, 3, 1,9 / 3 / 3
doublecenter-alpha_3-66-n20.txt, 1, 0.333333, 20, 827.762, 39, 19, 1, 0,
doublecenter-alpha_3-67-n20.txt, 1, 0.333333, 20, 842.366, 41, 21, 2, 1,16 / 4 / 2
doublecenter-alpha_3-68-n20.txt, 1, 0.333333, 20, 748.93, 44, 24, 2, 1,18 / 10 / 2
doublecenter-alpha_3-69-n20.txt, 1, 0.333333, 20, 773.729, 39, 19, 1, 0,
doublecenter-alpha_3-7-n250.txt, 1, 0.333333, 250, 3152.03, 517, 267, 2, 4,132 / 11 / 2, 77 / 59 / 2, 137 / 215 / 2, 1 / 245 / 2
doublecenter-alpha_3-7-n5.txt, 1, 0.333333, 5, 541.405, 9, 4, 1, 0,
doublecenter-alpha_3-7-n500.txt, 1, 0.333333, 500, 4492.82, 1003, 503, 2, 2,130 / 245 / 2, 208 / 351 / 2
doublecenter-alpha_3-70-n20.txt, 1, 0.333333, 20, 873.827, 39, 19, 1, 0,
doublecenter-alpha_3-71-n50.txt, 1, 0.333333, 50, 1588.5, 103, 53, 2, 2,25 / 7 / 2, 28 / 28 / 2
doublecenter-alpha_3-72-n50.txt, 1, 0.333333, 50, 1339.72, 102, 52, 2, 1,14 / 22 / 2
doublecenter-alpha_3-73-n50.txt, 1, 0.333333, 50, 1226.3, 102, 52, 2, 1,16 / 34 / 2
doublecenter-alpha_3-74-n50.txt, 1, 0.333333, 50, 1227.43, 101, 51, 2, 1,24 / 32 / 2
doublecenter-alpha_3-75-n50.txt, 1, 0.333333, 50, 1353.98, 104, 54, 2, 1,27 / 39 / 2
doublecenter-alpha_3-76-n50.txt, 1, 0.333333, 50, 1414.55, 115, 65, 3, 2,30 / 19 / 2, 38 / 30 / 3
doublecenter-alpha_3-77-n50.txt, 1, 0.333333, 50, 1247.82, 99, 49, 1, 0,
doublecenter-alpha_3-78-n50.txt, 1, 0.333333, 50, 1420.45, 101, 51, 2, 1,36 / 10 / 2
doublecenter-alpha_3-79-n50.txt, 1, 0.333333, 50, 1316.79, 105, 55, 2, 3,46 / 7 / 2, 9 / 30 / 2, 18 / 40 / 2
doublecenter-alpha_3-8-n250.txt, 1, 0.333333, 250, 2789.81, 505, 255, 2, 3,155 / 48 / 2, 53 / 109 / 2, 61 / 225 / 2
doublecenter-alpha_3-8-n5.txt, 1, 0.333333, 5, 710.08, 9, 4, 1, 0,
doublecenter-alpha_3-8-n500.txt, 1, 0.333333, 500, 4277.27, 1018, 518, 2, 9,8 / 67 / 2, 300 / 71 / 2, 348 / 160 / 2, 188 / 205 / 2, 337 / 277 / 2, 257 / 286 / 2, 296 / 303 / 2, 142 / 414 / 2, 270 / 474 / 2
doublecenter-alpha_3-80-n50.txt, 1, 0.333333, 50, 1500.26, 101, 51, 2, 1,40 / 26 / 2
doublecenter-alpha_3-81-n75.txt, 1, 0.333333, 75, 1528.45, 149, 74, 1, 0,
doublecenter-alpha_3-82-n75.txt, 1, 0.333333, 75, 1668.93, 154, 79, 2, 2,12 / 25 / 2, 66 / 72 / 2
doublecenter-alpha_3-83-n75.txt, 1, 0.333333, 75, 1552.78, 153, 78, 2, 1,10 / 14 / 2
doublecenter-alpha_3-84-n75.txt, 1, 0.333333, 75, 2039.43, 158, 83, 3, 2,37 / 2 / 2, 46 / 62 / 3
doublecenter-alpha_3-85-n75.txt, 1, 0.333333, 75, 2090.86, 151, 76, 2, 1,30 / 35 / 2
doublecenter-alpha_3-86-n75.txt, 1, 0.333333, 75, 1584.59, 154, 79, 2, 2,31 / 7 / 2, 58 / 57 / 2
doublecenter-alpha_3-87-n75.txt, 1, 0.333333, 75, 1594.5, 151, 76, 2, 1,70 / 20 / 2
doublecenter-alpha_3-88-n75.txt, 1, 0.333333, 75, 1936.17, 157, 82, 2, 4,31 / 33 / 2, 16 / 37 / 2, 27 / 58 / 2, 44 / 72 / 2
doublecenter-alpha_3-89-n75.txt, 1, 0.333333, 75, 1621.67, 153, 78, 2, 2,29 / 18 / 2, 51 / 70 / 2
doublecenter-alpha_3-9-n250.txt, 1, 0.333333, 250, 3318.03, 501, 251, 2, 1,150 / 44 / 2
doublecenter-alpha_3-9-n5.txt, 1, 0.333333, 5, 643.144, 9, 4, 1, 0,
doublecenter-alpha_3-9-n500.txt, 1, 0.333333, 500, 4608.31, 1005, 505, 2, 3,254 / 11 / 2, 330 / 44 / 2, 275 / 212 / 2
doublecenter-alpha_3-90-n75.txt, 1, 0.333333, 75, 1595.71, 153, 78, 2, 2,27 / 23 / 2, 70 / 27 / 2
doublecenter-alpha_3-91-n100.txt, 1, 0.333333, 100, 1893.79, 201, 101, 2, 1,74 / 24 / 2
doublecenter-alpha_3-92-n100.txt, 1, 0.333333, 100, 1924.44, 205, 105, 2, 1,37 / 88 / 2
doublecenter-alpha_3-93-n100.txt, 1, 0.333333, 100, 1714.12, 204, 104, 2, 2,75 / 36 / 2, 25 / 46 / 2
doublecenter-alpha_3-94-n100.txt, 1, 0.333333, 100, 1806.58, 201, 101, 2, 1,24 / 75 / 2
doublecenter-alpha_3-95-n100.txt, 1, 0.333333, 100, 2135.29, 206, 106, 2, 3,72 / 9 / 2, 3 / 32 / 2, 73 / 97 / 2
doublecenter-alpha_3-96-n100.txt, 1, 0.333333, 100, 2029.03, 202, 102, 2, 1,76 / 73 / 2
doublecenter-alpha_3-97-n100.txt, 1, 0.333333, 100, 1989.94, 210, 110, 2, 3,66 / 7 / 2, 35 / 11 / 2, 56 / 52 / 2
doublecenter-alpha_3-98-n100.txt, 1, 0.333333, 100, 1808.64, 208, 108, 3, 2,27 / 27 / 3, 49 / 45 / 2
doublecenter-alpha_3-99-n100.txt, 1, 0.333333, 100, 1835.55, 204, 104, 2, 2,56 / 12 / 2, 35 / 60 / 2
singlecenter-1-n250.txt, 1, 0.5, 250, 2073.28, 550, 300, 3, 14,133 / 2 / 2, 228 / 9 / 2, 60 / 19 / 2, 31 / 59 / 2, 174 / 64 / 2, 79 / 89 / 2, 211 / 137 / 2, 239 / 145 / 2, 117 / 147 / 2, 125 / 157 / 2, 222 / 197 / 3, 40 / 206 / 2, 137 / 225 / 3, 121 / 237 / 2
singlecenter-1-n375.txt, 1, 0.5, 375, 2795.17, 812, 437, 4, 20,265 / 7 / 2, 161 / 30 / 2, 54 / 32 / 2, 41 / 46 / 2, 91 / 76 / 4, 137 / 93 / 2, 44 / 104 / 2, 116 / 107 / 2, 58 / 112 / 2, 185 / 128 / 2, 16 / 151 / 2, 235 / 181 / 2, 194 / 205 / 3, 358 / 215 / 2, 97 / 229 / 2, 352 / 236 / 2, 319 / 239 / 2, 42 / 277 / 2, 156 / 284 / 2, 186 / 308 / 2
singlecenter-1-n5.txt, 1, 0.5, 5, 287.752, 11, 6, 2, 1,4 / 2 / 2
singlecenter-10-n250.txt, 1, 0.5, 250, 2200.61, 555, 305, 3, 18,172 / 25 / 2, 2 / 26 / 2, 74 / 50 / 3, 116 / 68 / 2, 79 / 73 / 2, 26 / 116 / 2, 164 / 118 / 2, 106 / 124 / 3, 111 / 128 / 2, 185 / 140 / 2, 236 / 150 / 2, 114 / 153 / 2, 198 / 157 / 3, 175 / 168 / 2, 94 / 184 / 2, 158 / 189 / 2, 239 / 195 / 2, 113 / 211 / 2
singlecenter-10-n5.txt, 1, 0.5, 5, 250.196, 10, 5, 2, 1,4 / 1 / 2
singlecenter-10-n500.txt, 1, 0.5, 500, 3244.48, 1051, 551, 2, 23,278 / 39 / 2, 95 / 47 / 2, 114 / 82 / 2, 77 / 87 / 2, 409 / 95 / 2, 103 / 131 / 2, 99 / 133 / 2, 473 / 146 / 2, 496 / 164 / 2, 196 / 170 / 2, 447 / 247 / 2, 166 / 256 / 2, 275 / 277 / 2, 407 / 289 / 2, 14 / 292 / 2, 12 / 309 / 2, 157 / 342 / 2, 436 / 392 / 2, 137 / 419 / 2, 80 / 426 / 2, 129 / 438 / 2, 134 / 445 / 2, 461 / 452 / 2
singlecenter-100-n100.txt, 1, 0.5, 100, 1275.65, 229, 129, 3, 8,1 / 7 / 2, 59 / 16 / 2, 5 / 34 / 3, 23 / 39 / 2, 14 / 44 / 2, 86 / 75 / 2, 99 / 82 / 2, 16 / 93 / 2
singlecenter-101-n175.txt, 1, 0.5, 175, 1790.45, 375, 200, 2, 11,78 / 17 / 2, 98 / 24 / 2, 33 / 34 / 2, 141 / 49 / 2, 114 / 64 / 2, 24 / 67 / 2, 76 / 83 / 2, 16 / 118 / 2, 117 / 126 / 2, 108 / 149 / 2, 101 / 162 / 2
singlecenter-102-n175.txt, 1, 0.5, 175, 1811.68, 383, 208, 3, 10,123 / 47 / 2, 110 / 61 / 3, 112 / 76 / 2, 24 / 80 / 2, 152 / 103 / 2, 33 / 107 / 2, 144 / 118 / 2, 163 / 141 / 2, 70 / 157 / 2, 32 / 164 / 2
singlecenter-103-n175.txt, 1, 0.5, 175, 1834.74, 370, 195, 2, 8,64 / 14 / 2, 54 / 37 / 2, 78 / 72 / 2, 22 / 107 / 2, 173 / 135 / 2, 142 / 154 / 2, 112 / 162 / 2, 145 / 165 / 2
singlecenter-104-n175.txt, 1, 0.5, 175, 1799.7, 373, 198, 2, 10,46 / 29 / 2, 101 / 54 / 2, 5 / 61 / 2, 68 / 67 / 2, 37 / 88 / 2, 51 / 89 / 2, 121 / 96 / 2, 94 / 127 / 2, 70 / 135 / 2, 55 / 144 / 2
singlecenter-105-n175.txt, 1, 0.5, 175, 1816.5, 376, 201, 3, 9,137 / 8 / 2, 149 / 49 / 2, 76 / 77 / 2, 108 / 82 / 2, 128 / 86 / 2, 135 / 101 / 2, 12 / 106 / 2, 163 / 150 / 2, 152 / 156 / 3
singlecenter-106-n175.txt, 1, 0.5, 175, 1948.49, 382, 207, 3, 9,59 / 67 / 2, 149 / 73 / 3, 150 / 84 / 2, 30 / 94 / 2, 115 / 116 / 2, 166 / 125 / 2, 134 / 150 / 2, 90 / 156 / 2, 60 / 161 / 2
singlecenter-107-n175.txt, 1, 0.5, 175, 1901.16, 367, 192, 3, 7,7 / 43 / 2, 52 / 52 / 3, 59 / 86 / 2, 84 / 96 / 2, 87 / 121 / 2, 102 / 137 / 2, 56 / 152 / 2
singlecenter-108-n175.txt, 1, 0.5, 175, 1976.54, 380, 205, 3, 9,167 / 2 / 2, 125 / 17 / 2, 61 / 60 / 2, 38 / 64 / 2, 69 / 93 / 3, 24 / 102 / 2, 86 / 109 / 2, 111 / 122 / 2, 97 / 130 / 2
singlecenter-109-n175.txt, 1, 0.5, 175, 1980.62, 373, 198, 2, 8,130 / 11 / 2, 94 / 24 / 2, 53 / 45 / 2, 131 / 76 / 2, 14 / 86 / 2, 34 / 136 / 2, 129 / 154 / 2, 18 / 166 / 2
singlecenter-11-n375.txt, 1, 0.5, 375, 2578.13, 828, 453, 3, 26,304 / 5 / 3, 270 / 19 / 2, 189 / 24 / 2, 59 / 33 / 2, 240 / 38 / 2, 212 / 54 / 2, 222 / 55 / 2, 232 / 71 / 2, 230 / 74 / 2, 81 / 78 / 2, 45 / 80 / 2, 219 / 105 / 2, 341 / 119 / 2, 320 / 153 / 2, 358 / 164 / 2, 132 / 211 / 2, 96 / 218 / 2, 361 / 243 / 2, 124 / 245 / 2, 202 / 251 / 2, 326 / 263 / 2, 309 / 281 / 2, 317 / 290 / 2, 121 / 307 / 2, 149 / 356 / 2, 257 / 360 / 2
singlecenter-11-n500.txt, 1, 0.5, 500, 3130.79, 1077, 577, 3, 31,262 / 14 / 2, 20 / 26 / 2, 385 / 39 / 2, 427 / 53 / 2, 260 / 60 / 2, 332 / 73 / 2, 92 / 79 / 2, 207 / 95 / 2, 255 / 98 / 2, 362 / 114 / 2, 405 / 120 / 2, 222 / 134 / 2, 56 / 140 / 2, 19 / 150 / 2, 331 / 174 / 2, 251 / 191 / 2, 406 / 194 / 2, 246 / 242 / 2, 435 / 253 / 2, 247 / 260 / 2, 191 / 269 / 2, 408 / 289 / 3, 346 / 318 / 2, 459 / 326 / 2, 359 / 390 / 2, 292 / 396 / 2, 210 / 400 / 2, 183 / 416 / 2, 259 / 432 / 2, 133 / 448 / 2, 63 / 453 / 2
singlecenter-11-n6.txt, 1, 0.5, 6, 266.872, 16, 10, 2, 1,5 / 2 / 2
singlecenter-110-n175.txt, 1, 0.5, 175, 1902.51, 381, 206, 3, 10,123 / 28 / 2, 119 / 39 / 3, 145 / 51 / 2, 139 / 58 / 2, 75 / 101 / 2, 20 / 104 / 2, 118 / 122 / 2, 70 / 124 / 2, 125 / 142 / 2, 7 / 173 / 2
singlecenter-111-n250.txt, 1, 0.5, 250, 2119.62, 541, 291, 3, 13,196 / 20 / 2, 54 / 34 / 3, 103 / 58 / 2, 222 / 94 / 2, 114 / 123 / 2, 83 / 132 / 2, 11 / 150 / 2, 232 / 163 / 2, 238 / 171 / 2, 3 / 175 / 2, 5 / 184 / 2, 152 / 188 / 2, 188 / 221 / 2
singlecenter-112-n250.txt, 1, 0.5, 250, 2057.09, 531, 281, 3, 10,90 / 62 / 2, 76 / 72 / 2, 227 / 117 / 3, 170 / 153 / 2, 109 / 195 / 2, 187 / 200 / 2, 57 / 204 / 2, 238 / 219 / 2, 86 / 229 / 2, 248 / 240 / 2
singlecenter-113-n250.txt, 1, 0.5, 250, 2140.1, 537, 287, 3, 14,224 / 6 / 2, 234 / 13 / 2, 153 / 53 / 2, 51 / 57 / 2, 47 / 92 / 2, 156 / 126 / 2, 18 / 140 / 2, 230 / 153 / 2, 246 / 160 / 2, 103 / 175 / 2, 96 / 182 / 3, 126 / 210 / 2, 240 / 237 / 2, 11 / 244 / 2
singlecenter-114-n250.txt, 1, 0.5, 250, 2165.45, 551, 301, 3, 17,149 / 27 / 2, 187 / 31 / 2, 27 / 48 / 2, 105 / 64 / 2, 56 / 77 / 2, 81 / 84 / 2, 243 / 107 / 2, 117 / 137 / 2, 185 / 155 / 2, 239 / 173 / 2, 169 / 180 / 2, 131 / 197 / 2, 89 / 206 / 2, 41 / 212 / 2, 231 / 219 / 2, 163 / 234 / 3, 154 / 246 / 2
singlecenter-115-n250.txt, 1, 0.5, 250, 2311.77, 550, 300, 3, 14,35 / 21 / 3, 126 / 45 / 3, 6 / 66 / 2, 241 / 72 / 2, 106 / 83 / 2, 227 / 87 / 2, 72 / 94 / 2, 96 / 121 / 3, 218 / 150 / 3, 211 / 162 / 2, 232 / 169 / 2, 186 / 178 / 2, 236 / 232 / 2, 162 / 244 / 2
singlecenter-116-n250.txt, 1, 0.5, 250, 2195.81, 534, 284, 3, 11,209 / 13 / 2, 15 / 33 / 2, 98 / 36 / 2, 117 / 49 / 2, 38 / 84 / 2, 221 / 91 / 2, 203 / 107 / 2, 118 / 118 / 3, 44 / 144 / 2, 122 / 175 / 2, 216 / 177 / 2
singlecenter-117-n250.txt, 1, 0.5, 250, 2222.72, 565, 315, 4, 14,139 / 7 / 3, 214 / 63 / 2, 44 / 66 / 2, 216 / 88 / 2, 243 / 92 / 2, 147 / 97 / 4, 28 / 119 / 2, 17 / 141 / 2, 38 / 168 / 2, 55 / 173 / 2, 203 / 182 / 2, 127 / 189 / 2, 90 / 197 / 2, 161 / 203 / 2
singlecenter-118-n250.txt, 1, 0.5, 250, 2204.77, 556, 306, 3, 16,114 / 16 / 2, 1 / 50 / 2, 219 / 54 / 2, 94 / 65 / 2, 128 / 91 / 2, 21 / 105 / 2, 205 / 112 / 2, 168 / 120 / 3, 181 / 128 / 2, 218 / 168 / 2, 110 / 178 / 2, 247 / 190 / 3, 118 / 195 / 2, 207 / 215 / 2, 227 / 221 / 2, 72 / 225 / 2
singlecenter-119-n250.txt, 1, 0.5, 250, 2035.42, 591, 341, 5, 14,174 / 13 / 2, 187 / 79 / 2, 209 / 82 / 2, 121 / 106 / 4, 43 / 109 / 2, 236 / 120 / 2, 246 / 138 / 2, 201 / 152 / 2, 91 / 170 / 2, 165 / 178 / 5, 162 / 194 / 2, 123 / 216 / 2, 192 / 218 / 2, 21 / 236 / 2
singlecenter-12-n375.txt, 1, 0.5, 375, 2757.97, 841, 466, 4, 24,138 / 18 / 3, 133 / 28 / 2, 75 / 32 / 2, 83 / 71 / 2, 145 / 77 / 2, 201 / 88 / 2, 23 / 112 / 2, 217 / 120 / 2, 272 / 135 / 2, 86 / 196 / 2, 235 / 201 / 2, 343 / 227 / 2, 224 / 234 / 2, 66 / 239 / 2, 174 / 241 / 2, 183 / 243 / 4, 2 / 263 / 2, 367 / 276 / 3, 281 / 283 / 2, 3 / 329 / 2, 104 / 346 / 2, 31 / 349 / 2, 233 / 357 / 2, 356 / 370 / 2
singlecenter-12-n500.txt, 1, 0.5, 500, 3589.22, 1065, 565, 3, 24,66 / 2 / 2, 489 / 24 / 2, 130 / 50 / 2, 387 / 68 / 3, 97 / 71 / 2, 353 / 140 / 2, 298 / 190 / 2, 53 / 202 / 2, 86 / 214 / 2, 120 / 249 / 2, 425 / 251 / 2, 405 / 261 / 2, 406 / 268 / 2, 476 / 278 / 2, 296 / 282 / 2, 385 / 336 / 2, 20 / 348 / 2, 278 / 362 / 2, 52 / 404 / 2, 163 / 466 / 2, 8 / 470 / 2, 95 / 479 / 2, 236 / 493 / 2, 438 / 496 / 2
singlecenter-12-n6.txt, 1, 0.5, 6, 254.028, 17, 11, 3, 2,4 / 2 / 3, 5 / 5 / 3
singlecenter-120-n250.txt, 1, 0.5, 250, 2078.65, 530, 280, 2, 13,25 / 9 / 2, 169 / 41 / 2, 72 / 55 / 2, 159 / 60 / 2, 31 / 107 / 2, 102 / 120 / 2, 130 / 130 / 2, 10 / 152 / 2, 229 / 166 / 2, 20 / 175 / 2, 76 / 183 / 2, 4 / 213 / 2, 164 / 223 / 2
singlecenter-13-n375.txt, 1, 0.5, 375, 2701.05, 790, 415, 3, 16,167 / 8 / 2, 270 / 42 / 2, 320 / 49 / 2, 202 / 74 / 3, 319 / 101 / 2, 321 / 131 / 2, 56 / 136 / 2, 207 / 163 / 2, 22 / 166 / 2, 369 / 253 / 2, 145 / 287 / 2, 312 / 310 / 2, 97 / 313 / 2, 102 / 317 / 2, 152 / 336 / 2, 364 / 363 / 2
singlecenter-13-n500.txt, 1, 0.5, 500, 3205.92, 1085, 585, 3, 30,196 / 20 / 2, 208 / 23 / 2, 258 / 59 / 2, 222 / 93 / 2, 115 / 111 / 2, 257 / 139 / 2, 68 / 163 / 2, 240 / 166 / 2, 108 / 172 / 2, 101 / 179 / 2, 14 / 193 / 2, 29 / 218 / 2, 211 / 268 / 2, 124 / 274 / 2, 226 / 282 / 2, 45 / 291 / 2, 436 / 294 / 2, 184 / 300 / 3, 293 / 328 / 2, 109 / 332 / 2, 23 / 358 / 2, 178 / 388 / 2, 410 / 395 / 2, 265 / 410 / 2, 287 / 426 / 2, 194 / 432 / 2, 121 / 435 / 3, 216 / 450 / 2, 22 / 473 / 2, 11 / 477 / 2
singlecenter-13-n6.txt, 1, 0.5, 6, 379.725, 14, 8, 2, 1,3 / 3 / 2
singlecenter-14-n375.txt, 1, 0.5, 375, 2816.56, 804, 429, 3, 16,183 / 18 / 2, 238 / 21 / 3, 178 / 37 / 2, 237 / 131 / 2, 247 / 134 / 2, 46 / 137 / 2, 326 / 143 / 2, 21 / 147 / 2, 330 / 155 / 2, 290 / 175 / 2, 170 / 196 / 2, 94 / 241 / 2, 226 / 248 / 2, 185 / 272 / 2, 7 / 278 / 2, 233 / 348 / 2
singlecenter-14-n500.txt, 1, 0.5, 500, 3032.81, 1063, 563, 2, 29,176 / 9 / 2, 476 / 14 / 2, 301 / 33 / 2, 281 / 54 / 2, 4 / 61 / 2, 192 / 89 / 2, 122 / 98 / 2, 208 / 105 / 2, 1 / 117 / 2, 484 / 124 / 2, 490 / 130 / 2, 254 / 171 / 2, 97 / 192 / 2, 380 / 203 / 2, 454 / 219 / 2, 492 / 230 / 2, 350 / 260 / 2, 374 / 265 / 2, 447 / 275 / 2, 7 / 303 / 2, 182 / 306 / 2, 243 / 322 / 2, 410 / 328 / 2, 287 / 346 / 2, 493 / 363 / 2, 124 / 379 / 2, 417 / 434 / 2, 17 / 452 / 2, 78 / 482 / 2
singlecenter-14-n6.txt, 1, 0.5, 6, 287.196, 15, 9, 6, 1,2 / 5 / 6
singlecenter-15-n375.txt, 1, 0.5, 375, 2810.98, 808, 433, 4, 17,167 / 14 / 2, 80 / 59 / 3, 253 / 61 / 2, 360 / 106 / 2, 41 / 109 / 2, 32 / 132 / 2, 4 / 174 / 2, 283 / 184 / 2, 200 / 199 / 2, 110 / 213 / 2, 15 / 253 / 2, 320 / 262 / 2, 321 / 265 / 2, 14 / 301 / 2, 96 / 312 / 2, 287 / 322 / 2, 85 / 326 / 4
singlecenter-15-n6.txt, 1, 0.5, 6, 267.742, 11, 5, 1, 0,
singlecenter-16-n375.txt, 1, 0.5, 375, 2686.26, 810, 435, 3, 20,152 / 72 / 3, 54 / 77 / 2, 119 / 78 / 2, 49 / 84 / 2, 281 / 91 / 2, 230 / 94 / 2, 282 / 158 / 2, 108 / 184 / 2, 321 / 192 / 2, 38 / 217 / 2, 351 / 249 / 2, 84 / 286 / 2, 30 / 302 / 2, 236 / 307 / 2, 249 / 314 / 2, 113 / 319 / 2, 258 / 330 / 2, 112 / 346 / 2, 207 / 360 / 2, 91 / 365 / 2
singlecenter-16-n6.txt, 1, 0.5, 6, 259.436, 17, 11, 3, 2,5 / 1 / 3, 1 / 4 / 3
singlecenter-17-n375.txt, 1, 0.5, 375, 2510.83, 844, 469, 3, 27,197 / 4 / 2, 241 / 12 / 2, 336 / 16 / 3, 164 / 18 / 2, 242 / 28 / 2, 309 / 31 / 3, 96 / 44 / 2, 359 / 46 / 2, 86 / 74 / 2, 351 / 77 / 2, 97 / 107 / 2, 262 / 143 / 2, 42 / 146 / 3, 349 / 166 / 2, 362 / 185 / 2, 132 / 188 / 2, 88 / 196 / 3, 311 / 198 / 2, 192 / 215 / 2, 57 / 230 / 2, 369 / 241 / 2, 206 / 248 / 2, 345 / 289 / 2, 220 / 333 / 2, 32 / 337 / 2, 84 / 349 / 2, 150 / 360 / 2
singlecenter-17-n6.txt, 1, 0.5, 6, 543.347, 12, 6, 2, 1,3 / 1 / 2
singlecenter-18-n375.txt, 1, 0.5, 375, 2800.63, 816, 441, 3, 21,272 / 15 / 2, 194 / 19 / 2, 204 / 39 / 2, 211 / 43 / 2, 295 / 48 / 2, 9 / 50 / 2, 308 / 55 / 2, 110 / 117 / 2, 316 / 131 / 2, 191 / 134 / 2, 73 / 138 / 2, 1 / 147 / 2, 49 / 178 / 3, 371 / 186 / 2, 298 / 223 / 2, 252 / 228 / 2, 5 / 272 / 2, 280 / 285 / 2, 11 / 303 / 2, 215 / 311 / 2, 146 / 339 / 2
singlecenter-18-n6.txt, 1, 0.5, 6, 451.076, 11, 5, 1, 0,
singlecenter-19-n375.txt, 1, 0.5, 375, 2657.47, 819, 444, 2, 27,192 / 6 / 2, 185 / 27 / 2, 157 / 49 / 2, 145 / 66 / 2, 129 / 72 / 2, 82 / 80 / 2, 364 / 94 / 2, 236 / 98 / 2, 340 / 100 / 2, 250 / 106 / 2, 39 / 116 / 2, 278 / 151 / 2, 323 / 157 / 2, 147 / 191 / 2, 55 / 204 / 2, 169 / 212 / 2, 338 / 241 / 2, 291 / 264 / 2, 268 / 271 / 2, 180 / 290 / 2, 362 / 293 / 2, 309 / 296 / 2, 277 / 314 / 2, 83 / 328 / 2, 294 / 344 / 2, 90 / 356 / 2, 297 / 367 / 2
singlecenter-19-n6.txt, 1, 0.5, 6, 298.648, 11, 5, 1, 0,
singlecenter-2-n250.txt, 1, 0.5, 250, 2278.82, 529, 279, 2, 13,122 / 20 / 2, 72 / 25 / 2, 80 / 43 / 2, 230 / 49 / 2, 75 / 56 / 2, 244 / 81 / 2, 183 / 104 / 2, 133 / 109 / 2, 135 / 141 / 2, 66 / 188 / 2, 197 / 227 / 2, 138 / 232 / 2, 119 / 235 / 2
singlecenter-2-n375.txt, 1, 0.5, 375, 2646.37, 793, 418, 2, 18,150 / 21 / 2, 268 / 29 / 2, 247 / 46 / 2, 321 / 54 / 2, 335 / 57 / 2, 220 / 64 / 2, 59 / 79 / 2, 147 / 87 / 2, 133 / 99 / 2, 2 / 169 / 2, 116 / 173 / 2, 108 / 181 / 2, 40 / 197 / 2, 277 / 199 / 2, 93 / 230 / 2, 32 / 281 / 2, 238 / 304 / 2, 239 / 361 / 2
singlecenter-2-n5.txt, 1, 0.5, 5, 301.242, 10, 5, 2, 1,2 / 4 / 2
singlecenter-20-n375.txt, 1, 0.5, 375, 2705.4, 806, 431, 3, 22,231 / 41 / 2, 310 / 47 / 2, 36 / 64 / 2, 149 / 77 / 2, 51 / 94 / 2, 361 / 98 / 2, 351 / 103 / 2, 104 / 107 / 2, 307 / 174 / 2, 265 / 187 / 2, 4 / 189 / 2, 15 / 204 / 3, 358 / 243 / 2, 6 / 246 / 2, 87 / 249 / 3, 268 / 282 / 2, 59 / 292 / 2, 132 / 301 / 2, 82 / 338 / 2, 236 / 349 / 2, 80 / 367 / 2, 105 / 370 / 2
singlecenter-20-n6.txt, 1, 0.5, 6, 230.966, 11, 5, 1, 0,
singlecenter-21-n7.txt, 1, 0.5, 7, 373.051, 13, 6, 1, 0,
singlecenter-22-n7.txt, 1, 0.5, 7, 361.737, 24, 17, 4, 2,3 / 3 / 4, 1 / 6 / 3
singlecenter-23-n7.txt, 1, 0.5, 7, 167.639, 13, 6, 1, 0,
singlecenter-24-n7.txt, 1, 0.5, 7, 318.567, 15, 8, 2, 1,2 / 5 / 2
singlecenter-25-n7.txt, 1, 0.5, 7, 357.359, 21, 14, 4, 1,1 / 2 / 4
singlecenter-26-n7.txt, 1, 0.5, 7, 201.045, 19, 12, 3, 2,1 / 4 / 2, 3 / 6 / 3
singlecenter-27-n7.txt, 1, 0.5, 7, 288.22, 13, 6, 1, 0,
singlecenter-28-n7.txt, 1, 0.5, 7, 326.378, 15, 8, 2, 1,1 / 5 / 2
singlecenter-29-n7.txt, 1, 0.5, 7, 364.546, 16, 9, 2, 1,6 / 3 / 2
singlecenter-3-n250.txt, 1, 0.5, 250, 2399.28, 540, 290, 2, 16,189 / 11 / 2, 145 / 16 / 2, 93 / 25 / 2, 30 / 31 / 2, 68 / 40 / 2, 102 / 69 / 2, 242 / 87 / 2, 183 / 112 / 2, 244 / 117 / 2, 100 / 119 / 2, 39 / 130 / 2, 182 / 142 / 2, 208 / 147 / 2, 118 / 156 / 2, 180 / 176 / 2, 56 / 246 / 2
singlecenter-3-n375.txt, 1, 0.5, 375, 2820.34, 802, 427, 3, 16,192 / 4 / 2, 62 / 55 / 2, 269 / 85 / 2, 131 / 132 / 2, 239 / 137 / 2, 363 / 163 / 2, 180 / 175 / 2, 120 / 206 / 2, 247 / 233 / 2, 229 / 235 / 2, 132 / 243 / 2, 27 / 279 / 2, 193 / 281 / 2, 24 / 304 / 2, 301 / 338 / 3, 110 / 365 / 2
singlecenter-3-n5.txt, 1, 0.5, 5, 113.906, 13, 8, 3, 2,4 / 1 / 3, 3 / 4 / 3
singlecenter-30-n7.txt, 1, 0.5, 7, 317.496, 13, 6, 1, 0,
singlecenter-31-n8.txt, 1, 0.5, 8, 262.502, 15, 7, 1, 0,
singlecenter-32-n8.txt, 1, 0.5, 8, 189.851, 17, 9, 2, 1,6 / 3 / 2
singlecenter-33-n8.txt, 1, 0.5, 8, 354.384, 19, 11, 3, 1,5 / 6 / 3
singlecenter-34-n8.txt, 1, 0.5, 8, 454.873, 18, 10, 2, 2,5 / 4 / 2, 7 / 7 / 2
singlecenter-35-n8.txt, 1, 0.5, 8, 378.761, 22, 14, 2, 3,4 / 2 / 2, 2 / 4 / 2, 7 / 6 / 2
singlecenter-36-n8.txt, 1, 0.5, 8, 411.356, 28, 20, 4, 2,6 / 3 / 4, 3 / 6 / 3
singlecenter-37-n8.txt, 1, 0.5, 8, 274.661, 21, 13, 5, 2,4 / 2 / 2, 2 / 7 / 5
singlecenter-38-n8.txt, 1, 0.5, 8, 514.708, 18, 10, 2, 1,1 / 4 / 2
singlecenter-39-n8.txt, 1, 0.5, 8, 348.275, 21, 13, 3, 1,1 / 6 / 3
singlecenter-4-n250.txt, 1, 0.5, 250, 2242.13, 534, 284, 2, 14,136 / 17 / 2, 82 / 21 / 2, 248 / 34 / 2, 153 / 49 / 2, 242 / 52 / 2, 80 / 65 / 2, 118 / 85 / 2, 154 / 94 / 2, 120 / 101 / 2, 143 / 110 / 2, 55 / 130 / 2, 125 / 135 / 2, 124 / 180 / 2, 2 / 211 / 2
singlecenter-4-n375.txt, 1, 0.5, 375, 2751.33, 808, 433, 3, 20,178 / 30 / 2, 29 / 49 / 2, 88 / 52 / 2, 292 / 55 / 2, 339 / 79 / 2, 255 / 88 / 3, 215 / 90 / 2, 144 / 106 / 2, 122 / 117 / 2, 266 / 151 / 2, 43 / 155 / 2, 32 / 174 / 2, 326 / 199 / 3, 120 / 210 / 2, 159 / 236 / 2, 371 / 245 / 2, 143 / 271 / 2, 286 / 286 / 2, 119 / 304 / 2, 93 / 314 / 2
singlecenter-4-n5.txt, 1, 0.5, 5, 248.069, 12, 7, 4, 1,2 / 1 / 4
singlecenter-40-n8.txt, 1, 0.5, 8, 375.521, 17, 9, 2, 1,3 / 6 / 2
singlecenter-41-n9.txt, 1, 0.5, 9, 242.025, 25, 16, 3, 2,8 / 2 / 3, 5 / 7 / 3
singlecenter-42-n9.txt, 1, 0.5, 9, 566.413, 23, 14, 3, 1,1 / 7 / 3
singlecenter-43-n9.txt, 1, 0.5, 9, 355.437, 21, 12, 2, 1,3 / 4 / 2
singlecenter-44-n9.txt, 1, 0.5, 9, 368.246, 17, 8, 1, 0,
singlecenter-45-n9.txt, 1, 0.5, 9, 434.671, 17, 8, 1, 0,
singlecenter-46-n9.txt, 1, 0.5, 9, 386.483, 22, 13, 2, 1,4 / 4 / 2
singlecenter-47-n9.txt, 1, 0.5, 9, 522.804, 17, 8, 1, 0,
singlecenter-48-n9.txt, 1, 0.5, 9, 365.626, 17, 8, 1, 0,
singlecenter-49-n9.txt, 1, 0.5, 9, 506.407, 17, 8, 1, 0,
singlecenter-5-n250.txt, 1, 0.5, 250, 2419.61, 552, 302, 4, 12,99 / 4 / 2, 70 / 10 / 2, 227 / 48 / 2, 166 / 99 / 2, 9 / 101 / 4, 220 / 112 / 2, 193 / 136 / 3, 33 / 153 / 2, 236 / 163 / 2, 200 / 194 / 2, 175 / 230 / 2, 222 / 236 / 2
singlecenter-5-n5.txt, 1, 0.5, 5, 248.933, 13, 8, 4, 2,4 / 1 / 2, 1 / 4 / 4
singlecenter-5-n500.txt, 1, 0.5, 500, 3128.76, 1068, 568, 3, 25,378 / 52 / 2, 93 / 78 / 2, 179 / 82 / 2, 371 / 87 / 2, 36 / 102 / 2, 338 / 107 / 2, 159 / 137 / 2, 7 / 152 / 2, 215 / 178 / 2, 316 / 205 / 2, 221 / 210 / 2, 10 / 227 / 2, 252 / 268 / 2, 244 / 287 / 2, 55 / 298 / 2, 417 / 322 / 2, 248 / 370 / 2, 390 / 393 / 3, 272 / 404 / 2, 255 / 422 / 2, 267 / 434 / 2, 114 / 439 / 2, 259 / 446 / 2, 404 / 454 / 2, 285 / 472 / 2
singlecenter-50-n9.txt, 1, 0.5, 9, 367.104, 19, 10, 2, 1,7 / 7 / 2
singlecenter-51-n10.txt, 1, 0.5, 10, 456.863, 27, 17, 3, 1,5 / 7 / 3
singlecenter-52-n10.txt, 1, 0.5, 10, 395.366, 21, 11, 2, 1,4 / 3 / 2
singlecenter-53-n10.txt, 1, 0.5, 10, 511.958, 22, 12, 4, 1,7 / 1 / 4
singlecenter-54-n10.txt, 1, 0.5, 10, 540.687, 19, 9, 1, 0,
singlecenter-55-n10.txt, 1, 0.5, 10, 420.54, 21, 11, 2, 1,8 / 8 / 2
singlecenter-56-n10.txt, 1, 0.5, 10, 533.079, 26, 16, 2, 2,6 / 5 / 2, 7 / 7 / 2
singlecenter-57-n10.txt, 1, 0.5, 10, 392.738, 24, 14, 2, 1,8 / 5 / 2
singlecenter-58-n10.txt, 1, 0.5, 10, 380.547, 25, 15, 2, 1,9 / 4 / 2
singlecenter-59-n10.txt, 1, 0.5, 10, 536.675, 24, 14, 2, 1,6 / 7 / 2
singlecenter-6-n250.txt, 1, 0.5, 250, 2144.41, 522, 272, 2, 7,76 / 13 / 2, 208 / 34 / 2, 104 / 79 / 2, 50 / 107 / 2, 10 / 139 / 2, 175 / 203 / 2, 116 / 236 / 2
singlecenter-6-n5.txt, 1, 0.5, 5, 385.016, 14, 9, 2, 2,1 / 1 / 2, 4 / 3 / 2
singlecenter-6-n500.txt, 1, 0.5, 500, 3062.78, 1063, 563, 3, 21,475 / 9 / 3, 245 / 35 / 2, 476 / 65 / 2, 416 / 88 / 2, 333 / 117 / 2, 332 / 167 / 2, 354 / 189 / 2, 499 / 195 / 2, 432 / 202 / 2, 360 / 207 / 3, 363 / 219 / 2, 265 / 227 / 2, 117 / 258 / 2, 167 / 298 / 2, 80 / 313 / 2, 353 / 321 / 2, 261 / 368 / 2, 106 / 370 / 2, 282 / 425 / 2, 279 / 437 / 2, 188 / 445 / 2
singlecenter-60-n10.txt, 1, 0.5, 10, 416.422, 19, 9, 1, 0,
singlecenter-61-n20.txt, 1, 0.5, 20, 611.697, 52, 32, 3, 3,17 / 3 / 3, 7 / 8 / 2, 4 / 12 / 2
singlecenter-62-n20.txt, 1, 0.5, 20, 558.852, 54, 34, 3, 3,19 / 1 / 2, 13 / 3 / 3, 3 / 7 / 3
singlecenter-63-n20.txt, 1, 0.5, 20, 744.799, 43, 23, 2, 2,3 / 4 / 2, 15 / 11 / 2
singlecenter-64-n20.txt, 1, 0.5, 20, 650.153, 53, 33, 2, 3,10 / 2 / 2, 5 / 8 / 2, 8 / 16 / 2
singlecenter-65-n20.txt, 1, 0.5, 20, 662.922, 48, 28, 2, 4,9 / 1 / 2, 14 / 4 / 2, 19 / 9 / 2, 10 / 18 / 2
singlecenter-66-n20.txt, 1, 0.5, 20, 494.764, 41, 21, 2, 1,18 / 17 / 2
singlecenter-67-n20.txt, 1, 0.5, 20, 594.362, 47, 27, 2, 3,17 / 3 / 2, 1 / 10 / 2, 7 / 16 / 2
singlecenter-68-n20.txt, 1, 0.5, 20, 634.428, 48, 28, 2, 2,10 / 12 / 2, 6 / 15 / 2
singlecenter-69-n20.txt, 1, 0.5, 20, 743.188, 40, 20, 2, 1,8 / 1 / 2
singlecenter-7-n250.txt, 1, 0.5, 250, 2148.22, 540, 290, 3, 12,234 / 16 / 2, 231 / 27 / 2, 216 / 92 / 2, 126 / 101 / 3, 218 / 106 / 2, 34 / 128 / 2, 29 / 134 / 2, 52 / 137 / 2, 184 / 140 / 2, 45 / 148 / 2, 174 / 169 / 2, 82 / 219 / 2
singlecenter-7-n5.txt, 1, 0.5, 5, 227.209, 9, 4, 1, 0,
singlecenter-7-n500.txt, 1, 0.5, 500, 3191.68, 1038, 538, 3, 15,35 / 19 / 2, 244 / 45 / 2, 15 / 59 / 2, 421 / 66 / 2, 436 / 96 / 2, 26 / 142 / 2, 217 / 159 / 2, 91 / 160 / 2, 415 / 171 / 2, 465 / 185 / 2, 196 / 200 / 2, 183 / 234 / 2, 339 / 262 / 3, 170 / 374 / 2, 191 / 390 / 2
singlecenter-70-n20.txt, 1, 0.5, 20, 529.556, 41, 21, 2, 1,11 / 14 / 2
singlecenter-71-n50.txt, 1, 0.5, 50, 736.636, 108, 58, 2, 4,2 / 3 / 2, 7 / 17 / 2, 34 / 32 / 2, 22 / 36 / 2
singlecenter-72-n50.txt, 1, 0.5, 50, 904.014, 101, 51, 2, 1,25 / 9 / 2
singlecenter-73-n50.txt, 1, 0.5, 50, 624.359, 116, 66, 2, 6,46 / 4 / 2, 45 / 15 / 2, 27 / 17 / 2, 9 / 24 / 2, 13 / 29 / 2, 40 / 43 / 2
singlecenter-74-n50.txt, 1, 0.5, 50, 949.827, 117, 67, 2, 6,41 / 2 / 2, 16 / 13 / 2, 44 / 15 / 2, 14 / 22 / 2, 33 / 31 / 2, 49 / 35 / 2
singlecenter-75-n50.txt, 1, 0.5, 50, 1076.85, 139, 89, 4, 6,16 / 5 / 2, 6 / 15 / 2, 5 / 21 / 2, 34 / 27 / 2, 23 / 35 / 2, 18 / 42 / 4
singlecenter-76-n50.txt, 1, 0.5, 50, 967.872, 124, 74, 3, 7,13 / 12 / 2, 44 / 17 / 3, 8 / 22 / 2, 34 / 25 / 2, 26 / 27 / 2, 41 / 31 / 2, 46 / 45 / 2
singlecenter-77-n50.txt, 1, 0.5, 50, 822.804, 121, 71, 3, 2,26 / 26 / 3, 47 / 42 / 2
singlecenter-78-n50.txt, 1, 0.5, 50, 914.864, 110, 60, 2, 4,30 / 11 / 2, 1 / 15 / 2, 13 / 33 / 2, 8 / 47 / 2
singlecenter-79-n50.txt, 1, 0.5, 50, 830.735, 120, 70, 3, 3,35 / 2 / 3, 22 / 7 / 2, 47 / 19 / 3
singlecenter-8-n250.txt, 1, 0.5, 250, 2273.07, 583, 333, 6, 15,91 / 5 / 2, 156 / 25 / 2, 183 / 33 / 2, 211 / 41 / 2, 231 / 84 / 2, 241 / 90 / 2, 155 / 99 / 2, 32 / 119 / 2, 224 / 146 / 2, 40 / 155 / 2, 212 / 170 / 2, 41 / 172 / 2, 109 / 178 / 2, 149 / 185 / 2, 161 / 234 / 6
singlecenter-8-n5.txt, 1, 0.5, 5, 152.815, 11, 6, 3, 1,4 / 1 / 3
singlecenter-8-n500.txt, 1, 0.5, 500, 2994.92, 1051, 551, 3, 18,473 / 3 / 3, 184 / 61 / 2, 267 / 64 / 2, 200 / 100 / 2, 247 / 108 / 2, 110 / 141 / 2, 231 / 144 / 2, 147 / 151 / 2, 367 / 179 / 2, 300 / 196 / 2, 379 / 199 / 2, 94 / 224 / 2, 327 / 253 / 2, 75 / 398 / 2, 412 / 411 / 2, 143 / 418 / 2, 31 / 477 / 2, 48 / 485 / 2
singlecenter-80-n50.txt, 1, 0.5, 50, 1029.69, 110, 60, 2, 4,10 / 2 / 2, 49 / 5 / 2, 26 / 44 / 2, 24 / 47 / 2
singlecenter-81-n75.txt, 1, 0.5, 75, 1336.02, 159, 84, 2, 4,34 / 31 / 2, 38 / 35 / 2, 19 / 47 / 2, 9 / 60 / 2
singlecenter-82-n75.txt, 1, 0.5, 75, 1095.88, 159, 84, 2, 4,15 / 36 / 2, 45 / 57 / 2, 7 / 68 / 2, 37 / 71 / 2
singlecenter-83-n75.txt, 1, 0.5, 75, 1039.48, 171, 96, 3, 4,74 / 27 / 2, 70 / 42 / 3, 10 / 53 / 3, 15 / 64 / 2
singlecenter-84-n75.txt, 1, 0.5, 75, 1168.69, 163, 88, 2, 6,48 / 5 / 2, 9 / 33 / 2, 4 / 40 / 2, 23 / 50 / 2, 53 / 62 / 2, 26 / 70 / 2
singlecenter-85-n75.txt, 1, 0.5, 75, 1097.28, 194, 119, 5, 2,57 / 40 / 5, 15 / 69 / 2
singlecenter-86-n75.txt, 1, 0.5, 75, 1292.17, 166, 91, 2, 7,30 / 18 / 2, 71 / 33 / 2, 13 / 36 / 2, 4 / 40 / 2, 38 / 42 / 2, 2 / 51 / 2, 48 / 63 / 2
singlecenter-87-n75.txt, 1, 0.5, 75, 1138.39, 165, 90, 2, 6,30 / 1 / 2, 3 / 28 / 2, 53 / 44 / 2, 42 / 51 / 2, 44 / 60 / 2, 18 / 70 / 2
singlecenter-88-n75.txt, 1, 0.5, 75, 1233.11, 182, 107, 3, 4,27 / 6 / 2, 20 / 9 / 3, 69 / 47 / 3, 28 / 53 / 2
singlecenter-89-n75.txt, 1, 0.5, 75, 1062.89, 158, 83, 2, 4,51 / 10 / 2, 48 / 40 / 2, 60 / 49 / 2, 24 / 64 / 2
singlecenter-9-n250.txt, 1, 0.5, 250, 2118.53, 533, 283, 2, 14,185 / 3 / 2, 218 / 10 / 2, 134 / 35 / 2, 129 / 81 / 2, 231 / 103 / 2, 17 / 104 / 2, 223 / 133 / 2, 16 / 180 / 2, 227 / 201 / 2, 29 / 217 / 2, 136 / 221 / 2, 194 / 228 / 2, 235 / 237 / 2, 173 / 244 / 2
singlecenter-9-n5.txt, 1, 0.5, 5, 248.361, 12, 7, 2, 1,1 / 3 / 2
singlecenter-9-n500.txt, 1, 0.5, 500, 3139.03, 1081, 581, 3, 30,269 / 5 / 2, 191 / 10 / 2, 202 / 61 / 2, 414 / 64 / 2, 343 / 81 / 2, 370 / 109 / 2, 66 / 111 / 2, 64 / 127 / 2, 195 / 128 / 2, 361 / 131 / 3, 421 / 168 / 2, 100 / 176 / 2, 243 / 177 / 2, 145 / 231 / 2, 362 / 235 / 2, 157 / 243 / 2, 419 / 280 / 2, 150 / 344 / 2, 441 / 351 / 2, 453 / 354 / 2, 121 / 369 / 2, 30 / 371 / 2, 122 / 381 / 2, 214 / 385 / 2, 77 / 402 / 2, 105 / 405 / 2, 412 / 410 / 2, 232 / 443 / 2, 375 / 445 / 2, 164 / 462 / 2
singlecenter-90-n75.txt, 1, 0.5, 75, 1289.82, 169, 94, 2, 6,52 / 9 / 2, 69 / 11 / 2, 27 / 29 / 2, 73 / 33 / 2, 20 / 44 / 2, 48 / 50 / 2
singlecenter-91-n100.txt, 1, 0.5, 100, 1387.49, 211, 111, 2, 4,38 / 24 / 2, 73 / 44 / 2, 69 / 53 / 2, 64 / 81 / 2
singlecenter-92-n100.txt, 1, 0.5, 100, 1481.52, 218, 118, 2, 7,9 / 2 / 2, 56 / 26 / 2, 8 / 33 / 2, 73 / 45 / 2, 61 / 48 / 2, 65 / 61 / 2, 34 / 75 / 2
singlecenter-93-n100.txt, 1, 0.5, 100, 1438.85, 226, 126, 3, 6,68 / 13 / 2, 93 / 19 / 2, 43 / 24 / 3, 95 / 58 / 2, 32 / 60 / 3, 17 / 63 / 3
singlecenter-94-n100.txt, 1, 0.5, 100, 1559.13, 209, 109, 2, 4,78 / 33 / 2, 36 / 64 / 2, 2 / 67 / 2, 62 / 98 / 2
singlecenter-95-n100.txt, 1, 0.5, 100, 1286.83, 215, 115, 2, 8,5 / 3 / 2, 19 / 10 / 2, 91 / 17 / 2, 20 / 33 / 2, 6 / 36 / 2, 12 / 40 / 2, 73 / 81 / 2, 54 / 84 / 2
singlecenter-96-n100.txt, 1, 0.5, 100, 1408.91, 216, 116, 3, 4,76 / 34 / 3, 65 / 36 / 2, 54 / 44 / 2, 68 / 47 / 2
singlecenter-97-n100.txt, 1, 0.5, 100, 1470, 219, 119, 2, 8,56 / 10 / 2, 52 / 28 / 2, 76 / 51 / 2, 35 / 56 / 2, 22 / 59 / 2, 69 / 64 / 2, 86 / 86 / 2, 27 / 89 / 2
singlecenter-98-n100.txt, 1, 0.5, 100, 1667.29, 218, 118, 3, 3,38 / 32 / 2, 77 / 67 / 3, 27 / 95 / 2
singlecenter-99-n100.txt, 1, 0.5, 100, 1193.97, 211, 111, 2, 4,95 / 16 / 2, 63 / 31 / 2, 53 / 35 / 2, 88 / 86 / 2
singlecenter-alpha_1-1-n250.txt, 1, 1, 250, 2117.03, 1921, 1671, 6, 249,179 / 1 / 2, 32 / 2 / 4, 133 / 3 / 2, 126 / 4 / 2, 161 / 5 / 5, 155 / 6 / 2, 224 / 7 / 2, 166 / 8 / 2, 69 / 9 / 2, 137 / 10 / 6, 36 / 11 / 2, 183 / 12 / 2, 198 / 13 / 2, 40 / 14 / 2, 74 / 15 / 2, 20 / 16 / 4, 172 / 17 / 2, 231 / 18 / 3, 177 / 19 / 2, 206 / 20 / 2, 196 / 21 / 3, 210 / 22 / 2, 202 / 23 / 2, 163 / 24 / 3, 188 / 25 / 2, 4 / 26 / 3, 158 / 27 / 2, 227 / 28 / 2, 207 / 29 / 2, 116 / 30 / 3, 139 / 31 / 2, 218 / 32 / 3, 22 / 33 / 2, 94 / 34 / 2, 186 / 35 / 3, 100 / 36 / 2, 245 / 37 / 2, 98 / 38 / 2, 222 / 39 / 5, 154 / 40 / 2, 63 / 41 / 3, 76 / 42 / 2, 56 / 43 / 2, 92 / 44 / 4, 2 / 45 / 2, 48 / 46 / 3, 145 / 47 / 2, 95 / 48 / 3, 87 / 49 / 2, 144 / 50 / 2, 42 / 51 / 2, 189 / 52 / 4, 170 / 53 / 2, 212 / 54 / 2, 150 / 55 / 2, 147 / 56 / 3, 168 / 57 / 2, 240 / 58 / 2, 81 / 59 / 2, 178 / 60 / 3, 52 / 61 / 2, 34 / 62 / 2, 49 / 63 / 3, 11 / 64 / 2, 162 / 65 / 2, 214 / 66 / 3, 91 / 67 / 2, 235 / 68 / 5, 5 / 69 / 2, 50 / 70 / 2, 182 / 71 / 2, 248 / 72 / 2, 19 / 73 / 3, 46 / 74 / 2, 208 / 75 / 3, 136 / 76 / 2, 187 / 77 / 3, 241 / 78 / 2, 45 / 79 / 3, 213 / 80 / 2, 85 / 81 / 2, 7 / 82 / 2, 41 / 83 / 2, 195 / 84 / 2, 90 / 85 / 3, 201 / 86 / 2, 44 / 87 / 3, 61 / 88 / 2, 107 / 89 / 2, 135 / 90 / 2, 54 / 91 / 3, 247 / 92 / 2, 169 / 93 / 2, 228 / 94 / 4, 97 / 95 / 2, 153 / 96 / 2, 128 / 97 / 3, 78 / 98 / 2, 37 / 99 / 3, 115 / 100 / 2, 246 / 101 / 2, 21 / 102 / 5, 193 / 103 / 2, 47 / 104 / 2, 38 / 105 / 2, 96 / 106 / 3, 131 / 107 / 2, 127 / 108 / 4, 68 / 109 / 2, 25 / 110 / 2, 89 / 111 / 2, 57 / 112 / 2, 191 / 113 / 4, 185 / 114 / 2, 142 / 115 / 2, 149 / 116 / 2, 108 / 117 / 3, 110 / 118 / 2, 93 / 119 / 3, 53 / 120 / 2, 66 / 121 / 2, 18 / 122 / 3, 156 / 123 / 2, 146 / 124 / 2, 6 / 125 / 4, 192 / 126 / 2, 160 / 127 / 2, 215 / 128 / 3, 190 / 129 / 2, 204 / 130 / 3, 29 / 131 / 2, 221 / 132 / 2, 43 / 133 / 4, 27 / 134 / 2, 24 / 135 / 2, 114 / 136 / 2, 31 / 137 / 2, 180 / 138 / 4, 55 / 139 / 2, 99 / 140 / 2, 119 / 141 / 2, 174 / 142 / 3, 209 / 143 / 2, 112 / 144 / 2, 237 / 145 / 2, 70 / 146 / 2, 101 / 147 / 3, 80 / 148 / 2, 77 / 149 / 4, 14 / 150 / 2, 73 / 151 / 3, 71 / 152 / 2, 148 / 153 / 2, 132 / 154 / 5, 102 / 155 / 2, 111 / 156 / 2, 217 / 157 / 2, 230 / 158 / 4, 33 / 159 / 2, 59 / 160 / 2, 26 / 161 / 3, 233 / 162 / 2, 23 / 163 / 2, 199 / 164 / 2, 141 / 165 / 2, 143 / 166 / 2, 159 / 167 / 2, 123 / 168 / 2, 223 / 169 / 4, 79 / 170 / 2, 138 / 171 / 2, 175 / 172 / 2, 205 / 173 / 2, 17 / 174 / 2, 64 / 175 / 4, 67 / 176 / 2, 86 / 177 / 2, 12 / 178 / 3, 16 / 179 / 2, 220 / 180 / 2, 129 / 181 / 2, 249 / 182 / 2, 118 / 183 / 2, 181 / 184 / 2, 113 / 185 / 2, 35 / 186 / 2, 203 / 187 / 2, 103 / 188 / 2, 84 / 189 / 2, 28 / 190 / 2, 152 / 191 / 2, 82 / 192 / 2, 15 / 193 / 3, 75 / 194 / 2, 173 / 195 / 2, 171 / 196 / 2, 109 / 197 / 2, 62 / 198 / 3, 60 / 199 / 2, 8 / 200 / 2, 151 / 201 / 5, 219 / 202 / 2, 130 / 203 / 2, 165 / 204 / 3, 124 / 205 / 2, 120 / 206 / 3, 105 / 207 / 2, 244 / 208 / 2, 226 / 209 / 2, 117 / 210 / 4, 239 / 211 / 2, 211 / 212 / 2, 83 / 213 / 4, 72 / 214 / 2, 176 / 215 / 3, 164 / 216 / 2, 238 / 217 / 3, 9 / 218 / 2, 232 / 219 / 3, 200 / 220 / 2, 30 / 221 / 3, 184 / 222 / 2, 13 / 223 / 2, 236 / 224 / 2, 3 / 225 / 4, 197 / 226 / 2, 39 / 227 / 2, 242 / 228 / 4, 104 / 229 / 2, 134 / 230 / 2, 125 / 231 / 4, 157 / 232 / 2, 1 / 233 / 3, 234 / 234 / 2, 51 / 235 / 2, 216 / 236 / 2, 121 / 237 / 5, 140 / 238 / 2, 88 / 239 / 2, 10 / 240 / 3, 58 / 241 / 2, 122 / 242 / 2, 65 / 243 / 3, 106 / 244 / 2, 229 / 245 / 2, 225 / 246 / 2, 194 / 247 / 2, 243 / 248 / 2, 167 / 249 / 2
singlecenter-alpha_1-1-n375.txt, 1, 1, 375, 2826.83, 3067, 2692, 13, 374,292 / 1 / 3, 74 / 2 / 2, 169 / 3 / 2, 191 / 4 / 3, 121 / 5 / 2, 51 / 6 / 2, 144 / 7 / 2, 119 / 8 / 2, 21 / 9 / 4, 372 / 10 / 2, 123 / 11 / 2, 205 / 12 / 2, 109 / 13 / 2, 135 / 14 / 2, 76 / 15 / 2, 354 / 16 / 3, 202 / 17 / 2, 185 / 18 / 2, 122 / 19 / 2, 316 / 20 / 3, 247 / 21 / 2, 211 / 22 / 3, 52 / 23 / 2, 215 / 24 / 2, 111 / 25 / 2, 273 / 26 / 2, 300 / 27 / 2, 12 / 28 / 2, 68 / 29 / 6, 18 / 30 / 2, 329 / 31 / 2, 104 / 32 / 3, 284 / 33 / 2, 26 / 34 / 3, 177 / 35 / 2, 86 / 36 / 2, 350 / 37 / 3, 263 / 38 / 2, 160 / 39 / 2, 305 / 40 / 3, 190 / 41 / 2, 359 / 42 / 2, 265 / 43 / 3, 36 / 44 / 2, 254 / 45 / 2, 238 / 46 / 2, 267 / 47 / 2, 118 / 48 / 3, 221 / 49 / 2, 57 / 50 / 3, 363 / 51 / 2, 84 / 52 / 2, 132 / 53 / 2, 208 / 54 / 2, 343 / 55 / 4, 8 / 56 / 2, 251 / 57 / 2, 106 / 58 / 2, 206 / 59 / 4, 304 / 60 / 2, 142 / 61 / 2, 281 / 62 / 2, 59 / 63 / 3, 17 / 64 / 2, 2 / 65 / 2, 23 / 66 / 2, 315 / 67 / 2, 105 / 68 / 2, 228 / 69 / 2, 178 / 70 / 2, 72 / 71 / 2, 4 / 72 / 2, 54 / 73 / 2, 216 / 74 / 2, 152 / 75 / 2, 355 / 76 / 3, 261 / 77 / 2, 362 / 78 / 2, 260 / 79 / 3, 195 / 80 / 2, 41 / 81 / 4, 289 / 82 / 2, 335 / 83 / 3, 99 / 84 / 2, 224 / 85 / 2, 164 / 86 / 2, 243 / 87 / 5, 340 / 88 / 2, 56 / 89 / 2, 120 / 90 / 3, 314 / 91 / 2, 147 / 92 / 3, 33 / 93 / 2, 180 / 94 / 3, 182 / 95 / 2, 90 / 96 / 3, 278 / 97 / 2, 257 / 98 / 2, 113 / 99 / 4, 157 / 100 / 2, 325 / 101 / 2, 368 / 102 / 4, 53 / 103 / 2, 310 / 104 / 2, 258 / 105 / 2, 229 / 106 / 2, 140 / 107 / 2, 159 / 108 / 3, 210 / 109 / 2, 96 / 110 / 2, 280 / 111 / 2, 81 / 112 / 2, 328 / 113 / 4, 219 / 114 / 2, 101 / 115 / 2, 154 / 116 / 3, 245 / 117 / 2, 307 / 118 / 3, 252 / 119 / 2, 288 / 120 / 3, 175 / 121 / 2, 156 / 122 / 2, 277 / 123 / 3, 192 / 124 / 2, 108 / 125 / 2, 55 / 126 / 3, 179 / 127 / 2, 334 / 128 / 3, 283 / 129 / 2, 338 / 130 / 3, 128 / 131 / 2, 272 / 132 / 3, 183 / 133 / 2, 35 / 134 / 2, 302 / 135 / 2, 270 / 136 / 3, 186 / 137 / 2, 145 / 138 / 3, 1 / 139 / 2, 313 / 140 / 2, 189 / 141 / 2, 73 / 142 / 2, 173 / 143 / 2, 158 / 144 / 2, 297 / 145 / 2, 339 / 146 / 2, 361 / 147 / 2, 199 / 148 / 2, 294 / 149 / 2, 255 / 150 / 2, 161 / 151 / 2, 286 / 152 / 2, 212 / 153 / 2, 312 / 154 / 2, 290 / 155 / 2, 148 / 156 / 2, 237 / 157 / 2, 27 / 158 / 2, 15 / 159 / 2, 165 / 160 / 2, 167 / 161 / 2, 60 / 162 / 2, 231 / 163 / 2, 176 / 164 / 3, 217 / 165 / 2, 32 / 166 / 3, 235 / 167 / 2, 242 / 168 / 2, 93 / 169 / 2, 131 / 170 / 4, 172 / 171 / 2, 153 / 172 / 2, 50 / 173 / 2, 357 / 174 / 2, 274 / 175 / 4, 155 / 176 / 2, 322 / 177 / 2, 146 / 178 / 4, 30 / 179 / 2, 366 / 180 / 2, 347 / 181 / 4, 291 / 182 / 2, 342 / 183 / 3, 213 / 184 / 2, 87 / 185 / 2, 66 / 186 / 2, 149 / 187 / 2, 253 / 188 / 2, 126 / 189 / 4, 268 / 190 / 2, 230 / 191 / 2, 89 / 192 / 2, 269 / 193 / 2, 184 / 194 / 2, 358 / 195 / 3, 85 / 196 / 2, 209 / 197 / 2, 220 / 198 / 2, 360 / 199 / 2, 9 / 200 / 2, 233 / 201 / 2, 6 / 202 / 3, 196 / 203 / 2, 293 / 204 / 2, 327 / 205 / 2, 256 / 206 / 3, 365 / 207 / 2, 259 / 208 / 2, 225 / 209 / 2, 218 / 210 / 9, 67 / 211 / 2, 303 / 212 / 2, 193 / 213 / 2, 240 / 214 / 2, 110 / 215 / 2, 282 / 216 / 3, 115 / 217 / 2, 138 / 218 / 4, 287 / 219 / 2, 139 / 220 / 2, 306 / 221 / 2, 285 / 222 / 5, 214 / 223 / 2, 16 / 224 / 2, 141 / 225 / 2, 94 / 226 / 2, 226 / 227 / 2, 39 / 228 / 2, 239 / 229 / 2, 341 / 230 / 3, 20 / 231 / 2, 201 / 232 / 3, 320 / 233 / 2, 71 / 234 / 2, 308 / 235 / 2, 88 / 236 / 2, 58 / 237 / 2, 275 / 238 / 4, 62 / 239 / 2, 369 / 240 / 2, 127 / 241 / 4, 250 / 242 / 2, 318 / 243 / 2, 345 / 244 / 4, 64 / 245 / 2, 356 / 246 / 2, 83 / 247 / 3, 37 / 248 / 2, 353 / 249 / 3, 98 / 250 / 2, 103 / 251 / 2, 162 / 252 / 4, 151 / 253 / 2, 69 / 254 / 2, 197 / 255 / 4, 95 / 256 / 2, 28 / 257 / 2, 19 / 258 / 3, 124 / 259 / 2, 168 / 260 / 3, 116 / 261 / 2, 264 / 262 / 3, 80 / 263 / 2, 204 / 264 / 2, 44 / 265 / 2, 194 / 266 / 4, 97 / 267 / 2, 188 / 268 / 2, 323 / 269 / 3, 61 / 270 / 2, 29 / 271 / 2, 25 / 272 / 2, 276 / 273 / 2, 130 / 274 / 2, 370 / 275 / 2, 47 / 276 / 2, 244 / 277 / 3, 78 / 278 / 2, 133 / 279 / 3, 82 / 280 / 2, 351 / 281 / 3, 63 / 282 / 2, 13 / 283 / 3, 266 / 284 / 2, 42 / 285 / 2, 107 / 286 / 3, 125 / 287 / 2, 279 / 288 / 3, 77 / 289 / 2, 232 / 290 / 3, 373 / 291 / 2, 117 / 292 / 2, 249 / 293 / 2, 150 / 294 / 3, 332 / 295 / 2, 367 / 296 / 2, 295 / 297 / 3, 331 / 298 / 2, 301 / 299 / 3, 234 / 300 / 2, 174 / 301 / 5, 309 / 302 / 2, 203 / 303 / 3, 222 / 304 / 2, 114 / 305 / 3, 11 / 306 / 2, 324 / 307 / 4, 75 / 308 / 2, 143 / 309 / 2, 326 / 310 / 3, 49 / 311 / 2, 299 / 312 / 3, 317 / 313 / 2, 271 / 314 / 3, 187 / 315 / 2, 352 / 316 / 13, 319 / 317 / 2, 336 / 318 / 2, 200 / 319 / 2, 298 / 320 / 2, 46 / 321 / 2, 166 / 322 / 3, 43 / 323 / 2, 364 / 324 / 3, 246 / 325 / 2, 65 / 326 / 3, 136 / 327 / 2, 371 / 328 / 2, 198 / 329 / 3, 137 / 330 / 2, 330 / 331 / 6, 241 / 332 / 2, 181 / 333 / 2, 22 / 334 / 2, 92 / 335 / 5, 333 / 336 / 2, 79 / 337 / 3, 3 / 338 / 2, 91 / 339 / 6, 129 / 340 / 2, 311 / 341 / 2, 236 / 342 / 2, 102 / 343 / 5, 321 / 344 / 2, 34 / 345 / 2, 344 / 346 / 2, 348 / 347 / 4, 70 / 348 / 2, 40 / 349 / 2, 171 / 350 / 4, 262 / 351 / 2, 38 / 352 / 2, 10 / 353 / 3, 5 / 354 / 2, 24 / 355 / 4, 163 / 356 / 2, 100 / 357 / 2, 374 / 358 / 4, 349 / 359 / 2, 337 / 360 / 2, 7 / 361 / 3, 134 / 362 / 2, 207 / 363 / 2, 223 / 364 / 2, 14 / 365 / 4, 170 / 366 / 2, 48 / 367 / 2, 112 / 368 / 4, 31 / 369 / 2, 227 / 370 / 2, 45 / 371 / 4, 346 / 372 / 2, 296 / 373 / 2, 248 / 374 / 4
singlecenter-alpha_1-1-n5.txt, 1, 1, 5, 287.752, 19, 14, 4, 4,3 / 1 / 3, 1 / 2 / 2, 4 / 3 / 2, 2 / 4 / 4
singlecenter-alpha_1-10-n250.txt, 1, 1, 250, 2078.63, 1979, 1729, 7, 249,20 / 1 / 4, 34 / 2 / 2, 21 / 3 / 2, 160 / 4 / 2, 199 / 5 / 2, 93 / 6 / 2, 113 / 7 / 5, 240 / 8 / 2, 8 / 9 / 3, 150 / 10 / 2, 49 / 11 / 2, 96 / 12 / 3, 211 / 13 / 2, 14 / 14 / 2, 193 / 15 / 2, 112 / 16 / 2, 98 / 17 / 2, 76 / 18 / 2, 47 / 19 / 2, 100 / 20 / 5, 24 / 21 / 2, 161 / 22 / 2, 249 / 23 / 2, 60 / 24 / 5, 153 / 25 / 2, 201 / 26 / 3, 41 / 27 / 2, 126 / 28 / 2, 156 / 29 / 4, 202 / 30 / 2, 151 / 31 / 2, 31 / 32 / 2, 232 / 33 / 2, 79 / 34 / 2, 5 / 35 / 7, 108 / 36 / 2, 13 / 37 / 2, 178 / 38 / 2, 165 / 39 / 3, 58 / 40 / 2, 65 / 41 / 3, 116 / 42 / 2, 209 / 43 / 2, 64 / 44 / 2, 227 / 45 / 3, 17 / 46 / 2, 118 / 47 / 2, 95 / 48 / 2, 218 / 49 / 2, 136 / 50 / 2, 248 / 51 / 2, 184 / 52 / 2, 45 / 53 / 2, 155 / 54 / 2, 16 / 55 / 2, 104 / 56 / 2, 217 / 57 / 2, 99 / 58 / 3, 192 / 59 / 2, 83 / 60 / 3, 207 / 61 / 2, 52 / 62 / 2, 48 / 63 / 2, 88 / 64 / 2, 216 / 65 / 2, 39 / 66 / 4, 236 / 67 / 2, 182 / 68 / 2, 220 / 69 / 3, 9 / 70 / 2, 191 / 71 / 2, 87 / 72 / 3, 10 / 73 / 2, 234 / 74 / 3, 120 / 75 / 2, 97 / 76 / 3, 114 / 77 / 2, 134 / 78 / 2, 146 / 79 / 2, 230 / 80 / 2, 188 / 81 / 5, 56 / 82 / 2, 223 / 83 / 2, 203 / 84 / 3, 105 / 85 / 2, 242 / 86 / 2, 55 / 87 / 2, 37 / 88 / 3, 110 / 89 / 2, 149 / 90 / 2, 4 / 91 / 2, 121 / 92 / 3, 90 / 93 / 2, 170 / 94 / 2, 194 / 95 / 4, 214 / 96 / 2, 237 / 97 / 2, 185 / 98 / 4, 198 / 99 / 2, 107 / 100 / 3, 54 / 101 / 2, 85 / 102 / 3, 187 / 103 / 2, 70 / 104 / 2, 3 / 105 / 2, 81 / 106 / 2, 73 / 107 / 2, 119 / 108 / 2, 233 / 109 / 2, 78 / 110 / 6, 169 / 111 / 2, 173 / 112 / 2, 115 / 113 / 3, 132 / 114 / 2, 143 / 115 / 2, 57 / 116 / 3, 186 / 117 / 2, 175 / 118 / 2, 30 / 119 / 3, 200 / 120 / 2, 127 / 121 / 2, 72 / 122 / 3, 38 / 123 / 2, 35 / 124 / 2, 84 / 125 / 2, 66 / 126 / 3, 215 / 127 / 2, 23 / 128 / 4, 7 / 129 / 2, 109 / 130 / 3, 228 / 131 / 2, 204 / 132 / 2, 111 / 133 / 6, 144 / 134 / 2, 50 / 135 / 2, 171 / 136 / 2, 82 / 137 / 4, 6 / 138 / 2, 106 / 139 / 2, 158 / 140 / 4, 22 / 141 / 2, 122 / 142 / 2, 205 / 143 / 2, 163 / 144 / 2, 101 / 145 / 2, 94 / 146 / 3, 117 / 147 / 2, 245 / 148 / 3, 29 / 149 / 2, 133 / 150 / 2, 51 / 151 / 3, 123 / 152 / 2, 164 / 153 / 2, 67 / 154 / 3, 241 / 155 / 2, 44 / 156 / 3, 91 / 157 / 2, 125 / 158 / 2, 26 / 159 / 2, 224 / 160 / 2, 162 / 161 / 2, 190 / 162 / 3, 36 / 163 / 2, 221 / 164 / 3, 62 / 165 / 2, 71 / 166 / 2, 168 / 167 / 3, 231 / 168 / 2, 174 / 169 / 3, 42 / 170 / 2, 135 / 171 / 2, 140 / 172 / 2, 239 / 173 / 4, 177 / 174 / 2, 222 / 175 / 3, 181 / 176 / 2, 28 / 177 / 5, 86 / 178 / 2, 246 / 179 / 3, 63 / 180 / 2, 1 / 181 / 3, 89 / 182 / 2, 229 / 183 / 2, 142 / 184 / 3, 80 / 185 / 2, 179 / 186 / 2, 33 / 187 / 2, 128 / 188 / 3, 11 / 189 / 2, 102 / 190 / 5, 130 / 191 / 2, 141 / 192 / 3, 180 / 193 / 2, 183 / 194 / 3, 32 / 195 / 2, 25 / 196 / 2, 68 / 197 / 3, 226 / 198 / 2, 74 / 199 / 5, 206 / 200 / 2, 69 / 201 / 3, 53 / 202 / 2, 210 / 203 / 2, 208 / 204 / 2, 195 / 205 / 2, 243 / 206 / 2, 238 / 207 / 4, 139 / 208 / 2, 40 / 209 / 2, 138 / 210 / 2, 152 / 211 / 2, 247 / 212 / 6, 213 / 213 / 2, 43 / 214 / 2, 212 / 215 / 2, 75 / 216 / 2, 145 / 217 / 2, 176 / 218 / 2, 225 / 219 / 2, 235 / 220 / 2, 189 / 221 / 3, 137 / 222 / 2, 244 / 223 / 3, 166 / 224 / 2, 147 / 225 / 2, 103 / 226 / 2, 129 / 227 / 3, 92 / 228 / 2, 12 / 229 / 2, 18 / 230 / 2, 157 / 231 / 3, 19 / 232 / 2, 77 / 233 / 2, 27 / 234 / 2, 46 / 235 / 2, 219 / 236 / 2, 196 / 237 / 2, 154 / 238 / 4, 124 / 239 / 2, 131 / 240 / 3, 159 / 241 / 2, 59 / 242 / 2, 2 / 243 / 3, 15 / 244 / 2, 172 / 245 / 2, 167 / 246 / 3, 61 / 247 / 2, 197 / 248 / 3, 148 / 249 / 2
singlecenter-alpha_1-10-n5.txt, 1, 1, 5, 250.196, 19, 14, 4, 4,2 / 1 / 2, 3 / 2 / 2, 1 / 3 / 2, 4 / 4 / 4
singlecenter-alpha_1-10-n500.txt, 1, 1, 500, 3232.89, 3858, 3358, 7, 499,375 / 1 / 3, 170 / 2 / 2, 254 / 3 / 2, 9 / 4 / 5, 358 / 5 / 2, 464 / 6 / 3, 483 / 7 / 2, 87 / 8 / 3, 109 / 9 / 2, 30 / 10 / 2, 343 / 11 / 2, 357 / 12 / 2, 85 / 13 / 2, 7 / 14 / 2, 8 / 15 / 2, 19 / 16 / 2, 227 / 17 / 2, 91 / 18 / 2, 374 / 19 / 3, 116 / 20 / 2, 259 / 21 / 3, 263 / 22 / 2, 387 / 23 / 2, 168 / 24 / 2, 197 / 25 / 2, 458 / 26 / 5, 337 / 27 / 2, 187 / 28 / 2, 304 / 29 / 2, 47 / 30 / 3, 388 / 31 / 2, 84 / 32 / 3, 206 / 33 / 2, 462 / 34 / 2, 486 / 35 / 2, 81 / 36 / 3, 4 / 37 / 2, 97 / 38 / 2, 71 / 39 / 3, 470 / 40 / 2, 414 / 41 / 3, 186 / 42 / 2, 399 / 43 / 2, 479 / 44 / 5, 377 / 45 / 2, 240 / 46 / 2, 112 / 47 / 3, 466 / 48 / 2, 312 / 49 / 2, 249 / 50 / 2, 52 / 51 / 3, 277 / 52 / 2, 57 / 53 / 2, 199 / 54 / 3, 315 / 55 / 2, 138 / 56 / 2, 201 / 57 / 6, 463 / 58 / 2, 347 / 59 / 2, 257 / 60 / 3, 314 / 61 / 2, 128 / 62 / 4, 205 / 63 / 2, 150 / 64 / 2, 223 / 65 / 2, 248 / 66 / 2, 16 / 67 / 2, 228 / 68 / 3, 243 / 69 / 2, 418 / 70 / 2, 22 / 71 / 3, 207 / 72 / 2, 383 / 73 / 2, 26 / 74 / 3, 438 / 75 / 2, 353 / 76 / 3, 497 / 77 / 2, 307 / 78 / 2, 434 / 79 / 2, 494 / 80 / 4, 134 / 81 / 2, 230 / 82 / 3, 75 / 83 / 2, 281 / 84 / 2, 305 / 85 / 2, 368 / 86 / 4, 265 / 87 / 2, 220 / 88 / 2, 129 / 89 / 2, 433 / 90 / 2, 250 / 91 / 2, 461 / 92 / 3, 33 / 93 / 2, 156 / 94 / 3, 233 / 95 / 2, 329 / 96 / 2, 74 / 97 / 3, 378 / 98 / 2, 159 / 99 / 2, 219 / 100 / 2, 456 / 101 / 2, 297 / 102 / 2, 311 / 103 / 2, 469 / 104 / 3, 327 / 105 / 2, 131 / 106 / 3, 43 / 107 / 2, 244 / 108 / 2, 429 / 109 / 3, 157 / 110 / 2, 258 / 111 / 2, 15 / 112 / 2, 88 / 113 / 2, 215 / 114 / 3, 204 / 115 / 2, 351 / 116 / 3, 356 / 117 / 2, 79 / 118 / 2, 490 / 119 / 4, 286 / 120 / 2, 101 / 121 / 2, 441 / 122 / 3, 2 / 123 / 2, 331 / 124 / 3, 391 / 125 / 2, 401 / 126 / 4, 90 / 127 / 2, 53 / 128 / 3, 410 / 129 / 2, 182 / 130 / 2, 86 / 131 / 2, 432 / 132 / 4, 69 / 133 / 2, 153 / 134 / 3, 46 / 135 / 2, 440 / 136 / 3, 475 / 137 / 2, 454 / 138 / 3, 218 / 139 / 2, 270 / 140 / 2, 35 / 141 / 3, 141 / 142 / 2, 124 / 143 / 3, 256 / 144 / 2, 395 / 145 / 2, 216 / 146 / 3, 298 / 147 / 2, 417 / 148 / 2, 369 / 149 / 2, 14 / 150 / 2, 111 / 151 / 3, 476 / 152 / 2, 348 / 153 / 2, 145 / 154 / 2, 324 / 155 / 2, 169 / 156 / 3, 276 / 157 / 2, 283 / 158 / 2, 51 / 159 / 4, 178 / 160 / 2, 445 / 161 / 2, 264 / 162 / 2, 130 / 163 / 2, 306 / 164 / 3, 379 / 165 / 2, 342 / 166 / 3, 39 / 167 / 2, 392 / 168 / 3, 407 / 169 / 2, 194 / 170 / 4, 115 / 171 / 2, 132 / 172 / 2, 18 / 173 / 3, 119 / 174 / 2, 481 / 175 / 3, 68 / 176 / 2, 405 / 177 / 2, 344 / 178 / 3, 72 / 179 / 2, 221 / 180 / 2, 113 / 181 / 2, 213 / 182 / 3, 457 / 183 / 2, 149 / 184 / 3, 246 / 185 / 2, 163 / 186 / 2, 200 / 187 / 2, 123 / 188 / 2, 474 / 189 / 2, 62 / 190 / 2, 122 / 191 / 2, 426 / 192 / 3, 226 / 193 / 2, 166 / 194 / 3, 480 / 195 / 2, 252 / 196 / 2, 332 / 197 / 3, 20 / 198 / 2, 217 / 199 / 3, 397 / 200 / 2, 13 / 201 / 4, 61 / 202 / 2, 214 / 203 / 2, 385 / 204 / 3, 54 / 205 / 2, 361 / 206 / 3, 82 / 207 / 2, 321 / 208 / 2, 459 / 209 / 2, 164 / 210 / 2, 247 / 211 / 2, 239 / 212 / 2, 340 / 213 / 2, 303 / 214 / 3, 367 / 215 / 2, 188 / 216 / 2, 38 / 217 / 2, 24 / 218 / 2, 408 / 219 / 2, 229 / 220 / 3, 335 / 221 / 2, 325 / 222 / 3, 11 / 223 / 2, 345 / 224 / 3, 364 / 225 / 2, 282 / 226 / 3, 193 / 227 / 2, 352 / 228 / 3, 478 / 229 / 2, 301 / 230 / 2, 102 / 231 / 2, 492 / 232 / 5, 323 / 233 / 2, 245 / 234 / 3, 125 / 235 / 2, 349 / 236 / 2, 498 / 237 / 3, 380 / 238 / 2, 326 / 239 / 2, 93 / 240 / 2, 473 / 241 / 3, 302 / 242 / 2, 428 / 243 / 2, 413 / 244 / 3, 289 / 245 / 2, 421 / 246 / 2, 253 / 247 / 4, 222 / 248 / 2, 136 / 249 / 2, 496 / 250 / 4, 45 / 251 / 2, 403 / 252 / 3, 42 / 253 / 2, 322 / 254 / 3, 435 / 255 / 2, 76 / 256 / 2, 3 / 257 / 4, 196 / 258 / 2, 110 / 259 / 2, 133 / 260 / 4, 120 / 261 / 2, 316 / 262 / 2, 495 / 263 / 2, 288 / 264 / 2, 293 / 265 / 3, 430 / 266 / 2, 336 / 267 / 3, 23 / 268 / 2, 294 / 269 / 2, 100 / 270 / 3, 147 / 271 / 2, 491 / 272 / 3, 416 / 273 / 2, 346 / 274 / 3, 487 / 275 / 2, 171 / 276 / 6, 425 / 277 / 2, 89 / 278 / 3, 415 / 279 / 2, 5 / 280 / 2, 34 / 281 / 4, 290 / 282 / 2, 143 / 283 / 2, 117 / 284 / 2, 58 / 285 / 5, 1 / 286 / 2, 359 / 287 / 3, 29 / 288 / 2, 231 / 289 / 4, 499 / 290 / 2, 313 / 291 / 2, 447 / 292 / 4, 78 / 293 / 2, 172 / 294 / 3, 362 / 295 / 2, 366 / 296 / 4, 50 / 297 / 2, 241 / 298 / 2, 360 / 299 / 3, 341 / 300 / 2, 477 / 301 / 2, 155 / 302 / 2, 12 / 303 / 7, 83 / 304 / 2, 191 / 305 / 3, 308 / 306 / 2, 40 / 307 / 3, 55 / 308 / 2, 355 / 309 / 2, 189 / 310 / 2, 287 / 311 / 3, 173 / 312 / 2, 202 / 313 / 3, 422 / 314 / 2, 338 / 315 / 2, 384 / 316 / 2, 70 / 317 / 2, 242 / 318 / 2, 310 / 319 / 2, 468 / 320 / 3, 451 / 321 / 2, 452 / 322 / 2, 319 / 323 / 2, 66 / 324 / 2, 127 / 325 / 2, 318 / 326 / 3, 224 / 327 / 2, 98 / 328 / 2, 260 / 329 / 3, 142 / 330 / 2, 400 / 331 / 3, 37 / 332 / 2, 49 / 333 / 3, 296 / 334 / 2, 179 / 335 / 3, 398 / 336 / 2, 60 / 337 / 3, 140 / 338 / 2, 460 / 339 / 2, 80 / 340 / 3, 44 / 341 / 2, 436 / 342 / 3, 21 / 343 / 2, 419 / 344 / 2, 64 / 345 / 3, 167 / 346 / 2, 192 / 347 / 3, 284 / 348 / 2, 65 / 349 / 2, 56 / 350 / 2, 212 / 351 / 2, 137 / 352 / 4, 185 / 353 / 2, 363 / 354 / 3, 488 / 355 / 2, 485 / 356 / 2, 291 / 357 / 2, 382 / 358 / 2, 437 / 359 / 2, 210 / 360 / 2, 17 / 361 / 2, 279 / 362 / 2, 177 / 363 / 2, 396 / 364 / 6, 390 / 365 / 2, 121 / 366 / 2, 139 / 367 / 2, 36 / 368 / 2, 299 / 369 / 4, 148 / 370 / 2, 41 / 371 / 2, 27 / 372 / 2, 251 / 373 / 3, 96 / 374 / 2, 161 / 375 / 2, 317 / 376 / 2, 48 / 377 / 2, 381 / 378 / 5, 262 / 379 / 2, 450 / 380 / 2, 406 / 381 / 2, 484 / 382 / 2, 95 / 383 / 2, 489 / 384 / 2, 10 / 385 / 3, 105 / 386 / 2, 118 / 387 / 2, 328 / 388 / 2, 160 / 389 / 2, 372 / 390 / 2, 107 / 391 / 6, 394 / 392 / 2, 255 / 393 / 2, 278 / 394 / 2, 104 / 395 / 2, 195 / 396 / 3, 268 / 397 / 2, 370 / 398 / 4, 420 / 399 / 2, 271 / 400 / 2, 126 / 401 / 4, 443 / 402 / 2, 280 / 403 / 3, 334 / 404 / 2, 471 / 405 / 2, 180 / 406 / 3, 333 / 407 / 2, 31 / 408 / 2, 309 / 409 / 2, 190 / 410 / 2, 269 / 411 / 3, 158 / 412 / 2, 295 / 413 / 2, 465 / 414 / 2, 146 / 415 / 2, 211 / 416 / 2, 106 / 417 / 2, 393 / 418 / 2, 99 / 419 / 4, 152 / 420 / 2, 103 / 421 / 2, 431 / 422 / 4, 365 / 423 / 2, 411 / 424 / 2, 184 / 425 / 3, 446 / 426 / 2, 448 / 427 / 2, 330 / 428 / 3, 472 / 429 / 2, 424 / 430 / 2, 275 / 431 / 2, 154 / 432 / 3, 467 / 433 / 2, 439 / 434 / 2, 389 / 435 / 2, 232 / 436 / 5, 272 / 437 / 2, 235 / 438 / 3, 482 / 439 / 2, 234 / 440 / 2, 402 / 441 / 2, 292 / 442 / 4, 376 / 443 / 2, 28 / 444 / 3, 59 / 445 / 2, 174 / 446 / 2, 266 / 447 / 2, 412 / 448 / 3, 444 / 449 / 2, 32 / 450 / 2, 373 / 451 / 4, 203 / 452 / 2, 449 / 453 / 2, 423 / 454 / 2, 409 / 455 / 7, 225 / 456 / 2, 92 / 457 / 2, 67 / 458 / 2, 165 / 459 / 3, 261 / 460 / 2, 320 / 461 / 3, 162 / 462 / 2, 114 / 463 / 2, 339 / 464 / 2, 108 / 465 / 6, 404 / 466 / 2, 300 / 467 / 3, 455 / 468 / 2, 442 / 469 / 2, 175 / 470 / 2, 427 / 471 / 2, 181 / 472 / 2, 350 / 473 / 3, 208 / 474 / 2, 176 / 475 / 2, 6 / 476 / 2, 274 / 477 / 2, 77 / 478 / 2, 453 / 479 / 6, 209 / 480 / 2, 144 / 481 / 2, 135 / 482 / 2, 285 / 483 / 2, 354 / 484 / 2, 73 / 485 / 5, 183 / 486 / 2, 386 / 487 / 2, 493 / 488 / 2, 273 / 489 / 2, 237 / 490 / 2, 63 / 491 / 2, 25 / 492 / 4, 238 / 493 / 2, 198 / 494 / 2, 151 / 495 / 2, 371 / 496 / 2, 267 / 497 / 4, 94 / 498 / 2, 236 / 499 / 2
singlecenter-alpha_1-100-n100.txt, 1, 1, 100, 1249.38, 864, 764, 8, 99,40 / 1 / 4, 83 / 2 / 2, 8 / 3 / 3, 79 / 4 / 2, 69 / 5 / 3, 18 / 6 / 2, 6 / 7 / 2, 16 / 8 / 8, 93 / 9 / 2, 37 / 10 / 2, 70 / 11 / 2, 72 / 12 / 2, 33 / 13 / 2, 15 / 14 / 2, 34 / 15 / 2, 17 / 16 / 2, 46 / 17 / 2, 43 / 18 / 2, 47 / 19 / 2, 62 / 20 / 4, 22 / 21 / 2, 54 / 22 / 2, 65 / 23 / 3, 90 / 24 / 2, 50 / 25 / 3, 3 / 26 / 2, 56 / 27 / 3, 32 / 28 / 2, 92 / 29 / 2, 29 / 30 / 2, 44 / 31 / 2, 60 / 32 / 2, 99 / 33 / 4, 77 / 34 / 2, 63 / 35 / 2, 19 / 36 / 2, 4 / 37 / 4, 55 / 38 / 2, 53 / 39 / 3, 12 / 40 / 2, 76 / 41 / 3, 98 / 42 / 2, 1 / 43 / 3, 52 / 44 / 2, 71 / 45 / 2, 81 / 46 / 2, 97 / 47 / 4, 48 / 48 / 2, 94 / 49 / 3, 28 / 50 / 2, 84 / 51 / 2, 57 / 52 / 3, 25 / 53 / 2, 74 / 54 / 3, 89 / 55 / 2, 86 / 56 / 3, 64 / 57 / 2, 39 / 58 / 2, 41 / 59 / 2, 14 / 60 / 2, 51 / 61 / 4, 27 / 62 / 2, 58 / 63 / 2, 49 / 64 / 2, 23 / 65 / 4, 91 / 66 / 2, 35 / 67 / 2, 11 / 68 / 2, 30 / 69 / 2, 36 / 70 / 2, 45 / 71 / 2, 10 / 72 / 2, 5 / 73 / 7, 31 / 74 / 2, 87 / 75 / 2, 73 / 76 / 2, 95 / 77 / 2, 68 / 78 / 3, 96 / 79 / 2, 82 / 80 / 2, 13 / 81 / 3, 42 / 82 / 2, 80 / 83 / 3, 78 / 84 / 2, 75 / 85 / 2, 26 / 86 / 3, 7 / 87 / 2, 38 / 88 / 2, 85 / 89 / 3, 2 / 90 / 2, 59 / 91 / 4, 9 / 92 / 2, 61 / 93 / 2, 67 / 94 / 3, 66 / 95 / 2, 20 / 96 / 2, 21 / 97 / 2, 88 / 98 / 4, 24 / 99 / 2
singlecenter-alpha_1-101-n175.txt, 1, 1, 175, 1844.41, 1554, 1379, 12, 174,22 / 1 / 2, 134 / 2 / 2, 148 / 3 / 2, 12 / 4 / 2, 131 / 5 / 3, 2 / 6 / 2, 37 / 7 / 3, 93 / 8 / 2, 96 / 9 / 2, 48 / 10 / 2, 153 / 11 / 4, 4 / 12 / 2, 6 / 13 / 2, 163 / 14 / 4, 56 / 15 / 2, 129 / 16 / 3, 87 / 17 / 2, 135 / 18 / 2, 92 / 19 / 2, 36 / 20 / 2, 79 / 21 / 3, 63 / 22 / 2, 160 / 23 / 3, 149 / 24 / 2, 147 / 25 / 3, 112 / 26 / 2, 125 / 27 / 2, 1 / 28 / 2, 115 / 29 / 4, 80 / 30 / 2, 83 / 31 / 2, 164 / 32 / 3, 54 / 33 / 2, 140 / 34 / 2, 67 / 35 / 3, 168 / 36 / 2, 123 / 37 / 2, 170 / 38 / 2, 141 / 39 / 2, 121 / 40 / 3, 69 / 41 / 2, 111 / 42 / 3, 30 / 43 / 2, 84 / 44 / 12, 161 / 45 / 2, 130 / 46 / 2, 97 / 47 / 2, 138 / 48 / 2, 47 / 49 / 2, 102 / 50 / 2, 9 / 51 / 2, 45 / 52 / 2, 167 / 53 / 3, 172 / 54 / 2, 78 / 55 / 3, 49 / 56 / 2, 119 / 57 / 2, 11 / 58 / 4, 117 / 59 / 2, 159 / 60 / 2, 65 / 61 / 2, 21 / 62 / 2, 128 / 63 / 2, 151 / 64 / 2, 27 / 65 / 2, 43 / 66 / 3, 105 / 67 / 2, 14 / 68 / 4, 29 / 69 / 2, 16 / 70 / 2, 20 / 71 / 2, 26 / 72 / 2, 88 / 73 / 3, 94 / 74 / 2, 64 / 75 / 7, 118 / 76 / 2, 109 / 77 / 3, 77 / 78 / 2, 40 / 79 / 3, 124 / 80 / 2, 95 / 81 / 3, 158 / 82 / 2, 166 / 83 / 2, 116 / 84 / 2, 108 / 85 / 6, 113 / 86 / 2, 34 / 87 / 2, 90 / 88 / 2, 19 / 89 / 4, 101 / 90 / 2, 15 / 91 / 2, 120 / 92 / 3, 139 / 93 / 2, 106 / 94 / 2, 5 / 95 / 2, 62 / 96 / 3, 72 / 97 / 2, 23 / 98 / 2, 35 / 99 / 4, 110 / 100 / 2, 8 / 101 / 2, 39 / 102 / 3, 76 / 103 / 2, 174 / 104 / 3, 157 / 105 / 2, 31 / 106 / 2, 42 / 107 / 2, 86 / 108 / 4, 126 / 109 / 2, 41 / 110 / 2, 154 / 111 / 3, 44 / 112 / 2, 137 / 113 / 2, 104 / 114 / 2, 50 / 115 / 2, 75 / 116 / 2, 173 / 117 / 2, 100 / 118 / 2, 74 / 119 / 2, 10 / 120 / 2, 133 / 121 / 2, 58 / 122 / 4, 146 / 123 / 2, 155 / 124 / 2, 171 / 125 / 2, 57 / 126 / 2, 52 / 127 / 2, 114 / 128 / 9, 152 / 129 / 2, 24 / 130 / 2, 13 / 131 / 3, 33 / 132 / 2, 156 / 133 / 2, 73 / 134 / 2, 127 / 135 / 3, 132 / 136 / 2, 91 / 137 / 2, 38 / 138 / 2, 122 / 139 / 2, 169 / 140 / 3, 17 / 141 / 2, 61 / 142 / 3, 150 / 143 / 2, 53 / 144 / 3, 85 / 145 / 2, 7 / 146 / 3, 18 / 147 / 2, 165 / 148 / 2, 136 / 149 / 2, 143 / 150 / 3, 46 / 151 / 2, 89 / 152 / 3, 60 / 153 / 2, 25 / 154 / 2, 81 / 155 / 2, 98 / 156 / 5, 55 / 157 / 2, 51 / 158 / 2, 66 / 159 / 2, 28 / 160 / 3, 162 / 161 / 2, 103 / 162 / 3, 3 / 163 / 2, 82 / 164 / 3, 144 / 165 / 2, 107 / 166 / 2, 145 / 167 / 2, 71 / 168 / 2, 32 / 169 / 2, 59 / 170 / 2, 99 / 171 / 2, 142 / 172 / 2, 68 / 173 / 4, 70 / 174 / 2
singlecenter-alpha_1-102-n175.txt, 1, 1, 175, 1846.54, 1392, 1217, 7, 174,96 / 1 / 4, 145 / 2 / 2, 73 / 3 / 2, 31 / 4 / 2, 103 / 5 / 2, 35 / 6 / 2, 9 / 7 / 2, 48 / 8 / 2, 63 / 9 / 2, 50 / 10 / 3, 114 / 11 / 2, 86 / 12 / 2, 134 / 13 / 3, 26 / 14 / 2, 108 / 15 / 2, 17 / 16 / 3, 77 / 17 / 2, 130 / 18 / 4, 121 / 19 / 2, 137 / 20 / 2, 141 / 21 / 2, 151 / 22 / 3, 160 / 23 / 2, 41 / 24 / 3, 166 / 25 / 2, 71 / 26 / 3, 68 / 27 / 2, 34 / 28 / 3, 82 / 29 / 2, 158 / 30 / 3, 72 / 31 / 2, 129 / 32 / 2, 80 / 33 / 4, 87 / 34 / 2, 45 / 35 / 2, 94 / 36 / 4, 174 / 37 / 2, 52 / 38 / 3, 146 / 39 / 2, 2 / 40 / 3, 118 / 41 / 2, 39 / 42 / 2, 47 / 43 / 2, 140 / 44 / 2, 131 / 45 / 2, 6 / 46 / 3, 10 / 47 / 2, 154 / 48 / 2, 162 / 49 / 2, 144 / 50 / 4, 58 / 51 / 2, 20 / 52 / 2, 107 / 53 / 2, 61 / 54 / 2, 99 / 55 / 3, 28 / 56 / 2, 36 / 57 / 3, 101 / 58 / 2, 60 / 59 / 2, 135 / 60 / 3, 120 / 61 / 2, 124 / 62 / 3, 163 / 63 / 2, 78 / 64 / 2, 74 / 65 / 3, 62 / 66 / 2, 113 / 67 / 5, 49 / 68 / 2, 25 / 69 / 2, 88 / 70 / 2, 69 / 71 / 3, 75 / 72 / 2, 116 / 73 / 4, 105 / 74 / 2, 142 / 75 / 2, 59 / 76 / 3, 38 / 77 / 2, 95 / 78 / 2, 32 / 79 / 2, 76 / 80 / 2, 150 / 81 / 2, 70 / 82 / 7, 104 / 83 / 2, 119 / 84 / 2, 159 / 85 / 2, 56 / 86 / 2, 126 / 87 / 4, 79 / 88 / 2, 23 / 89 / 2, 12 / 90 / 2, 85 / 91 / 4, 22 / 92 / 2, 53 / 93 / 2, 37 / 94 / 3, 40 / 95 / 2, 138 / 96 / 3, 125 / 97 / 2, 51 / 98 / 3, 4 / 99 / 2, 110 / 100 / 2, 54 / 101 / 6, 81 / 102 / 2, 173 / 103 / 2, 132 / 104 / 2, 171 / 105 / 3, 102 / 106 / 2, 97 / 107 / 2, 148 / 108 / 2, 100 / 109 / 2, 147 / 110 / 2, 92 / 111 / 2, 64 / 112 / 2, 152 / 113 / 3, 90 / 114 / 2, 30 / 115 / 2, 29 / 116 / 3, 46 / 117 / 2, 5 / 118 / 2, 165 / 119 / 2, 168 / 120 / 2, 13 / 121 / 2, 153 / 122 / 2, 155 / 123 / 2, 139 / 124 / 2, 15 / 125 / 4, 65 / 126 / 2, 11 / 127 / 2, 43 / 128 / 3, 149 / 129 / 2, 42 / 130 / 2, 27 / 131 / 3, 57 / 132 / 2, 67 / 133 / 3, 33 / 134 / 2, 157 / 135 / 3, 161 / 136 / 2, 109 / 137 / 3, 136 / 138 / 2, 3 / 139 / 2, 18 / 140 / 2, 133 / 141 / 2, 143 / 142 / 2, 14 / 143 / 2, 98 / 144 / 2, 24 / 145 / 2, 169 / 146 / 5, 66 / 147 / 2, 128 / 148 / 2, 111 / 149 / 2, 21 / 150 / 4, 170 / 151 / 2, 167 / 152 / 2, 8 / 153 / 3, 16 / 154 / 2, 1 / 155 / 2, 19 / 156 / 2, 122 / 157 / 2, 115 / 158 / 2, 44 / 159 / 2, 172 / 160 / 2, 117 / 161 / 3, 112 / 162 / 2, 83 / 163 / 2, 84 / 164 / 2, 89 / 165 / 2, 156 / 166 / 3, 127 / 167 / 2, 55 / 168 / 2, 164 / 169 / 2, 123 / 170 / 6, 93 / 171 / 2, 106 / 172 / 3, 91 / 173 / 2, 7 / 174 / 5
singlecenter-alpha_1-103-n175.txt, 1, 1, 175, 1793.48, 1390, 1215, 6, 174,138 / 1 / 3, 37 / 2 / 2, 23 / 3 / 2, 26 / 4 / 2, 75 / 5 / 2, 101 / 6 / 2, 9 / 7 / 2, 48 / 8 / 4, 62 / 9 / 2, 16 / 10 / 2, 84 / 11 / 2, 157 / 12 / 2, 115 / 13 / 3, 40 / 14 / 2, 99 / 15 / 3, 79 / 16 / 2, 61 / 17 / 2, 159 / 18 / 2, 165 / 19 / 2, 90 / 20 / 2, 13 / 21 / 2, 64 / 22 / 4, 128 / 23 / 2, 155 / 24 / 2, 24 / 25 / 4, 118 / 26 / 2, 125 / 27 / 2, 170 / 28 / 2, 31 / 29 / 2, 135 / 30 / 4, 97 / 31 / 2, 50 / 32 / 2, 43 / 33 / 4, 68 / 34 / 2, 77 / 35 / 2, 45 / 36 / 3, 17 / 37 / 2, 11 / 38 / 2, 22 / 39 / 6, 56 / 40 / 2, 34 / 41 / 2, 80 / 42 / 2, 6 / 43 / 2, 127 / 44 / 4, 55 / 45 / 2, 154 / 46 / 2, 116 / 47 / 2, 150 / 48 / 2, 82 / 49 / 2, 35 / 50 / 2, 156 / 51 / 2, 53 / 52 / 2, 109 / 53 / 5, 41 / 54 / 2, 66 / 55 / 2, 161 / 56 / 2, 124 / 57 / 2, 58 / 58 / 3, 74 / 59 / 2, 72 / 60 / 2, 152 / 61 / 2, 20 / 62 / 5, 132 / 63 / 2, 100 / 64 / 2, 93 / 65 / 2, 71 / 66 / 2, 4 / 67 / 2, 73 / 68 / 2, 25 / 69 / 2, 95 / 70 / 3, 112 / 71 / 2, 163 / 72 / 3, 27 / 73 / 2, 46 / 74 / 2, 8 / 75 / 2, 36 / 76 / 2, 144 / 77 / 2, 33 / 78 / 2, 76 / 79 / 2, 113 / 80 / 2, 96 / 81 / 2, 147 / 82 / 2, 106 / 83 / 2, 49 / 84 / 6, 141 / 85 / 2, 122 / 86 / 3, 129 / 87 / 2, 86 / 88 / 2, 39 / 89 / 2, 171 / 90 / 3, 168 / 91 / 2, 94 / 92 / 3, 30 / 93 / 2, 149 / 94 / 2, 139 / 95 / 2, 134 / 96 / 2, 70 / 97 / 4, 69 / 98 / 2, 148 / 99 / 2, 133 / 100 / 4, 10 / 101 / 2, 32 / 102 / 2, 47 / 103 / 2, 54 / 104 / 5, 174 / 105 / 2, 114 / 106 / 2, 83 / 107 / 3, 12 / 108 / 2, 131 / 109 / 2, 78 / 110 / 2, 162 / 111 / 2, 18 / 112 / 2, 63 / 113 / 2, 60 / 114 / 2, 15 / 115 / 3, 1 / 116 / 2, 107 / 117 / 2, 85 / 118 / 6, 117 / 119 / 2, 88 / 120 / 2, 59 / 121 / 2, 153 / 122 / 2, 145 / 123 / 3, 3 / 124 / 2, 89 / 125 / 6, 136 / 126 / 2, 104 / 127 / 3, 65 / 128 / 2, 81 / 129 / 2, 120 / 130 / 2, 91 / 131 / 3, 151 / 132 / 2, 38 / 133 / 3, 92 / 134 / 2, 142 / 135 / 2, 57 / 136 / 3, 52 / 137 / 2, 21 / 138 / 2, 98 / 139 / 3, 173 / 140 / 2, 2 / 141 / 2, 140 / 142 / 3, 108 / 143 / 2, 51 / 144 / 3, 172 / 145 / 2, 160 / 146 / 2, 103 / 147 / 2, 29 / 148 / 2, 28 / 149 / 2, 146 / 150 / 3, 121 / 151 / 2, 130 / 152 / 2, 102 / 153 / 2, 143 / 154 / 2, 164 / 155 / 4, 67 / 156 / 2, 111 / 157 / 2, 158 / 158 / 3, 119 / 159 / 2, 167 / 160 / 2, 169 / 161 / 5, 137 / 162 / 2, 42 / 163 / 3, 87 / 164 / 2, 166 / 165 / 2, 105 / 166 / 3, 7 / 167 / 2, 123 / 168 / 3, 126 / 169 / 2, 44 / 170 / 2, 110 / 171 / 2, 14 / 172 / 2, 5 / 173 / 2, 19 / 174 / 3
singlecenter-alpha_1-104-n175.txt, 1, 1, 175, 1874.22, 1476, 1301, 11, 174,96 / 1 / 4, 80 / 2 / 2, 43 / 3 / 2, 88 / 4 / 3, 113 / 5 / 2, 174 / 6 / 4, 168 / 7 / 2, 169 / 8 / 2, 84 / 9 / 3, 132 / 10 / 2, 26 / 11 / 3, 152 / 12 / 2, 171 / 13 / 2, 128 / 14 / 2, 162 / 15 / 11, 79 / 16 / 2, 159 / 17 / 3, 15 / 18 / 2, 86 / 19 / 3, 2 / 20 / 2, 50 / 21 / 3, 131 / 22 / 2, 60 / 23 / 2, 134 / 24 / 3, 75 / 25 / 2, 91 / 26 / 2, 116 / 27 / 2, 145 / 28 / 2, 161 / 29 / 2, 130 / 30 / 3, 55 / 31 / 2, 129 / 32 / 3, 104 / 33 / 2, 98 / 34 / 2, 78 / 35 / 2, 41 / 36 / 2, 54 / 37 / 2, 22 / 38 / 4, 38 / 39 / 2, 97 / 40 / 3, 31 / 41 / 2, 13 / 42 / 3, 65 / 43 / 2, 165 / 44 / 2, 143 / 45 / 4, 67 / 46 / 2, 149 / 47 / 2, 17 / 48 / 2, 10 / 49 / 2, 62 / 50 / 3, 148 / 51 / 2, 49 / 52 / 3, 133 / 53 / 2, 110 / 54 / 2, 9 / 55 / 2, 140 / 56 / 2, 109 / 57 / 2, 160 / 58 / 2, 72 / 59 / 2, 89 / 60 / 2, 157 / 61 / 2, 92 / 62 / 4, 94 / 63 / 2, 158 / 64 / 2, 70 / 65 / 5, 12 / 66 / 2, 103 / 67 / 3, 126 / 68 / 2, 170 / 69 / 4, 90 / 70 / 2, 120 / 71 / 2, 87 / 72 / 2, 144 / 73 / 2, 23 / 74 / 2, 27 / 75 / 2, 142 / 76 / 2, 136 / 77 / 2, 119 / 78 / 2, 74 / 79 / 3, 93 / 80 / 2, 100 / 81 / 3, 146 / 82 / 2, 115 / 83 / 2, 124 / 84 / 3, 63 / 85 / 2, 154 / 86 / 3, 46 / 87 / 2, 40 / 88 / 2, 11 / 89 / 2, 56 / 90 / 2, 6 / 91 / 2, 118 / 92 / 2, 111 / 93 / 2, 77 / 94 / 3, 7 / 95 / 2, 30 / 96 / 2, 123 / 97 / 2, 61 / 98 / 3, 4 / 99 / 2, 99 / 100 / 2, 83 / 101 / 2, 108 / 102 / 2, 117 / 103 / 2, 47 / 104 / 2, 3 / 105 / 2, 36 / 106 / 2, 35 / 107 / 2, 68 / 108 / 2, 34 / 109 / 2, 20 / 110 / 2, 21 / 111 / 3, 139 / 112 / 2, 81 / 113 / 2, 71 / 114 / 2, 5 / 115 / 2, 153 / 116 / 2, 18 / 117 / 2, 106 / 118 / 3, 53 / 119 / 2, 19 / 120 / 3, 173 / 121 / 2, 69 / 122 / 3, 164 / 123 / 2, 112 / 124 / 2, 57 / 125 / 2, 138 / 126 / 4, 102 / 127 / 2, 48 / 128 / 2, 76 / 129 / 4, 29 / 130 / 2, 44 / 131 / 2, 14 / 132 / 2, 121 / 133 / 2, 163 / 134 / 4, 156 / 135 / 2, 24 / 136 / 2, 85 / 137 / 3, 147 / 138 / 2, 28 / 139 / 2, 16 / 140 / 6, 25 / 141 / 2, 66 / 142 / 2, 73 / 143 / 3, 167 / 144 / 2, 1 / 145 / 3, 52 / 146 / 2, 150 / 147 / 3, 105 / 148 / 2, 166 / 149 / 2, 101 / 150 / 7, 135 / 151 / 2, 137 / 152 / 2, 32 / 153 / 2, 37 / 154 / 3, 51 / 155 / 2, 42 / 156 / 2, 64 / 157 / 3, 95 / 158 / 2, 59 / 159 / 3, 151 / 160 / 2, 141 / 161 / 2, 114 / 162 / 2, 172 / 163 / 4, 8 / 164 / 2, 33 / 165 / 2, 45 / 166 / 2, 122 / 167 / 2, 58 / 168 / 2, 107 / 169 / 2, 82 / 170 / 2, 39 / 171 / 2, 127 / 172 / 2, 125 / 173 / 5, 155 / 174 / 2
singlecenter-alpha_1-105-n175.txt, 1, 1, 175, 1861.92, 1511, 1336, 9, 174,69 / 1 / 2, 156 / 2 / 2, 66 / 3 / 2, 43 / 4 / 2, 133 / 5 / 2, 130 / 6 / 2, 36 / 7 / 3, 161 / 8 / 2, 121 / 9 / 2, 13 / 10 / 3, 33 / 11 / 2, 97 / 12 / 3, 136 / 13 / 2, 68 / 14 / 2, 81 / 15 / 3, 168 / 16 / 2, 14 / 17 / 2, 11 / 18 / 5, 91 / 19 / 2, 34 / 20 / 2, 78 / 21 / 2, 165 / 22 / 2, 42 / 23 / 2, 106 / 24 / 5, 158 / 25 / 2, 167 / 26 / 2, 84 / 27 / 2, 9 / 28 / 2, 64 / 29 / 2, 54 / 30 / 2, 55 / 31 / 6, 98 / 32 / 2, 102 / 33 / 3, 115 / 34 / 2, 53 / 35 / 2, 12 / 36 / 2, 92 / 37 / 2, 109 / 38 / 2, 119 / 39 / 2, 127 / 40 / 2, 1 / 41 / 2, 124 / 42 / 2, 160 / 43 / 2, 61 / 44 / 3, 95 / 45 / 2, 37 / 46 / 2, 169 / 47 / 3, 35 / 48 / 2, 171 / 49 / 3, 22 / 50 / 2, 6 / 51 / 2, 3 / 52 / 2, 101 / 53 / 2, 25 / 54 / 3, 83 / 55 / 2, 138 / 56 / 3, 8 / 57 / 2, 110 / 58 / 2, 116 / 59 / 2, 32 / 60 / 2, 140 / 61 / 2, 151 / 62 / 2, 144 / 63 / 3, 39 / 64 / 2, 154 / 65 / 2, 131 / 66 / 2, 166 / 67 / 2, 47 / 68 / 3, 30 / 69 / 2, 153 / 70 / 3, 58 / 71 / 2, 123 / 72 / 2, 7 / 73 / 3, 85 / 74 / 2, 100 / 75 / 3, 75 / 76 / 2, 120 / 77 / 2, 174 / 78 / 3, 59 / 79 / 2, 117 / 80 / 3, 162 / 81 / 2, 170 / 82 / 3, 159 / 83 / 2, 93 / 84 / 2, 2 / 85 / 2, 17 / 86 / 3, 56 / 87 / 2, 63 / 88 / 2, 29 / 89 / 3, 27 / 90 / 2, 146 / 91 / 2, 15 / 92 / 2, 28 / 93 / 3, 96 / 94 / 2, 67 / 95 / 2, 70 / 96 / 3, 50 / 97 / 2, 65 / 98 / 3, 164 / 99 / 2, 149 / 100 / 7, 52 / 101 / 2, 139 / 102 / 2, 142 / 103 / 2, 134 / 104 / 3, 72 / 105 / 2, 125 / 106 / 2, 80 / 107 / 2, 10 / 108 / 2, 40 / 109 / 5, 155 / 110 / 2, 94 / 111 / 2, 46 / 112 / 2, 152 / 113 / 9, 24 / 114 / 2, 129 / 115 / 2, 74 / 116 / 3, 16 / 117 / 2, 44 / 118 / 2, 26 / 119 / 4, 150 / 120 / 2, 163 / 121 / 3, 111 / 122 / 2, 31 / 123 / 2, 82 / 124 / 3, 57 / 125 / 2, 90 / 126 / 2, 145 / 127 / 2, 86 / 128 / 2, 114 / 129 / 2, 103 / 130 / 2, 18 / 131 / 3, 89 / 132 / 2, 173 / 133 / 8, 38 / 134 / 2, 141 / 135 / 3, 88 / 136 / 2, 118 / 137 / 2, 48 / 138 / 2, 45 / 139 / 2, 128 / 140 / 2, 143 / 141 / 2, 19 / 142 / 2, 147 / 143 / 4, 135 / 144 / 2, 49 / 145 / 2, 77 / 146 / 2, 122 / 147 / 2, 107 / 148 / 4, 51 / 149 / 2, 113 / 150 / 2, 5 / 151 / 4, 126 / 152 / 2, 112 / 153 / 2, 172 / 154 / 2, 76 / 155 / 2, 20 / 156 / 4, 23 / 157 / 2, 41 / 158 / 2, 108 / 159 / 2, 104 / 160 / 2, 99 / 161 / 2, 148 / 162 / 4, 132 / 163 / 2, 137 / 164 / 2, 60 / 165 / 2, 21 / 166 / 2, 87 / 167 / 2, 157 / 168 / 2, 105 / 169 / 4, 73 / 170 / 2, 71 / 171 / 2, 79 / 172 / 2, 4 / 173 / 2, 62 / 174 / 3
singlecenter-alpha_1-106-n175.txt, 1, 1, 175, 1914.16, 1321, 1146, 6, 174,128 / 1 / 2, 55 / 2 / 2, 28 / 3 / 2, 131 / 4 / 2, 104 / 5 / 2, 53 / 6 / 2, 76 / 7 / 2, 170 / 8 / 2, 140 / 9 / 2, 36 / 10 / 2, 26 / 11 / 3, 87 / 12 / 2, 27 / 13 / 3, 52 / 14 / 2, 130 / 15 / 2, 158 / 16 / 2, 30 / 17 / 2, 37 / 18 / 4, 141 / 19 / 2, 106 / 20 / 2, 129 / 21 / 2, 125 / 22 / 3, 95 / 23 / 2, 132 / 24 / 2, 110 / 25 / 2, 121 / 26 / 2, 11 / 27 / 2, 124 / 28 / 3, 105 / 29 / 2, 92 / 30 / 2, 147 / 31 / 2, 138 / 32 / 2, 160 / 33 / 2, 74 / 34 / 2, 62 / 35 / 2, 54 / 36 / 2, 149 / 37 / 5, 144 / 38 / 2, 151 / 39 / 2, 12 / 40 / 3, 83 / 41 / 2, 47 / 42 / 2, 59 / 43 / 6, 9 / 44 / 2, 16 / 45 / 2, 146 / 46 / 2, 172 / 47 / 3, 34 / 48 / 2, 8 / 49 / 6, 21 / 50 / 2, 123 / 51 / 3, 113 / 52 / 2, 32 / 53 / 3, 25 / 54 / 2, 142 / 55 / 2, 44 / 56 / 4, 51 / 57 / 2, 89 / 58 / 2, 98 / 59 / 3, 136 / 60 / 2, 85 / 61 / 2, 60 / 62 / 3, 58 / 63 / 2, 7 / 64 / 3, 2 / 65 / 2, 118 / 66 / 3, 90 / 67 / 2, 134 / 68 / 2, 45 / 69 / 2, 112 / 70 / 2, 103 / 71 / 2, 70 / 72 / 2, 164 / 73 / 2, 33 / 74 / 2, 154 / 75 / 2, 93 / 76 / 2, 31 / 77 / 3, 148 / 78 / 2, 100 / 79 / 3, 127 / 80 / 2, 169 / 81 / 3, 39 / 82 / 2, 81 / 83 / 3, 68 / 84 / 2, 153 / 85 / 2, 75 / 86 / 3, 56 / 87 / 2, 165 / 88 / 4, 24 / 89 / 2, 119 / 90 / 2, 41 / 91 / 2, 114 / 92 / 2, 120 / 93 / 2, 79 / 94 / 2, 84 / 95 / 2, 5 / 96 / 3, 4 / 97 / 2, 71 / 98 / 2, 82 / 99 / 3, 173 / 100 / 2, 168 / 101 / 3, 111 / 102 / 2, 126 / 103 / 3, 73 / 104 / 2, 115 / 105 / 2, 99 / 106 / 6, 122 / 107 / 2, 143 / 108 / 2, 17 / 109 / 2, 174 / 110 / 2, 133 / 111 / 2, 48 / 112 / 4, 96 / 113 / 2, 42 / 114 / 2, 80 / 115 / 2, 67 / 116 / 2, 43 / 117 / 2, 69 / 118 / 3, 1 / 119 / 2, 20 / 120 / 3, 61 / 121 / 2, 135 / 122 / 3, 3 / 123 / 2, 13 / 124 / 2, 18 / 125 / 2, 159 / 126 / 2, 64 / 127 / 2, 157 / 128 / 3, 49 / 129 / 2, 86 / 130 / 3, 117 / 131 / 2, 116 / 132 / 2, 102 / 133 / 2, 6 / 134 / 4, 23 / 135 / 2, 91 / 136 / 3, 155 / 137 / 2, 108 / 138 / 2, 14 / 139 / 3, 88 / 140 / 2, 107 / 141 / 6, 46 / 142 / 2, 150 / 143 / 3, 97 / 144 / 2, 65 / 145 / 3, 161 / 146 / 2, 57 / 147 / 3, 145 / 148 / 2, 101 / 149 / 2, 35 / 150 / 2, 19 / 151 / 2, 40 / 152 / 2, 167 / 153 / 3, 137 / 154 / 2, 171 / 155 / 2, 22 / 156 / 3, 162 / 157 / 2, 163 / 158 / 2, 29 / 159 / 3, 72 / 160 / 2, 156 / 161 / 3, 78 / 162 / 2, 66 / 163 / 3, 152 / 164 / 2, 109 / 165 / 3, 94 / 166 / 2, 50 / 167 / 2, 15 / 168 / 2, 139 / 169 / 2, 77 / 170 / 2, 166 / 171 / 3, 63 / 172 / 2, 10 / 173 / 6, 38 / 174 / 2
singlecenter-alpha_1-107-n175.txt, 1, 1, 175, 1970.37, 1443, 1268, 11, 174,106 / 1 / 2, 132 / 2 / 2, 51 / 3 / 2, 118 / 4 / 2, 63 / 5 / 2, 130 / 6 / 3, 102 / 7 / 2, 81 / 8 / 3, 112 / 9 / 2, 154 / 10 / 2, 9 / 11 / 2, 73 / 12 / 3, 122 / 13 / 2, 139 / 14 / 3, 50 / 15 / 2, 35 / 16 / 2, 60 / 17 / 3, 165 / 18 / 2, 74 / 19 / 3, 26 / 20 / 2, 105 / 21 / 2, 56 / 22 / 3, 85 / 23 / 2, 161 / 24 / 2, 167 / 25 / 3, 46 / 26 / 2, 18 / 27 / 2, 137 / 28 / 2, 36 / 29 / 5, 3 / 30 / 2, 27 / 31 / 3, 69 / 32 / 2, 23 / 33 / 3, 44 / 34 / 2, 49 / 35 / 2, 8 / 36 / 2, 121 / 37 / 2, 104 / 38 / 3, 166 / 39 / 2, 31 / 40 / 3, 116 / 41 / 2, 82 / 42 / 3, 123 / 43 / 2, 16 / 44 / 4, 28 / 45 / 2, 138 / 46 / 2, 110 / 47 / 4, 164 / 48 / 2, 108 / 49 / 2, 76 / 50 / 2, 95 / 51 / 3, 5 / 52 / 2, 93 / 53 / 3, 25 / 54 / 2, 72 / 55 / 2, 87 / 56 / 2, 79 / 57 / 2, 45 / 58 / 2, 125 / 59 / 2, 12 / 60 / 4, 42 / 61 / 2, 107 / 62 / 2, 20 / 63 / 2, 39 / 64 / 4, 54 / 65 / 2, 64 / 66 / 2, 61 / 67 / 2, 58 / 68 / 4, 129 / 69 / 2, 156 / 70 / 2, 62 / 71 / 2, 101 / 72 / 2, 33 / 73 / 2, 96 / 74 / 3, 80 / 75 / 2, 98 / 76 / 2, 48 / 77 / 2, 17 / 78 / 2, 171 / 79 / 3, 91 / 80 / 2, 152 / 81 / 2, 55 / 82 / 3, 169 / 83 / 2, 168 / 84 / 3, 135 / 85 / 2, 113 / 86 / 3, 30 / 87 / 2, 11 / 88 / 2, 144 / 89 / 2, 143 / 90 / 2, 13 / 91 / 2, 92 / 92 / 4, 174 / 93 / 2, 14 / 94 / 2, 7 / 95 / 3, 127 / 96 / 2, 133 / 97 / 2, 134 / 98 / 2, 119 / 99 / 4, 126 / 100 / 2, 47 / 101 / 2, 68 / 102 / 2, 94 / 103 / 3, 120 / 104 / 2, 2 / 105 / 2, 141 / 106 / 2, 162 / 107 / 2, 65 / 108 / 2, 22 / 109 / 2, 158 / 110 / 3, 70 / 111 / 2, 131 / 112 / 2, 90 / 113 / 4, 19 / 114 / 2, 84 / 115 / 2, 89 / 116 / 2, 153 / 117 / 3, 24 / 118 / 2, 128 / 119 / 3, 29 / 120 / 2, 57 / 121 / 4, 151 / 122 / 2, 66 / 123 / 2, 88 / 124 / 4, 170 / 125 / 2, 59 / 126 / 2, 145 / 127 / 3, 136 / 128 / 2, 52 / 129 / 3, 78 / 130 / 2, 4 / 131 / 3, 157 / 132 / 2, 142 / 133 / 2, 155 / 134 / 3, 173 / 135 / 2, 71 / 136 / 2, 111 / 137 / 11, 40 / 138 / 2, 32 / 139 / 2, 103 / 140 / 2, 124 / 141 / 2, 75 / 142 / 3, 6 / 143 / 2, 43 / 144 / 3, 163 / 145 / 2, 148 / 146 / 2, 41 / 147 / 5, 37 / 148 / 2, 53 / 149 / 2, 77 / 150 / 3, 10 / 151 / 2, 147 / 152 / 5, 140 / 153 / 2, 114 / 154 / 2, 160 / 155 / 2, 97 / 156 / 2, 15 / 157 / 2, 1 / 158 / 3, 172 / 159 / 2, 146 / 160 / 2, 159 / 161 / 2, 86 / 162 / 2, 149 / 163 / 2, 21 / 164 / 2, 83 / 165 / 3, 117 / 166 / 2, 115 / 167 / 2, 38 / 168 / 2, 109 / 169 / 2, 100 / 170 / 2, 150 / 171 / 2, 99 / 172 / 2, 34 / 173 / 2, 67 / 174 / 2
singlecenter-alpha_1-108-n175.txt, 1, 1, 175, 1826.69, 1286, 1111, 5, 174,131 / 1 / 3, 77 / 2 / 2, 43 / 3 / 4, 128 / 4 / 2, 137 / 5 / 2, 97 / 6 / 3, 11 / 7 / 2, 44 / 8 / 2, 72 / 9 / 3, 101 / 10 / 2, 153 / 11 / 3, 120 / 12 / 2, 1 / 13 / 5, 115 / 14 / 2, 103 / 15 / 2, 133 / 16 / 2, 155 / 17 / 5, 71 / 18 / 2, 51 / 19 / 2, 75 / 20 / 2, 59 / 21 / 3, 92 / 22 / 2, 68 / 23 / 2, 119 / 24 / 2, 110 / 25 / 2, 100 / 26 / 5, 21 / 27 / 2, 66 / 28 / 2, 89 / 29 / 3, 158 / 30 / 2, 27 / 31 / 2, 102 / 32 / 4, 142 / 33 / 2, 31 / 34 / 2, 64 / 35 / 3, 10 / 36 / 2, 94 / 37 / 4, 8 / 38 / 2, 54 / 39 / 2, 111 / 40 / 4, 118 / 41 / 2, 85 / 42 / 3, 134 / 43 / 2, 140 / 44 / 4, 139 / 45 / 2, 39 / 46 / 2, 40 / 47 / 2, 25 / 48 / 2, 33 / 49 / 3, 126 / 50 / 2, 124 / 51 / 3, 151 / 52 / 2, 143 / 53 / 2, 17 / 54 / 3, 26 / 55 / 2, 24 / 56 / 2, 41 / 57 / 2, 164 / 58 / 2, 67 / 59 / 2, 88 / 60 / 2, 156 / 61 / 2, 166 / 62 / 2, 171 / 63 / 2, 86 / 64 / 2, 38 / 65 / 2, 91 / 66 / 3, 107 / 67 / 2, 130 / 68 / 3, 47 / 69 / 2, 162 / 70 / 2, 61 / 71 / 2, 152 / 72 / 2, 149 / 73 / 2, 173 / 74 / 2, 163 / 75 / 4, 42 / 76 / 2, 114 / 77 / 2, 20 / 78 / 2, 113 / 79 / 2, 129 / 80 / 2, 135 / 81 / 2, 84 / 82 / 3, 34 / 83 / 2, 117 / 84 / 4, 172 / 85 / 2, 58 / 86 / 2, 53 / 87 / 2, 147 / 88 / 4, 104 / 89 / 2, 74 / 90 / 2, 96 / 91 / 2, 90 / 92 / 2, 154 / 93 / 3, 30 / 94 / 2, 132 / 95 / 2, 7 / 96 / 2, 144 / 97 / 2, 87 / 98 / 3, 5 / 99 / 2, 112 / 100 / 3, 165 / 101 / 2, 50 / 102 / 2, 169 / 103 / 2, 93 / 104 / 5, 48 / 105 / 2, 55 / 106 / 2, 123 / 107 / 2, 76 / 108 / 2, 121 / 109 / 3, 52 / 110 / 2, 78 / 111 / 2, 125 / 112 / 2, 6 / 113 / 2, 82 / 114 / 2, 13 / 115 / 2, 35 / 116 / 3, 37 / 117 / 2, 18 / 118 / 2, 15 / 119 / 2, 174 / 120 / 2, 127 / 121 / 2, 14 / 122 / 3, 98 / 123 / 2, 81 / 124 / 3, 116 / 125 / 2, 22 / 126 / 2, 95 / 127 / 2, 28 / 128 / 2, 148 / 129 / 3, 108 / 130 / 2, 36 / 131 / 2, 46 / 132 / 2, 29 / 133 / 2, 170 / 134 / 2, 19 / 135 / 3, 136 / 136 / 2, 83 / 137 / 2, 70 / 138 / 2, 160 / 139 / 4, 80 / 140 / 2, 109 / 141 / 3, 141 / 142 / 2, 3 / 143 / 4, 23 / 144 / 2, 168 / 145 / 2, 138 / 146 / 2, 159 / 147 / 3, 65 / 148 / 2, 63 / 149 / 2, 9 / 150 / 3, 49 / 151 / 2, 4 / 152 / 2, 69 / 153 / 5, 99 / 154 / 2, 16 / 155 / 2, 45 / 156 / 2, 2 / 157 / 4, 62 / 158 / 2, 73 / 159 / 2, 122 / 160 / 2, 79 / 161 / 4, 145 / 162 / 2, 60 / 163 / 2, 150 / 164 / 4, 106 / 165 / 2, 157 / 166 / 2, 161 / 167 / 2, 57 / 168 / 2, 32 / 169 / 2, 12 / 170 / 2, 146 / 171 / 2, 105 / 172 / 2, 167 / 173 / 3, 56 / 174 / 2
singlecenter-alpha_1-109-n175.txt, 1, 1, 175, 1963.28, 1437, 1262, 10, 174,169 / 1 / 3, 99 / 2 / 2, 130 / 3 / 3, 127 / 4 / 2, 21 / 5 / 2, 165 / 6 / 3, 41 / 7 / 2, 25 / 8 / 2, 62 / 9 / 2, 56 / 10 / 3, 139 / 11 / 2, 142 / 12 / 2, 48 / 13 / 2, 156 / 14 / 2, 7 / 15 / 2, 34 / 16 / 4, 11 / 17 / 2, 72 / 18 / 2, 81 / 19 / 3, 132 / 20 / 2, 123 / 21 / 3, 60 / 22 / 2, 88 / 23 / 2, 118 / 24 / 3, 26 / 25 / 2, 19 / 26 / 3, 122 / 27 / 2, 3 / 28 / 2, 22 / 29 / 2, 158 / 30 / 2, 64 / 31 / 2, 137 / 32 / 4, 27 / 33 / 2, 89 / 34 / 2, 114 / 35 / 2, 101 / 36 / 2, 124 / 37 / 2, 149 / 38 / 2, 15 / 39 / 2, 91 / 40 / 2, 23 / 41 / 2, 95 / 42 / 2, 80 / 43 / 2, 173 / 44 / 3, 66 / 45 / 2, 13 / 46 / 2, 73 / 47 / 3, 145 / 48 / 2, 87 / 49 / 2, 1 / 50 / 2, 147 / 51 / 3, 108 / 52 / 2, 29 / 53 / 3, 94 / 54 / 2, 42 / 55 / 3, 20 / 56 / 2, 12 / 57 / 2, 51 / 58 / 2, 170 / 59 / 2, 63 / 60 / 3, 126 / 61 / 2, 104 / 62 / 2, 31 / 63 / 2, 4 / 64 / 2, 10 / 65 / 4, 102 / 66 / 2, 97 / 67 / 2, 83 / 68 / 2, 24 / 69 / 5, 141 / 70 / 2, 32 / 71 / 2, 84 / 72 / 2, 77 / 73 / 3, 146 / 74 / 2, 58 / 75 / 2, 57 / 76 / 2, 85 / 77 / 3, 50 / 78 / 2, 125 / 79 / 3, 148 / 80 / 2, 135 / 81 / 2, 134 / 82 / 5, 100 / 83 / 2, 16 / 84 / 2, 47 / 85 / 2, 38 / 86 / 3, 78 / 87 / 2, 153 / 88 / 2, 14 / 89 / 3, 70 / 90 / 2, 171 / 91 / 2, 61 / 92 / 3, 45 / 93 / 2, 113 / 94 / 3, 162 / 95 / 2, 157 / 96 / 2, 76 / 97 / 2, 129 / 98 / 10, 44 / 99 / 2, 128 / 100 / 3, 55 / 101 / 2, 49 / 102 / 2, 151 / 103 / 2, 82 / 104 / 2, 69 / 105 / 2, 17 / 106 / 2, 98 / 107 / 2, 86 / 108 / 2, 115 / 109 / 3, 109 / 110 / 2, 52 / 111 / 2, 30 / 112 / 3, 79 / 113 / 2, 110 / 114 / 2, 131 / 115 / 4, 152 / 116 / 2, 155 / 117 / 2, 37 / 118 / 3, 92 / 119 / 2, 59 / 120 / 4, 40 / 121 / 2, 65 / 122 / 2, 68 / 123 / 3, 5 / 124 / 2, 71 / 125 / 3, 161 / 126 / 2, 172 / 127 / 2, 121 / 128 / 4, 119 / 129 / 2, 159 / 130 / 2, 9 / 131 / 4, 53 / 132 / 2, 154 / 133 / 2, 106 / 134 / 3, 46 / 135 / 2, 138 / 136 / 2, 164 / 137 / 3, 6 / 138 / 2, 112 / 139 / 3, 103 / 140 / 2, 36 / 141 / 2, 120 / 142 / 2, 144 / 143 / 2, 107 / 144 / 2, 143 / 145 / 3, 166 / 146 / 2, 174 / 147 / 3, 116 / 148 / 2, 163 / 149 / 2, 90 / 150 / 2, 111 / 151 / 4, 8 / 152 / 2, 150 / 153 / 2, 136 / 154 / 2, 43 / 155 / 2, 33 / 156 / 4, 67 / 157 / 2, 74 / 158 / 2, 168 / 159 / 4, 117 / 160 / 2, 54 / 161 / 2, 18 / 162 / 4, 160 / 163 / 2, 35 / 164 / 2, 140 / 165 / 2, 75 / 166 / 2, 39 / 167 / 2, 167 / 168 / 4, 2 / 169 / 2, 28 / 170 / 2, 105 / 171 / 4, 93 / 172 / 2, 96 / 173 / 3, 133 / 174 / 2
singlecenter-alpha_1-11-n375.txt, 1, 1, 375, 2643.55, 3021, 2646, 10, 374,78 / 1 / 4, 99 / 2 / 2, 301 / 3 / 2, 82 / 4 / 10, 90 / 5 / 2, 94 / 6 / 2, 95 / 7 / 2, 135 / 8 / 3, 218 / 9 / 2, 126 / 10 / 2, 120 / 11 / 2, 275 / 12 / 2, 7 / 13 / 2, 342 / 14 / 3, 56 / 15 / 2, 304 / 16 / 2, 238 / 17 / 2, 35 / 18 / 2, 84 / 19 / 2, 261 / 20 / 2, 39 / 21 / 3, 244 / 22 / 2, 69 / 23 / 3, 141 / 24 / 2, 340 / 25 / 2, 149 / 26 / 4, 146 / 27 / 2, 303 / 28 / 2, 257 / 29 / 4, 344 / 30 / 2, 21 / 31 / 2, 362 / 32 / 2, 156 / 33 / 2, 247 / 34 / 2, 311 / 35 / 2, 55 / 36 / 3, 142 / 37 / 2, 106 / 38 / 3, 118 / 39 / 2, 131 / 40 / 2, 115 / 41 / 5, 108 / 42 / 2, 163 / 43 / 2, 355 / 44 / 2, 86 / 45 / 2, 309 / 46 / 2, 36 / 47 / 2, 249 / 48 / 2, 101 / 49 / 3, 186 / 50 / 2, 157 / 51 / 2, 117 / 52 / 2, 314 / 53 / 2, 302 / 54 / 2, 93 / 55 / 2, 315 / 56 / 5, 229 / 57 / 2, 107 / 58 / 2, 2 / 59 / 3, 133 / 60 / 2, 128 / 61 / 2, 310 / 62 / 3, 374 / 63 / 2, 319 / 64 / 2, 167 / 65 / 2, 20 / 66 / 3, 369 / 67 / 2, 193 / 68 / 2, 187 / 69 / 3, 248 / 70 / 2, 298 / 71 / 2, 356 / 72 / 2, 53 / 73 / 4, 68 / 74 / 2, 273 / 75 / 2, 285 / 76 / 2, 71 / 77 / 3, 292 / 78 / 2, 8 / 79 / 2, 308 / 80 / 2, 200 / 81 / 2, 352 / 82 / 2, 97 / 83 / 4, 119 / 84 / 2, 64 / 85 / 2, 260 / 86 / 2, 251 / 87 / 2, 6 / 88 / 3, 166 / 89 / 2, 259 / 90 / 3, 37 / 91 / 2, 195 / 92 / 2, 181 / 93 / 2, 201 / 94 / 2, 116 / 95 / 3, 161 / 96 / 2, 317 / 97 / 5, 75 / 98 / 2, 103 / 99 / 2, 1 / 100 / 3, 290 / 101 / 2, 371 / 102 / 2, 267 / 103 / 2, 196 / 104 / 4, 105 / 105 / 2, 145 / 106 / 2, 213 / 107 / 3, 237 / 108 / 2, 245 / 109 / 2, 207 / 110 / 4, 291 / 111 / 2, 206 / 112 / 2, 332 / 113 / 3, 17 / 114 / 2, 194 / 115 / 2, 44 / 116 / 3, 3 / 117 / 2, 225 / 118 / 2, 129 / 119 / 2, 347 / 120 / 2, 174 / 121 / 4, 74 / 122 / 2, 366 / 123 / 2, 220 / 124 / 3, 204 / 125 / 2, 169 / 126 / 3, 176 / 127 / 2, 323 / 128 / 2, 217 / 129 / 4, 184 / 130 / 2, 272 / 131 / 2, 236 / 132 / 2, 57 / 133 / 2, 38 / 134 / 2, 42 / 135 / 2, 28 / 136 / 2, 336 / 137 / 2, 300 / 138 / 2, 358 / 139 / 2, 158 / 140 / 3, 155 / 141 / 2, 365 / 142 / 6, 350 / 143 / 2, 318 / 144 / 2, 4 / 145 / 4, 235 / 146 / 2, 197 / 147 / 2, 334 / 148 / 2, 328 / 149 / 3, 349 / 150 / 2, 127 / 151 / 2, 359 / 152 / 3, 30 / 153 / 2, 178 / 154 / 3, 32 / 155 / 2, 183 / 156 / 2, 123 / 157 / 2, 121 / 158 / 3, 367 / 159 / 2, 26 / 160 / 2, 320 / 161 / 2, 100 / 162 / 3, 271 / 163 / 2, 151 / 164 / 6, 370 / 165 / 2, 205 / 166 / 3, 190 / 167 / 2, 373 / 168 / 3, 102 / 169 / 2, 357 / 170 / 3, 139 / 171 / 2, 281 / 172 / 2, 72 / 173 / 3, 51 / 174 / 2, 154 / 175 / 3, 40 / 176 / 2, 221 / 177 / 2, 361 / 178 / 3, 215 / 179 / 2, 124 / 180 / 3, 43 / 181 / 2, 239 / 182 / 2, 31 / 183 / 2, 210 / 184 / 2, 326 / 185 / 3, 299 / 186 / 2, 202 / 187 / 3, 54 / 188 / 2, 331 / 189 / 2, 9 / 190 / 3, 188 / 191 / 2, 199 / 192 / 2, 254 / 193 / 3, 325 / 194 / 2, 92 / 195 / 2, 77 / 196 / 2, 364 / 197 / 3, 46 / 198 / 2, 278 / 199 / 3, 24 / 200 / 2, 255 / 201 / 3, 80 / 202 / 2, 297 / 203 / 2, 137 / 204 / 2, 110 / 205 / 3, 23 / 206 / 2, 307 / 207 / 2, 346 / 208 / 3, 227 / 209 / 2, 353 / 210 / 2, 270 / 211 / 2, 231 / 212 / 5, 368 / 213 / 2, 282 / 214 / 3, 29 / 215 / 2, 164 / 216 / 3, 79 / 217 / 2, 175 / 218 / 3, 87 / 219 / 2, 148 / 220 / 2, 41 / 221 / 2, 327 / 222 / 3, 288 / 223 / 2, 147 / 224 / 3, 61 / 225 / 2, 230 / 226 / 2, 203 / 227 / 3, 306 / 228 / 2, 293 / 229 / 2, 232 / 230 / 2, 316 / 231 / 2, 81 / 232 / 6, 348 / 233 / 2, 45 / 234 / 3, 324 / 235 / 2, 76 / 236 / 2, 266 / 237 / 3, 289 / 238 / 2, 83 / 239 / 2, 343 / 240 / 3, 150 / 241 / 2, 264 / 242 / 3, 63 / 243 / 2, 140 / 244 / 2, 360 / 245 / 2, 339 / 246 / 2, 48 / 247 / 2, 284 / 248 / 2, 66 / 249 / 2, 279 / 250 / 5, 274 / 251 / 2, 18 / 252 / 2, 136 / 253 / 2, 329 / 254 / 2, 321 / 255 / 3, 130 / 256 / 2, 214 / 257 / 2, 134 / 258 / 3, 263 / 259 / 2, 265 / 260 / 3, 160 / 261 / 2, 234 / 262 / 2, 22 / 263 / 2, 132 / 264 / 7, 165 / 265 / 2, 89 / 266 / 2, 283 / 267 / 3, 172 / 268 / 2, 19 / 269 / 2, 180 / 270 / 2, 96 / 271 / 5, 138 / 272 / 2, 233 / 273 / 3, 258 / 274 / 2, 13 / 275 / 5, 313 / 276 / 2, 47 / 277 / 3, 322 / 278 / 2, 276 / 279 / 2, 153 / 280 / 4, 250 / 281 / 2, 242 / 282 / 2, 296 / 283 / 3, 246 / 284 / 2, 228 / 285 / 5, 208 / 286 / 2, 269 / 287 / 2, 50 / 288 / 2, 338 / 289 / 2, 253 / 290 / 3, 222 / 291 / 2, 211 / 292 / 2, 212 / 293 / 2, 122 / 294 / 2, 354 / 295 / 2, 337 / 296 / 3, 125 / 297 / 2, 60 / 298 / 2, 198 / 299 / 2, 33 / 300 / 2, 59 / 301 / 2, 345 / 302 / 3, 143 / 303 / 2, 112 / 304 / 3, 189 / 305 / 2, 351 / 306 / 2, 70 / 307 / 4, 192 / 308 / 2, 177 / 309 / 3, 268 / 310 / 2, 295 / 311 / 3, 240 / 312 / 2, 12 / 313 / 2, 52 / 314 / 2, 262 / 315 / 2, 58 / 316 / 2, 223 / 317 / 2, 65 / 318 / 2, 16 / 319 / 2, 25 / 320 / 2, 280 / 321 / 2, 219 / 322 / 2, 209 / 323 / 2, 330 / 324 / 5, 171 / 325 / 2, 363 / 326 / 2, 27 / 327 / 2, 277 / 328 / 2, 256 / 329 / 2, 372 / 330 / 2, 170 / 331 / 2, 34 / 332 / 2, 286 / 333 / 2, 287 / 334 / 2, 5 / 335 / 2, 15 / 336 / 2, 10 / 337 / 2, 113 / 338 / 2, 312 / 339 / 3, 252 / 340 / 2, 104 / 341 / 3, 333 / 342 / 2, 182 / 343 / 2, 109 / 344 / 3, 67 / 345 / 2, 162 / 346 / 4, 88 / 347 / 2, 168 / 348 / 2, 114 / 349 / 2, 243 / 350 / 2, 91 / 351 / 3, 216 / 352 / 2, 185 / 353 / 2, 173 / 354 / 3, 335 / 355 / 2, 98 / 356 / 2, 85 / 357 / 5, 14 / 358 / 2, 305 / 359 / 2, 179 / 360 / 2, 152 / 361 / 2, 341 / 362 / 2, 62 / 363 / 2, 49 / 364 / 2, 191 / 365 / 2, 11 / 366 / 2, 73 / 367 / 3, 226 / 368 / 2, 224 / 369 / 2, 111 / 370 / 2, 294 / 371 / 2, 159 / 372 / 5, 241 / 373 / 2, 144 / 374 / 2
singlecenter-alpha_1-11-n500.txt, 1, 1, 500, 3064.23, 3772, 3272, 7, 499,185 / 1 / 2, 308 / 2 / 2, 266 / 3 / 2, 444 / 4 / 2, 114 / 5 / 2, 110 / 6 / 2, 45 / 7 / 2, 493 / 8 / 2, 474 / 9 / 2, 209 / 10 / 5, 317 / 11 / 2, 336 / 12 / 3, 313 / 13 / 2, 285 / 14 / 3, 488 / 15 / 2, 80 / 16 / 2, 466 / 17 / 4, 418 / 18 / 2, 25 / 19 / 2, 219 / 20 / 4, 135 / 21 / 2, 142 / 22 / 3, 477 / 23 / 2, 170 / 24 / 3, 41 / 25 / 2, 486 / 26 / 2, 395 / 27 / 3, 8 / 28 / 2, 284 / 29 / 3, 333 / 30 / 2, 158 / 31 / 3, 443 / 32 / 2, 61 / 33 / 2, 343 / 34 / 3, 394 / 35 / 2, 111 / 36 / 2, 356 / 37 / 4, 335 / 38 / 2, 445 / 39 / 2, 399 / 40 / 3, 263 / 41 / 2, 324 / 42 / 2, 363 / 43 / 2, 101 / 44 / 3, 254 / 45 / 2, 35 / 46 / 2, 495 / 47 / 3, 419 / 48 / 2, 289 / 49 / 3, 467 / 50 / 2, 143 / 51 / 2, 256 / 52 / 2, 3 / 53 / 2, 181 / 54 / 2, 76 / 55 / 3, 371 / 56 / 2, 368 / 57 / 2, 63 / 58 / 4, 167 / 59 / 2, 360 / 60 / 2, 349 / 61 / 2, 184 / 62 / 3, 86 / 63 / 2, 377 / 64 / 3, 133 / 65 / 2, 259 / 66 / 2, 312 / 67 / 2, 400 / 68 / 2, 27 / 69 / 2, 248 / 70 / 2, 455 / 71 / 3, 396 / 72 / 2, 409 / 73 / 2, 217 / 74 / 3, 416 / 75 / 2, 449 / 76 / 2, 183 / 77 / 2, 137 / 78 / 2, 442 / 79 / 2, 240 / 80 / 2, 270 / 81 / 2, 33 / 82 / 2, 273 / 83 / 2, 178 / 84 / 3, 347 / 85 / 2, 489 / 86 / 3, 397 / 87 / 2, 294 / 88 / 2, 438 / 89 / 2, 354 / 90 / 3, 417 / 91 / 2, 58 / 92 / 2, 107 / 93 / 3, 357 / 94 / 2, 7 / 95 / 3, 39 / 96 / 2, 450 / 97 / 3, 52 / 98 / 2, 23 / 99 / 3, 386 / 100 / 2, 252 / 101 / 2, 408 / 102 / 3, 393 / 103 / 2, 334 / 104 / 2, 299 / 105 / 2, 487 / 106 / 3, 205 / 107 / 2, 439 / 108 / 3, 168 / 109 / 2, 191 / 110 / 2, 198 / 111 / 2, 320 / 112 / 2, 471 / 113 / 3, 291 / 114 / 2, 352 / 115 / 2, 120 / 116 / 2, 244 / 117 / 2, 242 / 118 / 4, 129 / 119 / 2, 327 / 120 / 2, 139 / 121 / 5, 42 / 122 / 2, 17 / 123 / 2, 79 / 124 / 2, 430 / 125 / 3, 160 / 126 / 2, 216 / 127 / 3, 390 / 128 / 2, 267 / 129 / 3, 482 / 130 / 2, 68 / 131 / 2, 20 / 132 / 2, 196 / 133 / 4, 118 / 134 / 2, 293 / 135 / 2, 385 / 136 / 3, 189 / 137 / 2, 132 / 138 / 2, 201 / 139 / 2, 218 / 140 / 2, 279 / 141 / 5, 253 / 142 / 2, 123 / 143 / 2, 127 / 144 / 3, 136 / 145 / 2, 211 / 146 / 3, 154 / 147 / 2, 286 / 148 / 2, 453 / 149 / 3, 310 / 150 / 2, 330 / 151 / 2, 38 / 152 / 2, 402 / 153 / 3, 376 / 154 / 2, 150 / 155 / 2, 134 / 156 / 2, 316 / 157 / 2, 54 / 158 / 2, 83 / 159 / 3, 249 / 160 / 2, 108 / 161 / 2, 332 / 162 / 2, 491 / 163 / 2, 223 / 164 / 4, 186 / 165 / 2, 32 / 166 / 2, 46 / 167 / 2, 84 / 168 / 3, 431 / 169 / 2, 15 / 170 / 3, 307 / 171 / 2, 300 / 172 / 2, 104 / 173 / 3, 227 / 174 / 2, 432 / 175 / 3, 199 / 176 / 2, 494 / 177 / 2, 344 / 178 / 4, 94 / 179 / 2, 407 / 180 / 2, 422 / 181 / 2, 206 / 182 / 2, 319 / 183 / 2, 476 / 184 / 3, 457 / 185 / 2, 176 / 186 / 3, 10 / 187 / 2, 410 / 188 / 2, 241 / 189 / 3, 112 / 190 / 2, 346 / 191 / 4, 475 / 192 / 2, 374 / 193 / 3, 98 / 194 / 2, 66 / 195 / 2, 212 / 196 / 2, 179 / 197 / 3, 392 / 198 / 2, 297 / 199 / 3, 459 / 200 / 2, 479 / 201 / 2, 238 / 202 / 2, 156 / 203 / 3, 458 / 204 / 2, 49 / 205 / 2, 95 / 206 / 3, 92 / 207 / 2, 9 / 208 / 3, 109 / 209 / 2, 64 / 210 / 4, 215 / 211 / 2, 355 / 212 / 2, 462 / 213 / 2, 350 / 214 / 2, 413 / 215 / 2, 1 / 216 / 3, 172 / 217 / 2, 12 / 218 / 3, 96 / 219 / 2, 329 / 220 / 3, 147 / 221 / 2, 103 / 222 / 3, 78 / 223 / 2, 398 / 224 / 2, 375 / 225 / 2, 405 / 226 / 2, 126 / 227 / 2, 163 / 228 / 2, 204 / 229 / 2, 318 / 230 / 2, 353 / 231 / 2, 446 / 232 / 3, 441 / 233 / 2, 89 / 234 / 2, 412 / 235 / 2, 228 / 236 / 3, 43 / 237 / 2, 255 / 238 / 3, 91 / 239 / 2, 498 / 240 / 2, 90 / 241 / 4, 461 / 242 / 2, 207 / 243 / 2, 469 / 244 / 2, 220 / 245 / 5, 55 / 246 / 2, 282 / 247 / 2, 190 / 248 / 2, 226 / 249 / 3, 448 / 250 / 2, 338 / 251 / 2, 362 / 252 / 4, 56 / 253 / 2, 225 / 254 / 2, 305 / 255 / 5, 22 / 256 / 2, 175 / 257 / 2, 426 / 258 / 2, 161 / 259 / 3, 483 / 260 / 2, 72 / 261 / 3, 174 / 262 / 2, 36 / 263 / 2, 34 / 264 / 3, 166 / 265 / 2, 481 / 266 / 2, 19 / 267 / 7, 60 / 268 / 2, 364 / 269 / 2, 283 / 270 / 3, 57 / 271 / 2, 314 / 272 / 2, 165 / 273 / 4, 424 / 274 / 2, 37 / 275 / 2, 322 / 276 / 2, 472 / 277 / 4, 222 / 278 / 2, 122 / 279 / 3, 213 / 280 / 2, 48 / 281 / 2, 321 / 282 / 2, 379 / 283 / 2, 69 / 284 / 3, 391 / 285 / 2, 366 / 286 / 2, 164 / 287 / 2, 30 / 288 / 2, 85 / 289 / 2, 162 / 290 / 3, 478 / 291 / 2, 456 / 292 / 2, 29 / 293 / 2, 428 / 294 / 2, 62 / 295 / 3, 452 / 296 / 2, 100 / 297 / 2, 420 / 298 / 2, 302 / 299 / 2, 234 / 300 / 3, 149 / 301 / 2, 290 / 302 / 3, 6 / 303 / 2, 14 / 304 / 2, 342 / 305 / 3, 337 / 306 / 2, 130 / 307 / 2, 51 / 308 / 2, 140 / 309 / 3, 5 / 310 / 2, 269 / 311 / 4, 339 / 312 / 2, 382 / 313 / 2, 345 / 314 / 2, 381 / 315 / 2, 387 / 316 / 2, 115 / 317 / 2, 157 / 318 / 2, 484 / 319 / 2, 389 / 320 / 3, 229 / 321 / 2, 128 / 322 / 3, 113 / 323 / 2, 235 / 324 / 3, 138 / 325 / 2, 331 / 326 / 4, 237 / 327 / 2, 24 / 328 / 2, 155 / 329 / 4, 411 / 330 / 2, 480 / 331 / 2, 169 / 332 / 4, 236 / 333 / 2, 210 / 334 / 2, 423 / 335 / 2, 372 / 336 / 2, 192 / 337 / 2, 288 / 338 / 3, 208 / 339 / 2, 436 / 340 / 2, 359 / 341 / 5, 323 / 342 / 2, 447 / 343 / 2, 261 / 344 / 2, 434 / 345 / 3, 70 / 346 / 2, 497 / 347 / 2, 50 / 348 / 5, 388 / 349 / 2, 171 / 350 / 2, 97 / 351 / 2, 82 / 352 / 4, 11 / 353 / 2, 145 / 354 / 3, 224 / 355 / 2, 177 / 356 / 2, 214 / 357 / 4, 53 / 358 / 2, 296 / 359 / 3, 59 / 360 / 2, 303 / 361 / 3, 159 / 362 / 2, 194 / 363 / 2, 272 / 364 / 2, 102 / 365 / 3, 258 / 366 / 2, 257 / 367 / 2, 325 / 368 / 2, 203 / 369 / 2, 351 / 370 / 2, 340 / 371 / 2, 75 / 372 / 2, 146 / 373 / 2, 119 / 374 / 4, 306 / 375 / 2, 435 / 376 / 2, 144 / 377 / 3, 187 / 378 / 2, 18 / 379 / 3, 230 / 380 / 2, 378 / 381 / 2, 271 / 382 / 2, 31 / 383 / 2, 71 / 384 / 3, 454 / 385 / 2, 415 / 386 / 2, 246 / 387 / 4, 464 / 388 / 2, 74 / 389 / 3, 47 / 390 / 2, 315 / 391 / 2, 463 / 392 / 3, 361 / 393 / 2, 260 / 394 / 2, 358 / 395 / 2, 88 / 396 / 2, 281 / 397 / 2, 152 / 398 / 2, 326 / 399 / 2, 4 / 400 / 3, 13 / 401 / 2, 403 / 402 / 2, 274 / 403 / 3, 309 / 404 / 2, 182 / 405 / 2, 427 / 406 / 3, 245 / 407 / 2, 247 / 408 / 2, 173 / 409 / 3, 499 / 410 / 2, 304 / 411 / 3, 87 / 412 / 2, 197 / 413 / 2, 195 / 414 / 3, 151 / 415 / 2, 153 / 416 / 3, 383 / 417 / 2, 233 / 418 / 3, 200 / 419 / 2, 437 / 420 / 3, 465 / 421 / 2, 401 / 422 / 3, 221 / 423 / 2, 380 / 424 / 3, 202 / 425 / 2, 433 / 426 / 3, 440 / 427 / 2, 275 / 428 / 3, 485 / 429 / 2, 268 / 430 / 3, 414 / 431 / 2, 367 / 432 / 2, 105 / 433 / 3, 131 / 434 / 2, 193 / 435 / 3, 148 / 436 / 2, 93 / 437 / 2, 2 / 438 / 3, 188 / 439 / 2, 421 / 440 / 3, 117 / 441 / 2, 121 / 442 / 3, 292 / 443 / 2, 490 / 444 / 4, 125 / 445 / 2, 429 / 446 / 2, 468 / 447 / 2, 328 / 448 / 4, 180 / 449 / 2, 26 / 450 / 2, 451 / 451 / 4, 67 / 452 / 2, 369 / 453 / 2, 370 / 454 / 3, 404 / 455 / 2, 250 / 456 / 2, 311 / 457 / 2, 251 / 458 / 2, 21 / 459 / 6, 28 / 460 / 2, 232 / 461 / 2, 406 / 462 / 3, 298 / 463 / 2, 280 / 464 / 2, 276 / 465 / 2, 116 / 466 / 2, 106 / 467 / 3, 81 / 468 / 2, 264 / 469 / 2, 40 / 470 / 5, 77 / 471 / 2, 301 / 472 / 2, 99 / 473 / 3, 473 / 474 / 2, 243 / 475 / 3, 265 / 476 / 2, 287 / 477 / 2, 239 / 478 / 3, 341 / 479 / 2, 231 / 480 / 2, 425 / 481 / 3, 16 / 482 / 2, 278 / 483 / 5, 348 / 484 / 2, 492 / 485 / 2, 44 / 486 / 2, 460 / 487 / 2, 365 / 488 / 2, 295 / 489 / 2, 496 / 490 / 2, 141 / 491 / 2, 73 / 492 / 2, 124 / 493 / 3, 384 / 494 / 2, 277 / 495 / 2, 262 / 496 / 2, 65 / 497 / 3, 373 / 498 / 2, 470 / 499 / 2
singlecenter-alpha_1-11-n6.txt, 1, 1, 6, 266.872, 26, 20, 6, 5,4 / 1 / 3, 2 / 2 / 2, 3 / 3 / 2, 5 / 4 / 6, 1 / 5 / 2
singlecenter-alpha_1-110-n175.txt, 1, 1, 175, 1826.96, 1309, 1134, 7, 174,174 / 1 / 2, 89 / 2 / 5, 113 / 3 / 2, 55 / 4 / 3, 147 / 5 / 2, 48 / 6 / 2, 115 / 7 / 2, 19 / 8 / 2, 24 / 9 / 2, 101 / 10 / 5, 40 / 11 / 2, 7 / 12 / 2, 137 / 13 / 2, 100 / 14 / 2, 87 / 15 / 2, 82 / 16 / 2, 172 / 17 / 2, 42 / 18 / 3, 83 / 19 / 2, 67 / 20 / 3, 103 / 21 / 2, 140 / 22 / 5, 148 / 23 / 2, 162 / 24 / 2, 141 / 25 / 2, 21 / 26 / 2, 136 / 27 / 2, 8 / 28 / 3, 31 / 29 / 2, 56 / 30 / 3, 122 / 31 / 2, 71 / 32 / 2, 143 / 33 / 2, 65 / 34 / 4, 129 / 35 / 2, 169 / 36 / 2, 23 / 37 / 2, 149 / 38 / 3, 36 / 39 / 2, 41 / 40 / 3, 134 / 41 / 2, 61 / 42 / 2, 39 / 43 / 4, 52 / 44 / 2, 104 / 45 / 2, 142 / 46 / 2, 170 / 47 / 2, 35 / 48 / 4, 153 / 49 / 2, 80 / 50 / 2, 17 / 51 / 3, 4 / 52 / 2, 45 / 53 / 2, 126 / 54 / 2, 165 / 55 / 2, 86 / 56 / 3, 116 / 57 / 2, 120 / 58 / 3, 93 / 59 / 2, 124 / 60 / 3, 62 / 61 / 2, 76 / 62 / 2, 64 / 63 / 3, 91 / 64 / 2, 54 / 65 / 3, 114 / 66 / 2, 77 / 67 / 2, 157 / 68 / 3, 135 / 69 / 2, 118 / 70 / 3, 63 / 71 / 2, 117 / 72 / 3, 158 / 73 / 2, 121 / 74 / 3, 20 / 75 / 2, 25 / 76 / 2, 166 / 77 / 2, 173 / 78 / 4, 28 / 79 / 2, 16 / 80 / 2, 154 / 81 / 2, 59 / 82 / 2, 29 / 83 / 5, 12 / 84 / 2, 50 / 85 / 2, 79 / 86 / 2, 156 / 87 / 3, 49 / 88 / 2, 75 / 89 / 2, 96 / 90 / 3, 34 / 91 / 2, 13 / 92 / 3, 127 / 93 / 2, 167 / 94 / 2, 155 / 95 / 2, 27 / 96 / 2, 108 / 97 / 2, 22 / 98 / 5, 1 / 99 / 2, 112 / 100 / 2, 84 / 101 / 2, 130 / 102 / 4, 138 / 103 / 2, 57 / 104 / 3, 68 / 105 / 2, 74 / 106 / 2, 32 / 107 / 2, 164 / 108 / 3, 171 / 109 / 2, 81 / 110 / 2, 110 / 111 / 3, 144 / 112 / 2, 139 / 113 / 4, 146 / 114 / 2, 107 / 115 / 2, 128 / 116 / 3, 111 / 117 / 2, 69 / 118 / 4, 163 / 119 / 2, 43 / 120 / 2, 161 / 121 / 2, 78 / 122 / 4, 9 / 123 / 2, 66 / 124 / 2, 94 / 125 / 2, 99 / 126 / 2, 168 / 127 / 2, 145 / 128 / 3, 119 / 129 / 2, 132 / 130 / 3, 6 / 131 / 2, 15 / 132 / 3, 10 / 133 / 2, 73 / 134 / 2, 53 / 135 / 4, 102 / 136 / 2, 46 / 137 / 2, 70 / 138 / 7, 109 / 139 / 2, 125 / 140 / 2, 26 / 141 / 3, 151 / 142 / 2, 106 / 143 / 2, 14 / 144 / 3, 30 / 145 / 2, 105 / 146 / 3, 11 / 147 / 2, 131 / 148 / 3, 98 / 149 / 2, 3 / 150 / 2, 133 / 151 / 2, 152 / 152 / 3, 85 / 153 / 2, 2 / 154 / 2, 95 / 155 / 4, 150 / 156 / 2, 38 / 157 / 3, 58 / 158 / 2, 97 / 159 / 3, 92 / 160 / 2, 159 / 161 / 2, 18 / 162 / 2, 123 / 163 / 2, 72 / 164 / 2, 160 / 165 / 2, 33 / 166 / 3, 90 / 167 / 2, 51 / 168 / 3, 47 / 169 / 2, 37 / 170 / 3, 88 / 171 / 2, 44 / 172 / 3, 60 / 173 / 2, 5 / 174 / 2
singlecenter-alpha_1-111-n250.txt, 1, 1, 250, 2056.11, 2122, 1872, 10, 249,45 / 1 / 4, 159 / 2 / 2, 147 / 3 / 2, 198 / 4 / 2, 69 / 5 / 3, 27 / 6 / 2, 129 / 7 / 3, 72 / 8 / 2, 171 / 9 / 2, 169 / 10 / 3, 183 / 11 / 2, 241 / 12 / 5, 48 / 13 / 2, 128 / 14 / 2, 56 / 15 / 2, 145 / 16 / 3, 143 / 17 / 2, 161 / 18 / 3, 172 / 19 / 2, 242 / 20 / 2, 108 / 21 / 4, 62 / 22 / 2, 207 / 23 / 2, 82 / 24 / 3, 6 / 25 / 2, 79 / 26 / 2, 112 / 27 / 2, 18 / 28 / 2, 213 / 29 / 2, 80 / 30 / 2, 155 / 31 / 2, 211 / 32 / 3, 53 / 33 / 2, 52 / 34 / 2, 160 / 35 / 3, 32 / 36 / 2, 35 / 37 / 2, 33 / 38 / 2, 113 / 39 / 3, 214 / 40 / 2, 149 / 41 / 5, 148 / 42 / 2, 94 / 43 / 2, 243 / 44 / 2, 12 / 45 / 3, 22 / 46 / 2, 23 / 47 / 2, 218 / 48 / 3, 132 / 49 / 2, 46 / 50 / 2, 173 / 51 / 3, 70 / 52 / 2, 65 / 53 / 2, 231 / 54 / 3, 16 / 55 / 2, 114 / 56 / 3, 74 / 57 / 2, 92 / 58 / 2, 106 / 59 / 2, 115 / 60 / 4, 184 / 61 / 2, 222 / 62 / 2, 86 / 63 / 4, 71 / 64 / 2, 144 / 65 / 2, 188 / 66 / 4, 157 / 67 / 2, 244 / 68 / 2, 245 / 69 / 2, 100 / 70 / 2, 208 / 71 / 2, 234 / 72 / 2, 116 / 73 / 2, 215 / 74 / 3, 60 / 75 / 2, 179 / 76 / 2, 1 / 77 / 2, 225 / 78 / 2, 210 / 79 / 2, 51 / 80 / 2, 13 / 81 / 4, 201 / 82 / 2, 187 / 83 / 2, 95 / 84 / 4, 217 / 85 / 2, 153 / 86 / 2, 203 / 87 / 5, 131 / 88 / 2, 96 / 89 / 2, 189 / 90 / 4, 125 / 91 / 2, 126 / 92 / 3, 15 / 93 / 2, 181 / 94 / 2, 191 / 95 / 2, 190 / 96 / 2, 186 / 97 / 3, 14 / 98 / 2, 19 / 99 / 2, 11 / 100 / 5, 246 / 101 / 2, 136 / 102 / 2, 21 / 103 / 2, 199 / 104 / 3, 84 / 105 / 2, 175 / 106 / 3, 146 / 107 / 2, 87 / 108 / 2, 120 / 109 / 3, 66 / 110 / 2, 41 / 111 / 2, 36 / 112 / 3, 83 / 113 / 2, 167 / 114 / 2, 42 / 115 / 2, 134 / 116 / 2, 88 / 117 / 2, 127 / 118 / 3, 109 / 119 / 2, 124 / 120 / 3, 224 / 121 / 2, 99 / 122 / 2, 236 / 123 / 3, 194 / 124 / 2, 93 / 125 / 2, 182 / 126 / 2, 55 / 127 / 2, 232 / 128 / 7, 37 / 129 / 2, 130 / 130 / 2, 238 / 131 / 3, 216 / 132 / 2, 223 / 133 / 2, 3 / 134 / 3, 102 / 135 / 2, 81 / 136 / 3, 104 / 137 / 2, 133 / 138 / 3, 140 / 139 / 2, 77 / 140 / 2, 67 / 141 / 2, 105 / 142 / 2, 204 / 143 / 3, 90 / 144 / 2, 5 / 145 / 5, 61 / 146 / 2, 10 / 147 / 3, 75 / 148 / 2, 152 / 149 / 5, 117 / 150 / 2, 76 / 151 / 2, 197 / 152 / 2, 180 / 153 / 5, 63 / 154 / 2, 168 / 155 / 2, 141 / 156 / 2, 89 / 157 / 5, 73 / 158 / 2, 121 / 159 / 3, 185 / 160 / 2, 193 / 161 / 3, 170 / 162 / 2, 31 / 163 / 3, 39 / 164 / 2, 151 / 165 / 2, 38 / 166 / 3, 220 / 167 / 2, 17 / 168 / 2, 174 / 169 / 2, 47 / 170 / 2, 249 / 171 / 3, 137 / 172 / 2, 196 / 173 / 4, 50 / 174 / 2, 91 / 175 / 2, 233 / 176 / 2, 25 / 177 / 2, 30 / 178 / 2, 219 / 179 / 2, 206 / 180 / 2, 54 / 181 / 10, 135 / 182 / 2, 142 / 183 / 3, 24 / 184 / 2, 212 / 185 / 3, 110 / 186 / 2, 156 / 187 / 3, 97 / 188 / 2, 7 / 189 / 2, 43 / 190 / 2, 9 / 191 / 3, 235 / 192 / 2, 209 / 193 / 2, 162 / 194 / 2, 26 / 195 / 2, 119 / 196 / 2, 221 / 197 / 4, 150 / 198 / 2, 227 / 199 / 2, 59 / 200 / 2, 68 / 201 / 5, 2 / 202 / 2, 230 / 203 / 2, 166 / 204 / 4, 49 / 205 / 2, 123 / 206 / 3, 163 / 207 / 2, 239 / 208 / 3, 64 / 209 / 2, 176 / 210 / 5, 247 / 211 / 2, 226 / 212 / 2, 28 / 213 / 3, 78 / 214 / 2, 20 / 215 / 3, 4 / 216 / 2, 98 / 217 / 3, 111 / 218 / 2, 101 / 219 / 3, 40 / 220 / 2, 57 / 221 / 2, 200 / 222 / 2, 103 / 223 / 4, 34 / 224 / 2, 237 / 225 / 2, 122 / 226 / 3, 229 / 227 / 2, 158 / 228 / 2, 202 / 229 / 3, 205 / 230 / 2, 154 / 231 / 2, 29 / 232 / 2, 240 / 233 / 2, 107 / 234 / 4, 44 / 235 / 2, 138 / 236 / 2, 177 / 237 / 2, 8 / 238 / 3, 228 / 239 / 2, 85 / 240 / 2, 139 / 241 / 2, 248 / 242 / 3, 165 / 243 / 2, 192 / 244 / 2, 164 / 245 / 4, 195 / 246 / 2, 118 / 247 / 2, 178 / 248 / 4, 58 / 249 / 2
singlecenter-alpha_1-112-n250.txt, 1, 1, 250, 1965.17, 1896, 1646, 7, 249,32 / 1 / 2, 198 / 2 / 5, 64 / 3 / 2, 67 / 4 / 2, 1 / 5 / 2, 2 / 6 / 2, 26 / 7 / 3, 61 / 8 / 2, 59 / 9 / 3, 206 / 10 / 2, 94 / 11 / 3, 147 / 12 / 2, 123 / 13 / 2, 135 / 14 / 2, 69 / 15 / 2, 72 / 16 / 2, 109 / 17 / 3, 60 / 18 / 2, 249 / 19 / 3, 75 / 20 / 2, 166 / 21 / 3, 81 / 22 / 2, 159 / 23 / 2, 187 / 24 / 2, 57 / 25 / 2, 52 / 26 / 2, 192 / 27 / 3, 24 / 28 / 2, 36 / 29 / 5, 71 / 30 / 2, 179 / 31 / 2, 194 / 32 / 2, 82 / 33 / 5, 171 / 34 / 2, 217 / 35 / 2, 237 / 36 / 3, 110 / 37 / 2, 122 / 38 / 3, 124 / 39 / 2, 126 / 40 / 3, 63 / 41 / 2, 34 / 42 / 3, 184 / 43 / 2, 218 / 44 / 2, 245 / 45 / 2, 140 / 46 / 3, 39 / 47 / 2, 111 / 48 / 2, 99 / 49 / 2, 209 / 50 / 3, 84 / 51 / 2, 80 / 52 / 2, 46 / 53 / 4, 233 / 54 / 2, 98 / 55 / 2, 223 / 56 / 2, 68 / 57 / 2, 175 / 58 / 2, 50 / 59 / 3, 96 / 60 / 2, 85 / 61 / 2, 229 / 62 / 4, 17 / 63 / 2, 86 / 64 / 3, 22 / 65 / 2, 12 / 66 / 2, 11 / 67 / 2, 238 / 68 / 2, 66 / 69 / 4, 234 / 70 / 2, 91 / 71 / 2, 93 / 72 / 2, 168 / 73 / 4, 54 / 74 / 2, 183 / 75 / 2, 180 / 76 / 3, 117 / 77 / 2, 164 / 78 / 4, 113 / 79 / 2, 162 / 80 / 3, 28 / 81 / 2, 203 / 82 / 2, 102 / 83 / 2, 33 / 84 / 2, 30 / 85 / 2, 41 / 86 / 2, 53 / 87 / 6, 115 / 88 / 2, 27 / 89 / 3, 243 / 90 / 2, 97 / 91 / 2, 150 / 92 / 6, 181 / 93 / 2, 208 / 94 / 2, 142 / 95 / 2, 149 / 96 / 2, 211 / 97 / 3, 29 / 98 / 2, 3 / 99 / 3, 169 / 100 / 2, 212 / 101 / 2, 151 / 102 / 3, 210 / 103 / 2, 101 / 104 / 2, 105 / 105 / 3, 146 / 106 / 2, 6 / 107 / 2, 239 / 108 / 4, 224 / 109 / 2, 236 / 110 / 2, 5 / 111 / 4, 139 / 112 / 2, 104 / 113 / 2, 176 / 114 / 2, 10 / 115 / 2, 156 / 116 / 2, 125 / 117 / 2, 173 / 118 / 2, 119 / 119 / 2, 242 / 120 / 2, 143 / 121 / 3, 4 / 122 / 2, 197 / 123 / 2, 226 / 124 / 3, 157 / 125 / 2, 88 / 126 / 3, 15 / 127 / 2, 78 / 128 / 2, 161 / 129 / 2, 14 / 130 / 2, 92 / 131 / 4, 128 / 132 / 2, 83 / 133 / 2, 199 / 134 / 2, 89 / 135 / 2, 133 / 136 / 2, 202 / 137 / 2, 120 / 138 / 2, 49 / 139 / 3, 160 / 140 / 2, 191 / 141 / 2, 132 / 142 / 7, 58 / 143 / 2, 186 / 144 / 2, 74 / 145 / 2, 207 / 146 / 3, 195 / 147 / 2, 144 / 148 / 2, 155 / 149 / 2, 130 / 150 / 3, 31 / 151 / 2, 108 / 152 / 2, 200 / 153 / 2, 182 / 154 / 5, 240 / 155 / 2, 185 / 156 / 2, 154 / 157 / 2, 188 / 158 / 2, 90 / 159 / 3, 114 / 160 / 2, 163 / 161 / 3, 18 / 162 / 2, 129 / 163 / 4, 42 / 164 / 2, 37 / 165 / 3, 193 / 166 / 2, 56 / 167 / 2, 121 / 168 / 2, 45 / 169 / 3, 76 / 170 / 2, 35 / 171 / 3, 215 / 172 / 2, 55 / 173 / 2, 152 / 174 / 2, 62 / 175 / 2, 19 / 176 / 2, 44 / 177 / 2, 127 / 178 / 3, 116 / 179 / 2, 241 / 180 / 2, 221 / 181 / 3, 107 / 182 / 2, 158 / 183 / 3, 167 / 184 / 2, 13 / 185 / 2, 225 / 186 / 2, 177 / 187 / 2, 9 / 188 / 2, 21 / 189 / 3, 136 / 190 / 2, 231 / 191 / 3, 247 / 192 / 2, 51 / 193 / 2, 7 / 194 / 2, 8 / 195 / 2, 222 / 196 / 2, 25 / 197 / 2, 232 / 198 / 2, 16 / 199 / 2, 165 / 200 / 4, 40 / 201 / 2, 138 / 202 / 2, 230 / 203 / 3, 214 / 204 / 2, 246 / 205 / 2, 48 / 206 / 2, 43 / 207 / 2, 118 / 208 / 2, 189 / 209 / 2, 103 / 210 / 2, 235 / 211 / 2, 170 / 212 / 3, 106 / 213 / 2, 196 / 214 / 2, 227 / 215 / 3, 220 / 216 / 2, 201 / 217 / 2, 216 / 218 / 2, 219 / 219 / 3, 204 / 220 / 2, 65 / 221 / 3, 228 / 222 / 2, 87 / 223 / 2, 73 / 224 / 2, 47 / 225 / 3, 112 / 226 / 2, 23 / 227 / 3, 172 / 228 / 2, 213 / 229 / 4, 205 / 230 / 2, 70 / 231 / 3, 145 / 232 / 2, 77 / 233 / 2, 190 / 234 / 2, 79 / 235 / 2, 38 / 236 / 2, 141 / 237 / 3, 148 / 238 / 2, 131 / 239 / 2, 137 / 240 / 3, 95 / 241 / 2, 174 / 242 / 3, 153 / 243 / 2, 248 / 244 / 2, 100 / 245 / 3, 20 / 246 / 2, 178 / 247 / 3, 244 / 248 / 2, 134 / 249 / 2
singlecenter-alpha_1-113-n250.txt, 1, 1, 250, 2181.71, 1833, 1583, 8, 249,28 / 1 / 3, 212 / 2 / 2, 239 / 3 / 2, 18 / 4 / 8, 165 / 5 / 2, 91 / 6 / 2, 89 / 7 / 3, 136 / 8 / 2, 137 / 9 / 2, 70 / 10 / 3, 76 / 11 / 2, 84 / 12 / 4, 104 / 13 / 2, 186 / 14 / 2, 78 / 15 / 2, 22 / 16 / 4, 75 / 17 / 2, 58 / 18 / 2, 214 / 19 / 2, 73 / 20 / 2, 138 / 21 / 2, 63 / 22 / 3, 105 / 23 / 2, 57 / 24 / 3, 13 / 25 / 2, 242 / 26 / 2, 6 / 27 / 2, 246 / 28 / 3, 231 / 29 / 2, 177 / 30 / 4, 54 / 31 / 2, 30 / 32 / 2, 96 / 33 / 2, 71 / 34 / 2, 132 / 35 / 2, 164 / 36 / 4, 238 / 37 / 2, 157 / 38 / 3, 249 / 39 / 2, 20 / 40 / 3, 87 / 41 / 2, 218 / 42 / 3, 200 / 43 / 2, 120 / 44 / 3, 248 / 45 / 2, 161 / 46 / 2, 83 / 47 / 2, 50 / 48 / 2, 14 / 49 / 2, 184 / 50 / 2, 85 / 51 / 2, 199 / 52 / 4, 244 / 53 / 2, 216 / 54 / 2, 48 / 55 / 4, 192 / 56 / 2, 176 / 57 / 2, 146 / 58 / 2, 208 / 59 / 3, 188 / 60 / 2, 206 / 61 / 3, 235 / 62 / 2, 190 / 63 / 2, 124 / 64 / 2, 67 / 65 / 2, 194 / 66 / 2, 26 / 67 / 2, 197 / 68 / 2, 167 / 69 / 2, 51 / 70 / 2, 65 / 71 / 2, 45 / 72 / 3, 243 / 73 / 2, 183 / 74 / 3, 189 / 75 / 2, 170 / 76 / 2, 142 / 77 / 2, 159 / 78 / 2, 228 / 79 / 2, 213 / 80 / 3, 245 / 81 / 2, 47 / 82 / 3, 133 / 83 / 2, 111 / 84 / 2, 8 / 85 / 3, 33 / 86 / 2, 109 / 87 / 3, 204 / 88 / 2, 172 / 89 / 3, 241 / 90 / 2, 127 / 91 / 3, 23 / 92 / 2, 7 / 93 / 2, 220 / 94 / 2, 210 / 95 / 3, 211 / 96 / 2, 150 / 97 / 3, 86 / 98 / 2, 201 / 99 / 2, 103 / 100 / 2, 156 / 101 / 2, 121 / 102 / 4, 61 / 103 / 2, 82 / 104 / 2, 140 / 105 / 3, 158 / 106 / 2, 74 / 107 / 2, 69 / 108 / 3, 205 / 109 / 2, 1 / 110 / 2, 149 / 111 / 3, 27 / 112 / 2, 187 / 113 / 2, 34 / 114 / 2, 166 / 115 / 3, 131 / 116 / 2, 129 / 117 / 4, 55 / 118 / 2, 43 / 119 / 2, 233 / 120 / 3, 38 / 121 / 2, 169 / 122 / 3, 108 / 123 / 2, 77 / 124 / 2, 56 / 125 / 2, 237 / 126 / 2, 112 / 127 / 4, 53 / 128 / 2, 225 / 129 / 2, 162 / 130 / 2, 24 / 131 / 2, 107 / 132 / 2, 117 / 133 / 2, 226 / 134 / 3, 66 / 135 / 2, 160 / 136 / 2, 21 / 137 / 2, 68 / 138 / 2, 139 / 139 / 2, 202 / 140 / 2, 143 / 141 / 3, 16 / 142 / 2, 221 / 143 / 2, 175 / 144 / 2, 3 / 145 / 2, 95 / 146 / 2, 154 / 147 / 2, 215 / 148 / 2, 17 / 149 / 2, 153 / 150 / 2, 181 / 151 / 2, 93 / 152 / 2, 12 / 153 / 2, 32 / 154 / 2, 223 / 155 / 2, 41 / 156 / 3, 196 / 157 / 2, 98 / 158 / 2, 31 / 159 / 2, 240 / 160 / 2, 88 / 161 / 2, 227 / 162 / 2, 122 / 163 / 2, 100 / 164 / 2, 130 / 165 / 4, 247 / 166 / 2, 44 / 167 / 2, 114 / 168 / 3, 126 / 169 / 2, 81 / 170 / 2, 155 / 171 / 3, 10 / 172 / 2, 115 / 173 / 4, 29 / 174 / 2, 217 / 175 / 2, 59 / 176 / 3, 168 / 177 / 2, 152 / 178 / 2, 147 / 179 / 3, 90 / 180 / 2, 203 / 181 / 2, 178 / 182 / 2, 118 / 183 / 2, 102 / 184 / 4, 46 / 185 / 2, 219 / 186 / 2, 134 / 187 / 2, 19 / 188 / 3, 49 / 189 / 2, 101 / 190 / 2, 125 / 191 / 2, 173 / 192 / 2, 191 / 193 / 2, 163 / 194 / 2, 180 / 195 / 2, 174 / 196 / 3, 39 / 197 / 2, 113 / 198 / 3, 4 / 199 / 2, 229 / 200 / 2, 230 / 201 / 4, 15 / 202 / 2, 198 / 203 / 3, 99 / 204 / 2, 106 / 205 / 5, 79 / 206 / 2, 123 / 207 / 2, 171 / 208 / 2, 207 / 209 / 2, 222 / 210 / 3, 35 / 211 / 2, 116 / 212 / 2, 141 / 213 / 3, 64 / 214 / 2, 135 / 215 / 2, 185 / 216 / 2, 11 / 217 / 2, 145 / 218 / 4, 195 / 219 / 2, 232 / 220 / 3, 36 / 221 / 2, 9 / 222 / 2, 92 / 223 / 2, 97 / 224 / 2, 2 / 225 / 3, 94 / 226 / 2, 151 / 227 / 2, 25 / 228 / 3, 209 / 229 / 2, 52 / 230 / 3, 72 / 231 / 2, 128 / 232 / 2, 182 / 233 / 2, 119 / 234 / 2, 110 / 235 / 2, 37 / 236 / 2, 42 / 237 / 2, 62 / 238 / 2, 60 / 239 / 2, 234 / 240 / 3, 144 / 241 / 2, 193 / 242 / 2, 224 / 243 / 5, 5 / 244 / 2, 179 / 245 / 2, 148 / 246 / 2, 236 / 247 / 2, 80 / 248 / 5, 40 / 249 / 2
singlecenter-alpha_1-114-n250.txt, 1, 1, 250, 2096.43, 1929, 1679, 6, 249,221 / 1 / 2, 137 / 2 / 4, 236 / 3 / 2, 37 / 4 / 3, 108 / 5 / 2, 134 / 6 / 2, 12 / 7 / 4, 165 / 8 / 2, 85 / 9 / 2, 195 / 10 / 3, 120 / 11 / 2, 190 / 12 / 2, 34 / 13 / 2, 194 / 14 / 3, 100 / 15 / 2, 122 / 16 / 3, 80 / 17 / 2, 185 / 18 / 2, 77 / 19 / 4, 146 / 20 / 2, 42 / 21 / 2, 218 / 22 / 3, 162 / 23 / 2, 92 / 24 / 2, 174 / 25 / 3, 55 / 26 / 2, 106 / 27 / 2, 61 / 28 / 2, 182 / 29 / 2, 23 / 30 / 2, 208 / 31 / 2, 40 / 32 / 2, 36 / 33 / 2, 118 / 34 / 2, 102 / 35 / 2, 66 / 36 / 3, 60 / 37 / 2, 84 / 38 / 2, 138 / 39 / 2, 188 / 40 / 2, 116 / 41 / 2, 239 / 42 / 6, 127 / 43 / 2, 87 / 44 / 2, 224 / 45 / 2, 153 / 46 / 2, 49 / 47 / 3, 212 / 48 / 2, 169 / 49 / 5, 240 / 50 / 2, 73 / 51 / 2, 57 / 52 / 4, 94 / 53 / 2, 237 / 54 / 2, 219 / 55 / 3, 32 / 56 / 2, 148 / 57 / 3, 167 / 58 / 2, 210 / 59 / 3, 163 / 60 / 2, 67 / 61 / 3, 154 / 62 / 2, 24 / 63 / 3, 245 / 64 / 2, 74 / 65 / 3, 39 / 66 / 2, 5 / 67 / 3, 220 / 68 / 2, 88 / 69 / 2, 226 / 70 / 3, 82 / 71 / 2, 7 / 72 / 2, 13 / 73 / 2, 110 / 74 / 2, 105 / 75 / 2, 48 / 76 / 6, 234 / 77 / 2, 247 / 78 / 2, 166 / 79 / 3, 115 / 80 / 2, 51 / 81 / 2, 19 / 82 / 2, 168 / 83 / 6, 63 / 84 / 2, 156 / 85 / 2, 192 / 86 / 3, 152 / 87 / 2, 248 / 88 / 2, 143 / 89 / 3, 170 / 90 / 2, 68 / 91 / 3, 26 / 92 / 2, 11 / 93 / 2, 90 / 94 / 3, 164 / 95 / 2, 3 / 96 / 2, 235 / 97 / 3, 38 / 98 / 2, 44 / 99 / 2, 161 / 100 / 2, 111 / 101 / 2, 97 / 102 / 4, 197 / 103 / 2, 20 / 104 / 2, 149 / 105 / 6, 114 / 106 / 2, 33 / 107 / 3, 101 / 108 / 2, 27 / 109 / 2, 91 / 110 / 3, 159 / 111 / 2, 184 / 112 / 2, 59 / 113 / 2, 228 / 114 / 3, 129 / 115 / 2, 222 / 116 / 2, 241 / 117 / 3, 50 / 118 / 2, 125 / 119 / 2, 187 / 120 / 5, 47 / 121 / 2, 104 / 122 / 2, 52 / 123 / 2, 238 / 124 / 2, 70 / 125 / 2, 64 / 126 / 2, 205 / 127 / 2, 124 / 128 / 2, 109 / 129 / 2, 145 / 130 / 2, 99 / 131 / 3, 196 / 132 / 2, 107 / 133 / 3, 56 / 134 / 2, 173 / 135 / 2, 10 / 136 / 2, 230 / 137 / 2, 217 / 138 / 3, 179 / 139 / 2, 209 / 140 / 3, 183 / 141 / 2, 14 / 142 / 2, 72 / 143 / 3, 69 / 144 / 2, 53 / 145 / 2, 202 / 146 / 3, 17 / 147 / 2, 199 / 148 / 2, 81 / 149 / 2, 75 / 150 / 4, 54 / 151 / 2, 31 / 152 / 2, 140 / 153 / 2, 181 / 154 / 2, 225 / 155 / 2, 155 / 156 / 2, 9 / 157 / 2, 46 / 158 / 4, 43 / 159 / 2, 95 / 160 / 2, 243 / 161 / 4, 6 / 162 / 2, 233 / 163 / 2, 216 / 164 / 4, 223 / 165 / 2, 126 / 166 / 2, 229 / 167 / 2, 213 / 168 / 3, 198 / 169 / 2, 21 / 170 / 4, 76 / 171 / 2, 141 / 172 / 2, 8 / 173 / 3, 58 / 174 / 2, 135 / 175 / 3, 28 / 176 / 2, 98 / 177 / 2, 177 / 178 / 2, 62 / 179 / 2, 4 / 180 / 2, 18 / 181 / 5, 15 / 182 / 2, 189 / 183 / 2, 201 / 184 / 2, 249 / 185 / 2, 136 / 186 / 3, 83 / 187 / 2, 227 / 188 / 2, 103 / 189 / 2, 117 / 190 / 2, 30 / 191 / 2, 130 / 192 / 2, 2 / 193 / 2, 151 / 194 / 2, 96 / 195 / 3, 158 / 196 / 2, 172 / 197 / 2, 147 / 198 / 2, 1 / 199 / 3, 79 / 200 / 2, 119 / 201 / 2, 128 / 202 / 5, 22 / 203 / 2, 132 / 204 / 2, 232 / 205 / 2, 175 / 206 / 2, 231 / 207 / 6, 246 / 208 / 2, 203 / 209 / 3, 113 / 210 / 2, 214 / 211 / 3, 45 / 212 / 2, 65 / 213 / 3, 29 / 214 / 2, 86 / 215 / 3, 193 / 216 / 2, 133 / 217 / 2, 242 / 218 / 2, 191 / 219 / 2, 160 / 220 / 3, 35 / 221 / 2, 89 / 222 / 2, 71 / 223 / 3, 207 / 224 / 2, 215 / 225 / 3, 112 / 226 / 2, 211 / 227 / 2, 144 / 228 / 3, 186 / 229 / 2, 131 / 230 / 2, 121 / 231 / 2, 176 / 232 / 4, 157 / 233 / 2, 16 / 234 / 2, 204 / 235 / 4, 206 / 236 / 2, 142 / 237 / 2, 123 / 238 / 2, 139 / 239 / 3, 171 / 240 / 2, 41 / 241 / 3, 78 / 242 / 2, 180 / 243 / 2, 93 / 244 / 2, 244 / 245 / 3, 25 / 246 / 2, 150 / 247 / 2, 200 / 248 / 4, 178 / 249 / 2
singlecenter-alpha_1-115-n250.txt, 1, 1, 250, 2287.67, 2091, 1841, 10, 249,33 / 1 / 6, 124 / 2 / 2, 78 / 3 / 2, 248 / 4 / 3, 118 / 5 / 2, 4 / 6 / 3, 1 / 7 / 2, 137 / 8 / 4, 65 / 9 / 2, 24 / 10 / 2, 245 / 11 / 2, 162 / 12 / 2, 67 / 13 / 2, 117 / 14 / 2, 39 / 15 / 2, 208 / 16 / 2, 185 / 17 / 2, 244 / 18 / 2, 233 / 19 / 3, 83 / 20 / 2, 61 / 21 / 4, 56 / 22 / 2, 102 / 23 / 2, 148 / 24 / 4, 90 / 25 / 2, 48 / 26 / 2, 164 / 27 / 2, 158 / 28 / 2, 75 / 29 / 3, 125 / 30 / 2, 73 / 31 / 2, 160 / 32 / 2, 219 / 33 / 3, 49 / 34 / 2, 186 / 35 / 2, 157 / 36 / 2, 99 / 37 / 2, 89 / 38 / 3, 197 / 39 / 2, 151 / 40 / 2, 171 / 41 / 2, 10 / 42 / 2, 18 / 43 / 4, 121 / 44 / 2, 88 / 45 / 2, 13 / 46 / 2, 221 / 47 / 4, 161 / 48 / 2, 131 / 49 / 3, 183 / 50 / 2, 205 / 51 / 2, 138 / 52 / 2, 115 / 53 / 2, 119 / 54 / 2, 155 / 55 / 2, 123 / 56 / 4, 236 / 57 / 2, 204 / 58 / 2, 11 / 59 / 3, 68 / 60 / 2, 170 / 61 / 3, 167 / 62 / 2, 173 / 63 / 3, 163 / 64 / 2, 182 / 65 / 2, 43 / 66 / 2, 31 / 67 / 2, 192 / 68 / 2, 50 / 69 / 2, 100 / 70 / 4, 30 / 71 / 2, 189 / 72 / 2, 74 / 73 / 2, 174 / 74 / 4, 188 / 75 / 2, 57 / 76 / 2, 218 / 77 / 4, 109 / 78 / 2, 120 / 79 / 3, 71 / 80 / 2, 144 / 81 / 2, 21 / 82 / 2, 132 / 83 / 5, 55 / 84 / 2, 15 / 85 / 2, 216 / 86 / 2, 17 / 87 / 4, 16 / 88 / 2, 234 / 89 / 3, 184 / 90 / 2, 181 / 91 / 2, 111 / 92 / 2, 101 / 93 / 4, 149 / 94 / 2, 222 / 95 / 2, 226 / 96 / 2, 175 / 97 / 3, 166 / 98 / 2, 40 / 99 / 2, 60 / 100 / 3, 122 / 101 / 2, 235 / 102 / 2, 207 / 103 / 2, 246 / 104 / 3, 116 / 105 / 2, 228 / 106 / 2, 206 / 107 / 3, 249 / 108 / 2, 240 / 109 / 2, 150 / 110 / 2, 203 / 111 / 2, 27 / 112 / 2, 63 / 113 / 3, 172 / 114 / 2, 129 / 115 / 3, 92 / 116 / 2, 52 / 117 / 3, 134 / 118 / 2, 80 / 119 / 2, 58 / 120 / 2, 69 / 121 / 3, 229 / 122 / 2, 26 / 123 / 3, 53 / 124 / 2, 37 / 125 / 3, 7 / 126 / 2, 96 / 127 / 4, 36 / 128 / 2, 5 / 129 / 2, 79 / 130 / 4, 94 / 131 / 2, 93 / 132 / 2, 41 / 133 / 2, 227 / 134 / 3, 217 / 135 / 2, 106 / 136 / 10, 210 / 137 / 2, 77 / 138 / 2, 72 / 139 / 3, 133 / 140 / 2, 247 / 141 / 5, 200 / 142 / 2, 25 / 143 / 2, 3 / 144 / 2, 212 / 145 / 3, 141 / 146 / 2, 66 / 147 / 2, 187 / 148 / 2, 194 / 149 / 2, 202 / 150 / 4, 201 / 151 / 2, 199 / 152 / 2, 213 / 153 / 2, 95 / 154 / 5, 20 / 155 / 2, 103 / 156 / 2, 193 / 157 / 2, 23 / 158 / 3, 14 / 159 / 2, 220 / 160 / 2, 76 / 161 / 3, 127 / 162 / 2, 238 / 163 / 2, 136 / 164 / 3, 113 / 165 / 2, 135 / 166 / 2, 91 / 167 / 2, 130 / 168 / 2, 198 / 169 / 3, 231 / 170 / 2, 196 / 171 / 2, 215 / 172 / 2, 239 / 173 / 2, 47 / 174 / 3, 98 / 175 / 2, 241 / 176 / 3, 168 / 177 / 2, 165 / 178 / 2, 82 / 179 / 3, 12 / 180 / 2, 29 / 181 / 2, 110 / 182 / 3, 6 / 183 / 2, 64 / 184 / 2, 8 / 185 / 3, 19 / 186 / 2, 211 / 187 / 3, 224 / 188 / 2, 114 / 189 / 2, 145 / 190 / 2, 195 / 191 / 5, 146 / 192 / 2, 84 / 193 / 2, 143 / 194 / 2, 51 / 195 / 2, 108 / 196 / 2, 180 / 197 / 2, 104 / 198 / 2, 214 / 199 / 2, 177 / 200 / 2, 59 / 201 / 6, 169 / 202 / 2, 191 / 203 / 2, 232 / 204 / 2, 242 / 205 / 2, 179 / 206 / 3, 153 / 207 / 2, 139 / 208 / 2, 225 / 209 / 4, 9 / 210 / 2, 243 / 211 / 2, 223 / 212 / 3, 147 / 213 / 2, 34 / 214 / 2, 190 / 215 / 2, 86 / 216 / 2, 45 / 217 / 2, 97 / 218 / 4, 140 / 219 / 2, 105 / 220 / 2, 126 / 221 / 2, 32 / 222 / 4, 42 / 223 / 2, 209 / 224 / 2, 44 / 225 / 2, 54 / 226 / 2, 107 / 227 / 2, 237 / 228 / 2, 46 / 229 / 2, 35 / 230 / 2, 22 / 231 / 3, 128 / 232 / 2, 178 / 233 / 2, 81 / 234 / 2, 154 / 235 / 2, 156 / 236 / 4, 152 / 237 / 2, 112 / 238 / 3, 142 / 239 / 2, 87 / 240 / 2, 62 / 241 / 2, 70 / 242 / 3, 2 / 243 / 2, 176 / 244 / 2, 38 / 245 / 2, 85 / 246 / 2, 230 / 247 / 2, 159 / 248 / 2, 28 / 249 / 2
singlecenter-alpha_1-116-n250.txt, 1, 1, 250, 2266.25, 1875, 1625, 7, 249,51 / 1 / 2, 57 / 2 / 2, 3 / 3 / 7, 148 / 4 / 2, 45 / 5 / 2, 99 / 6 / 2, 39 / 7 / 2, 53 / 8 / 3, 185 / 9 / 2, 208 / 10 / 3, 62 / 11 / 2, 241 / 12 / 2, 242 / 13 / 2, 56 / 14 / 3, 191 / 15 / 2, 28 / 16 / 3, 111 / 17 / 2, 38 / 18 / 5, 245 / 19 / 2, 211 / 20 / 2, 220 / 21 / 2, 50 / 22 / 3, 23 / 23 / 2, 132 / 24 / 2, 79 / 25 / 2, 188 / 26 / 2, 13 / 27 / 2, 199 / 28 / 2, 114 / 29 / 2, 213 / 30 / 2, 232 / 31 / 3, 108 / 32 / 2, 71 / 33 / 2, 52 / 34 / 2, 74 / 35 / 2, 101 / 36 / 3, 214 / 37 / 2, 219 / 38 / 2, 89 / 39 / 3, 27 / 40 / 2, 83 / 41 / 2, 143 / 42 / 4, 197 / 43 / 2, 158 / 44 / 2, 195 / 45 / 5, 116 / 46 / 2, 215 / 47 / 2, 167 / 48 / 2, 186 / 49 / 2, 138 / 50 / 3, 22 / 51 / 2, 202 / 52 / 3, 5 / 53 / 2, 119 / 54 / 2, 247 / 55 / 2, 234 / 56 / 2, 11 / 57 / 3, 227 / 58 / 2, 190 / 59 / 2, 26 / 60 / 3, 110 / 61 / 2, 236 / 62 / 3, 204 / 63 / 2, 107 / 64 / 2, 129 / 65 / 2, 206 / 66 / 2, 14 / 67 / 3, 139 / 68 / 2, 41 / 69 / 5, 76 / 70 / 2, 180 / 71 / 2, 249 / 72 / 4, 17 / 73 / 2, 216 / 74 / 2, 123 / 75 / 3, 100 / 76 / 2, 226 / 77 / 2, 112 / 78 / 2, 115 / 79 / 5, 20 / 80 / 2, 66 / 81 / 2, 147 / 82 / 2, 184 / 83 / 2, 122 / 84 / 4, 6 / 85 / 2, 233 / 86 / 2, 25 / 87 / 4, 78 / 88 / 2, 174 / 89 / 2, 244 / 90 / 3, 230 / 91 / 2, 34 / 92 / 2, 135 / 93 / 3, 96 / 94 / 2, 40 / 95 / 3, 126 / 96 / 2, 8 / 97 / 2, 246 / 98 / 3, 152 / 99 / 2, 146 / 100 / 2, 154 / 101 / 5, 165 / 102 / 2, 43 / 103 / 3, 24 / 104 / 2, 95 / 105 / 2, 248 / 106 / 3, 64 / 107 / 2, 153 / 108 / 2, 44 / 109 / 3, 131 / 110 / 2, 9 / 111 / 2, 218 / 112 / 2, 113 / 113 / 2, 134 / 114 / 2, 160 / 115 / 2, 93 / 116 / 2, 229 / 117 / 2, 46 / 118 / 4, 228 / 119 / 2, 72 / 120 / 2, 162 / 121 / 2, 98 / 122 / 2, 201 / 123 / 2, 182 / 124 / 2, 172 / 125 / 2, 133 / 126 / 2, 86 / 127 / 4, 243 / 128 / 2, 157 / 129 / 2, 15 / 130 / 4, 166 / 131 / 2, 164 / 132 / 2, 150 / 133 / 3, 63 / 134 / 2, 104 / 135 / 3, 149 / 136 / 2, 117 / 137 / 3, 203 / 138 / 2, 136 / 139 / 3, 7 / 140 / 2, 4 / 141 / 5, 124 / 142 / 2, 31 / 143 / 2, 231 / 144 / 2, 120 / 145 / 2, 237 / 146 / 2, 18 / 147 / 3, 207 / 148 / 2, 212 / 149 / 2, 82 / 150 / 2, 221 / 151 / 4, 156 / 152 / 2, 1 / 153 / 2, 84 / 154 / 4, 194 / 155 / 2, 2 / 156 / 2, 10 / 157 / 3, 65 / 158 / 2, 80 / 159 / 2, 85 / 160 / 2, 240 / 161 / 2, 145 / 162 / 3, 173 / 163 / 2, 141 / 164 / 2, 47 / 165 / 2, 238 / 166 / 2, 36 / 167 / 2, 193 / 168 / 2, 42 / 169 / 2, 73 / 170 / 2, 151 / 171 / 2, 239 / 172 / 3, 176 / 173 / 2, 12 / 174 / 2, 60 / 175 / 3, 19 / 176 / 2, 235 / 177 / 2, 48 / 178 / 3, 198 / 179 / 2, 181 / 180 / 2, 217 / 181 / 4, 97 / 182 / 2, 30 / 183 / 2, 118 / 184 / 4, 91 / 185 / 2, 161 / 186 / 3, 178 / 187 / 2, 155 / 188 / 3, 137 / 189 / 2, 128 / 190 / 3, 106 / 191 / 2, 88 / 192 / 2, 168 / 193 / 2, 183 / 194 / 2, 35 / 195 / 3, 33 / 196 / 2, 103 / 197 / 3, 121 / 198 / 2, 54 / 199 / 2, 58 / 200 / 4, 69 / 201 / 2, 222 / 202 / 3, 32 / 203 / 2, 175 / 204 / 2, 189 / 205 / 3, 61 / 206 / 2, 130 / 207 / 3, 37 / 208 / 2, 109 / 209 / 2, 29 / 210 / 3, 179 / 211 / 2, 92 / 212 / 2, 205 / 213 / 2, 67 / 214 / 3, 200 / 215 / 2, 90 / 216 / 2, 59 / 217 / 2, 87 / 218 / 2, 169 / 219 / 4, 196 / 220 / 2, 55 / 221 / 2, 192 / 222 / 3, 49 / 223 / 2, 142 / 224 / 3, 94 / 225 / 2, 223 / 226 / 2, 102 / 227 / 2, 68 / 228 / 2, 210 / 229 / 2, 105 / 230 / 4, 171 / 231 / 2, 127 / 232 / 3, 21 / 233 / 2, 224 / 234 / 2, 187 / 235 / 3, 16 / 236 / 2, 177 / 237 / 2, 75 / 238 / 2, 209 / 239 / 3, 144 / 240 / 2, 70 / 241 / 2, 125 / 242 / 2, 81 / 243 / 2, 163 / 244 / 2, 77 / 245 / 3, 170 / 246 / 2, 140 / 247 / 2, 159 / 248 / 2, 225 / 249 / 4
singlecenter-alpha_1-117-n250.txt, 1, 1, 250, 2334.85, 2049, 1799, 7, 249,80 / 1 / 2, 126 / 2 / 2, 116 / 3 / 3, 1 / 4 / 2, 117 / 5 / 2, 146 / 6 / 2, 197 / 7 / 3, 225 / 8 / 2, 226 / 9 / 3, 204 / 10 / 2, 8 / 11 / 2, 33 / 12 / 3, 61 / 13 / 2, 220 / 14 / 2, 67 / 15 / 4, 115 / 16 / 2, 162 / 17 / 2, 184 / 18 / 4, 75 / 19 / 2, 81 / 20 / 3, 21 / 21 / 2, 231 / 22 / 3, 195 / 23 / 2, 7 / 24 / 2, 244 / 25 / 4, 145 / 26 / 2, 140 / 27 / 3, 50 / 28 / 2, 96 / 29 / 3, 176 / 30 / 2, 209 / 31 / 3, 152 / 32 / 2, 157 / 33 / 3, 130 / 34 / 2, 167 / 35 / 2, 5 / 36 / 2, 191 / 37 / 4, 49 / 38 / 2, 215 / 39 / 2, 106 / 40 / 3, 113 / 41 / 2, 72 / 42 / 3, 175 / 43 / 2, 221 / 44 / 4, 218 / 45 / 2, 242 / 46 / 3, 13 / 47 / 2, 166 / 48 / 4, 247 / 49 / 2, 165 / 50 / 2, 216 / 51 / 6, 208 / 52 / 2, 134 / 53 / 2, 118 / 54 / 3, 243 / 55 / 2, 147 / 56 / 7, 154 / 57 / 2, 15 / 58 / 2, 234 / 59 / 3, 128 / 60 / 2, 124 / 61 / 3, 174 / 62 / 2, 159 / 63 / 4, 58 / 64 / 2, 190 / 65 / 2, 46 / 66 / 3, 59 / 67 / 2, 4 / 68 / 3, 25 / 69 / 2, 84 / 70 / 2, 79 / 71 / 2, 185 / 72 / 4, 45 / 73 / 2, 241 / 74 / 2, 219 / 75 / 4, 129 / 76 / 2, 182 / 77 / 2, 238 / 78 / 2, 196 / 79 / 3, 164 / 80 / 2, 235 / 81 / 2, 171 / 82 / 3, 91 / 83 / 2, 90 / 84 / 6, 42 / 85 / 2, 205 / 86 / 2, 82 / 87 / 2, 51 / 88 / 2, 136 / 89 / 2, 85 / 90 / 4, 127 / 91 / 2, 133 / 92 / 2, 187 / 93 / 4, 6 / 94 / 2, 2 / 95 / 2, 122 / 96 / 2, 62 / 97 / 2, 43 / 98 / 3, 203 / 99 / 2, 111 / 100 / 3, 60 / 101 / 2, 54 / 102 / 3, 168 / 103 / 2, 188 / 104 / 2, 236 / 105 / 2, 172 / 106 / 2, 177 / 107 / 2, 48 / 108 / 4, 156 / 109 / 2, 107 / 110 / 3, 114 / 111 / 2, 183 / 112 / 3, 66 / 113 / 2, 11 / 114 / 2, 17 / 115 / 2, 98 / 116 / 3, 95 / 117 / 2, 93 / 118 / 2, 28 / 119 / 2, 110 / 120 / 3, 193 / 121 / 2, 153 / 122 / 2, 139 / 123 / 2, 143 / 124 / 2, 34 / 125 / 4, 104 / 126 / 2, 31 / 127 / 2, 63 / 128 / 2, 181 / 129 / 2, 65 / 130 / 3, 92 / 131 / 2, 36 / 132 / 2, 119 / 133 / 2, 99 / 134 / 5, 163 / 135 / 2, 22 / 136 / 2, 207 / 137 / 2, 173 / 138 / 3, 206 / 139 / 2, 227 / 140 / 2, 24 / 141 / 2, 16 / 142 / 2, 125 / 143 / 2, 112 / 144 / 2, 223 / 145 / 2, 97 / 146 / 3, 56 / 147 / 2, 230 / 148 / 3, 180 / 149 / 2, 224 / 150 / 2, 151 / 151 / 3, 89 / 152 / 2, 144 / 153 / 2, 76 / 154 / 2, 186 / 155 / 3, 19 / 156 / 2, 135 / 157 / 2, 178 / 158 / 2, 158 / 159 / 2, 248 / 160 / 2, 100 / 161 / 2, 74 / 162 / 2, 160 / 163 / 2, 237 / 164 / 2, 141 / 165 / 2, 109 / 166 / 3, 150 / 167 / 2, 137 / 168 / 4, 71 / 169 / 2, 212 / 170 / 2, 229 / 171 / 3, 233 / 172 / 2, 47 / 173 / 4, 68 / 174 / 2, 23 / 175 / 2, 101 / 176 / 2, 57 / 177 / 2, 12 / 178 / 2, 38 / 179 / 3, 32 / 180 / 2, 131 / 181 / 3, 155 / 182 / 2, 228 / 183 / 3, 194 / 184 / 2, 189 / 185 / 3, 132 / 186 / 2, 55 / 187 / 2, 202 / 188 / 2, 198 / 189 / 3, 83 / 190 / 2, 35 / 191 / 2, 78 / 192 / 3, 29 / 193 / 2, 246 / 194 / 2, 232 / 195 / 3, 53 / 196 / 2, 14 / 197 / 3, 39 / 198 / 2, 30 / 199 / 3, 9 / 200 / 2, 138 / 201 / 2, 148 / 202 / 3, 170 / 203 / 2, 10 / 204 / 2, 200 / 205 / 2, 161 / 206 / 7, 240 / 207 / 2, 27 / 208 / 2, 142 / 209 / 2, 201 / 210 / 2, 123 / 211 / 2, 37 / 212 / 2, 214 / 213 / 6, 26 / 214 / 2, 239 / 215 / 2, 94 / 216 / 2, 245 / 217 / 2, 69 / 218 / 3, 44 / 219 / 2, 103 / 220 / 3, 199 / 221 / 2, 192 / 222 / 2, 217 / 223 / 2, 211 / 224 / 4, 52 / 225 / 2, 20 / 226 / 2, 87 / 227 / 4, 149 / 228 / 2, 77 / 229 / 2, 121 / 230 / 2, 88 / 231 / 2, 108 / 232 / 2, 86 / 233 / 2, 249 / 234 / 2, 179 / 235 / 4, 210 / 236 / 2, 73 / 237 / 2, 41 / 238 / 2, 222 / 239 / 2, 3 / 240 / 2, 18 / 241 / 2, 64 / 242 / 3, 102 / 243 / 2, 70 / 244 / 3, 169 / 245 / 2, 213 / 246 / 3, 40 / 247 / 2, 120 / 248 / 2, 105 / 249 / 5
singlecenter-alpha_1-118-n250.txt, 1, 1, 250, 2200.86, 1964, 1714, 8, 249,187 / 1 / 3, 126 / 2 / 2, 136 / 3 / 3, 238 / 4 / 2, 101 / 5 / 2, 107 / 6 / 2, 26 / 7 / 3, 234 / 8 / 2, 39 / 9 / 2, 76 / 10 / 2, 235 / 11 / 2, 160 / 12 / 2, 214 / 13 / 3, 2 / 14 / 2, 18 / 15 / 2, 122 / 16 / 2, 88 / 17 / 2, 197 / 18 / 4, 233 / 19 / 2, 189 / 20 / 2, 68 / 21 / 3, 38 / 22 / 2, 175 / 23 / 3, 211 / 24 / 2, 186 / 25 / 2, 92 / 26 / 2, 114 / 27 / 3, 29 / 28 / 2, 12 / 29 / 2, 135 / 30 / 3, 62 / 31 / 2, 178 / 32 / 3, 115 / 33 / 2, 59 / 34 / 2, 48 / 35 / 5, 146 / 36 / 2, 117 / 37 / 3, 47 / 38 / 2, 249 / 39 / 2, 128 / 40 / 4, 32 / 41 / 2, 217 / 42 / 3, 10 / 43 / 2, 230 / 44 / 3, 82 / 45 / 2, 37 / 46 / 2, 157 / 47 / 2, 154 / 48 / 3, 98 / 49 / 2, 21 / 50 / 4, 86 / 51 / 2, 79 / 52 / 2, 54 / 53 / 3, 220 / 54 / 2, 57 / 55 / 3, 134 / 56 / 2, 242 / 57 / 2, 94 / 58 / 3, 83 / 59 / 2, 198 / 60 / 2, 93 / 61 / 2, 206 / 62 / 3, 71 / 63 / 2, 20 / 64 / 2, 213 / 65 / 2, 14 / 66 / 3, 228 / 67 / 2, 244 / 68 / 2, 113 / 69 / 3, 30 / 70 / 2, 221 / 71 / 2, 127 / 72 / 2, 109 / 73 / 2, 67 / 74 / 2, 95 / 75 / 3, 245 / 76 / 2, 219 / 77 / 6, 171 / 78 / 2, 248 / 79 / 2, 246 / 80 / 2, 176 / 81 / 2, 170 / 82 / 2, 106 / 83 / 2, 85 / 84 / 2, 156 / 85 / 3, 73 / 86 / 2, 7 / 87 / 3, 149 / 88 / 2, 108 / 89 / 2, 17 / 90 / 2, 125 / 91 / 2, 196 / 92 / 4, 185 / 93 / 2, 184 / 94 / 2, 63 / 95 / 3, 61 / 96 / 2, 11 / 97 / 2, 173 / 98 / 4, 172 / 99 / 2, 34 / 100 / 3, 182 / 101 / 2, 84 / 102 / 3, 66 / 103 / 2, 166 / 104 / 2, 226 / 105 / 2, 120 / 106 / 3, 209 / 107 / 2, 9 / 108 / 3, 36 / 109 / 2, 35 / 110 / 2, 40 / 111 / 4, 180 / 112 / 2, 102 / 113 / 3, 52 / 114 / 2, 168 / 115 / 3, 58 / 116 / 2, 121 / 117 / 3, 42 / 118 / 2, 232 / 119 / 2, 177 / 120 / 2, 151 / 121 / 2, 231 / 122 / 2, 224 / 123 / 2, 25 / 124 / 2, 167 / 125 / 2, 24 / 126 / 2, 200 / 127 / 2, 205 / 128 / 4, 81 / 129 / 2, 64 / 130 / 3, 70 / 131 / 2, 145 / 132 / 2, 181 / 133 / 4, 223 / 134 / 2, 111 / 135 / 2, 31 / 136 / 3, 6 / 137 / 2, 243 / 138 / 3, 23 / 139 / 2, 129 / 140 / 3, 216 / 141 / 2, 147 / 142 / 2, 96 / 143 / 2, 141 / 144 / 3, 53 / 145 / 2, 140 / 146 / 3, 222 / 147 / 2, 162 / 148 / 2, 60 / 149 / 2, 199 / 150 / 3, 144 / 151 / 2, 78 / 152 / 2, 28 / 153 / 2, 247 / 154 / 7, 229 / 155 / 2, 210 / 156 / 3, 56 / 157 / 2, 16 / 158 / 2, 118 / 159 / 2, 207 / 160 / 3, 179 / 161 / 2, 236 / 162 / 3, 188 / 163 / 2, 165 / 164 / 3, 87 / 165 / 2, 195 / 166 / 2, 191 / 167 / 2, 215 / 168 / 5, 183 / 169 / 2, 41 / 170 / 3, 164 / 171 / 2, 19 / 172 / 2, 3 / 173 / 4, 192 / 174 / 2, 27 / 175 / 3, 194 / 176 / 2, 202 / 177 / 3, 161 / 178 / 2, 90 / 179 / 3, 239 / 180 / 2, 225 / 181 / 4, 33 / 182 / 2, 203 / 183 / 2, 119 / 184 / 2, 150 / 185 / 2, 143 / 186 / 2, 5 / 187 / 4, 130 / 188 / 2, 13 / 189 / 2, 240 / 190 / 2, 139 / 191 / 2, 91 / 192 / 2, 8 / 193 / 3, 51 / 194 / 2, 104 / 195 / 2, 138 / 196 / 2, 45 / 197 / 2, 50 / 198 / 2, 4 / 199 / 2, 44 / 200 / 2, 105 / 201 / 2, 110 / 202 / 3, 218 / 203 / 2, 142 / 204 / 3, 74 / 205 / 2, 131 / 206 / 2, 75 / 207 / 2, 1 / 208 / 2, 193 / 209 / 3, 153 / 210 / 2, 208 / 211 / 3, 112 / 212 / 2, 133 / 213 / 2, 212 / 214 / 4, 159 / 215 / 2, 80 / 216 / 2, 237 / 217 / 3, 15 / 218 / 2, 97 / 219 / 3, 49 / 220 / 2, 22 / 221 / 2, 201 / 222 / 2, 124 / 223 / 2, 158 / 224 / 3, 204 / 225 / 2, 55 / 226 / 2, 152 / 227 / 2, 65 / 228 / 3, 77 / 229 / 2, 241 / 230 / 3, 103 / 231 / 2, 46 / 232 / 3, 69 / 233 / 2, 148 / 234 / 2, 227 / 235 / 3, 174 / 236 / 2, 155 / 237 / 3, 132 / 238 / 2, 43 / 239 / 2, 116 / 240 / 2, 72 / 241 / 7, 190 / 242 / 2, 137 / 243 / 2, 123 / 244 / 2, 89 / 245 / 3, 163 / 246 / 2, 99 / 247 / 2, 100 / 248 / 2, 169 / 249 / 8
singlecenter-alpha_1-119-n250.txt, 1, 1, 250, 2081.86, 2973, 2723, 24, 249,65 / 1 / 3, 129 / 2 / 2, 35 / 3 / 2, 48 / 4 / 2, 12 / 5 / 4, 51 / 6 / 2, 21 / 7 / 3, 16 / 8 / 2, 87 / 9 / 3, 82 / 10 / 2, 131 / 11 / 2, 179 / 12 / 2, 8 / 13 / 3, 5 / 14 / 2, 243 / 15 / 2, 134 / 16 / 2, 186 / 17 / 2, 14 / 18 / 2, 57 / 19 / 3, 149 / 20 / 2, 105 / 21 / 2, 157 / 22 / 2, 36 / 23 / 2, 164 / 24 / 3, 103 / 25 / 2, 189 / 26 / 3, 207 / 27 / 2, 184 / 28 / 3, 135 / 29 / 2, 206 / 30 / 3, 175 / 31 / 2, 193 / 32 / 2, 114 / 33 / 2, 110 / 34 / 2, 122 / 35 / 2, 211 / 36 / 2, 133 / 37 / 2, 55 / 38 / 3, 226 / 39 / 2, 229 / 40 / 4, 198 / 41 / 2, 128 / 42 / 2, 238 / 43 / 2, 83 / 44 / 2, 37 / 45 / 2, 28 / 46 / 3, 52 / 47 / 2, 140 / 48 / 3, 13 / 49 / 2, 62 / 50 / 3, 181 / 51 / 2, 64 / 52 / 2, 7 / 53 / 3, 74 / 54 / 2, 72 / 55 / 2, 106 / 56 / 2, 92 / 57 / 4, 26 / 58 / 2, 109 / 59 / 2, 156 / 60 / 2, 111 / 61 / 2, 218 / 62 / 2, 223 / 63 / 2, 214 / 64 / 4, 42 / 65 / 2, 147 / 66 / 2, 34 / 67 / 3, 56 / 68 / 2, 174 / 69 / 2, 19 / 70 / 2, 222 / 71 / 2, 150 / 72 / 2, 233 / 73 / 2, 169 / 74 / 3, 50 / 75 / 2, 242 / 76 / 3, 154 / 77 / 2, 145 / 78 / 2, 153 / 79 / 3, 6 / 80 / 2, 126 / 81 / 2, 120 / 82 / 3, 20 / 83 / 2, 11 / 84 / 3, 100 / 85 / 2, 212 / 86 / 2, 192 / 87 / 5, 66 / 88 / 2, 123 / 89 / 3, 77 / 90 / 2, 162 / 91 / 5, 41 / 92 / 2, 79 / 93 / 3, 161 / 94 / 2, 117 / 95 / 2, 127 / 96 / 3, 146 / 97 / 2, 177 / 98 / 2, 219 / 99 / 6, 215 / 100 / 2, 1 / 101 / 2, 178 / 102 / 2, 70 / 103 / 2, 241 / 104 / 2, 99 / 105 / 2, 191 / 106 / 2, 88 / 107 / 2, 33 / 108 / 2, 49 / 109 / 3, 204 / 110 / 2, 137 / 111 / 2, 67 / 112 / 3, 60 / 113 / 2, 76 / 114 / 2, 151 / 115 / 2, 165 / 116 / 15, 138 / 117 / 2, 152 / 118 / 2, 197 / 119 / 3, 29 / 120 / 2, 143 / 121 / 2, 159 / 122 / 2, 10 / 123 / 2, 91 / 124 / 4, 112 / 125 / 2, 54 / 126 / 3, 113 / 127 / 2, 124 / 128 / 3, 75 / 129 / 2, 84 / 130 / 3, 173 / 131 / 2, 46 / 132 / 2, 168 / 133 / 4, 108 / 134 / 2, 240 / 135 / 2, 93 / 136 / 2, 220 / 137 / 2, 180 / 138 / 2, 94 / 139 / 2, 201 / 140 / 3, 63 / 141 / 2, 188 / 142 / 3, 4 / 143 / 2, 247 / 144 / 2, 61 / 145 / 2, 232 / 146 / 3, 9 / 147 / 2, 144 / 148 / 2, 25 / 149 / 3, 231 / 150 / 2, 237 / 151 / 2, 39 / 152 / 2, 96 / 153 / 4, 160 / 154 / 2, 32 / 155 / 2, 234 / 156 / 2, 246 / 157 / 4, 44 / 158 / 2, 95 / 159 / 2, 196 / 160 / 3, 85 / 161 / 2, 203 / 162 / 3, 40 / 163 / 2, 213 / 164 / 2, 97 / 165 / 2, 194 / 166 / 2, 30 / 167 / 3, 190 / 168 / 2, 27 / 169 / 2, 68 / 170 / 2, 182 / 171 / 2, 244 / 172 / 2, 176 / 173 / 2, 107 / 174 / 2, 101 / 175 / 2, 86 / 176 / 2, 236 / 177 / 2, 119 / 178 / 2, 69 / 179 / 2, 141 / 180 / 2, 43 / 181 / 2, 89 / 182 / 3, 78 / 183 / 2, 121 / 184 / 24, 125 / 185 / 2, 17 / 186 / 2, 23 / 187 / 3, 45 / 188 / 2, 195 / 189 / 3, 2 / 190 / 2, 171 / 191 / 2, 53 / 192 / 3, 3 / 193 / 2, 132 / 194 / 3, 230 / 195 / 2, 227 / 196 / 2, 210 / 197 / 2, 155 / 198 / 2, 245 / 199 / 2, 116 / 200 / 2, 248 / 201 / 2, 228 / 202 / 3, 47 / 203 / 2, 71 / 204 / 3, 130 / 205 / 2, 235 / 206 / 2, 167 / 207 / 3, 73 / 208 / 2, 58 / 209 / 3, 172 / 210 / 2, 225 / 211 / 2, 38 / 212 / 2, 136 / 213 / 2, 217 / 214 / 3, 216 / 215 / 2, 249 / 216 / 2, 200 / 217 / 2, 115 / 218 / 3, 199 / 219 / 2, 22 / 220 / 2, 183 / 221 / 3, 104 / 222 / 2, 59 / 223 / 3, 202 / 224 / 2, 208 / 225 / 2, 139 / 226 / 2, 170 / 227 / 2, 166 / 228 / 3, 118 / 229 / 2, 224 / 230 / 2, 185 / 231 / 2, 24 / 232 / 2, 102 / 233 / 3, 158 / 234 / 2, 80 / 235 / 2, 205 / 236 / 2, 81 / 237 / 3, 148 / 238 / 2, 31 / 239 / 2, 221 / 240 / 2, 142 / 241 / 4, 98 / 242 / 2, 239 / 243 / 2, 209 / 244 / 2, 18 / 245 / 2, 15 / 246 / 2, 90 / 247 / 2, 187 / 248 / 3, 163 / 249 / 2
singlecenter-alpha_1-12-n375.txt, 1, 1, 375, 2754.9, 2949, 2574, 10, 374,113 / 1 / 2, 316 / 2 / 3, 249 / 3 / 2, 233 / 4 / 2, 32 / 5 / 2, 94 / 6 / 3, 31 / 7 / 2, 22 / 8 / 2, 336 / 9 / 2, 368 / 10 / 3, 246 / 11 / 2, 173 / 12 / 3, 82 / 13 / 2, 199 / 14 / 4, 195 / 15 / 2, 36 / 16 / 2, 251 / 17 / 2, 104 / 18 / 2, 71 / 19 / 2, 272 / 20 / 3, 37 / 21 / 2, 211 / 22 / 2, 228 / 23 / 3, 289 / 24 / 2, 53 / 25 / 2, 17 / 26 / 4, 364 / 27 / 2, 58 / 28 / 2, 74 / 29 / 2, 293 / 30 / 2, 116 / 31 / 2, 171 / 32 / 2, 28 / 33 / 2, 256 / 34 / 2, 209 / 35 / 2, 106 / 36 / 2, 230 / 37 / 3, 34 / 38 / 2, 261 / 39 / 2, 7 / 40 / 3, 282 / 41 / 2, 217 / 42 / 2, 103 / 43 / 5, 252 / 44 / 2, 96 / 45 / 2, 62 / 46 / 2, 143 / 47 / 5, 334 / 48 / 2, 366 / 49 / 2, 262 / 50 / 2, 112 / 51 / 3, 285 / 52 / 2, 324 / 53 / 4, 145 / 54 / 2, 185 / 55 / 2, 345 / 56 / 2, 328 / 57 / 2, 146 / 58 / 2, 184 / 59 / 2, 152 / 60 / 2, 215 / 61 / 3, 273 / 62 / 2, 83 / 63 / 2, 287 / 64 / 3, 227 / 65 / 2, 123 / 66 / 2, 166 / 67 / 2, 254 / 68 / 2, 142 / 69 / 3, 153 / 70 / 2, 98 / 71 / 2, 277 / 72 / 3, 164 / 73 / 2, 158 / 74 / 3, 61 / 75 / 2, 55 / 76 / 3, 268 / 77 / 2, 351 / 78 / 2, 263 / 79 / 2, 206 / 80 / 2, 330 / 81 / 2, 30 / 82 / 2, 108 / 83 / 5, 358 / 84 / 2, 25 / 85 / 2, 242 / 86 / 2, 15 / 87 / 2, 101 / 88 / 2, 95 / 89 / 2, 315 / 90 / 2, 309 / 91 / 2, 139 / 92 / 2, 44 / 93 / 2, 86 / 94 / 2, 240 / 95 / 2, 121 / 96 / 2, 333 / 97 / 2, 239 / 98 / 2, 93 / 99 / 2, 135 / 100 / 2, 90 / 101 / 2, 56 / 102 / 2, 42 / 103 / 2, 161 / 104 / 2, 175 / 105 / 2, 47 / 106 / 4, 172 / 107 / 2, 319 / 108 / 2, 245 / 109 / 2, 125 / 110 / 2, 275 / 111 / 2, 210 / 112 / 2, 269 / 113 / 3, 169 / 114 / 2, 73 / 115 / 2, 357 / 116 / 2, 4 / 117 / 3, 280 / 118 / 2, 353 / 119 / 2, 288 / 120 / 2, 322 / 121 / 3, 23 / 122 / 2, 11 / 123 / 3, 156 / 124 / 2, 119 / 125 / 3, 136 / 126 / 2, 365 / 127 / 3, 105 / 128 / 2, 257 / 129 / 5, 201 / 130 / 2, 335 / 131 / 2, 332 / 132 / 2, 92 / 133 / 2, 81 / 134 / 2, 307 / 135 / 2, 41 / 136 / 2, 207 / 137 / 2, 331 / 138 / 2, 126 / 139 / 2, 117 / 140 / 2, 222 / 141 / 4, 294 / 142 / 2, 39 / 143 / 3, 46 / 144 / 2, 170 / 145 / 2, 51 / 146 / 4, 308 / 147 / 2, 229 / 148 / 2, 323 / 149 / 3, 369 / 150 / 2, 370 / 151 / 2, 347 / 152 / 2, 236 / 153 / 5, 213 / 154 / 2, 144 / 155 / 2, 68 / 156 / 3, 219 / 157 / 2, 163 / 158 / 2, 19 / 159 / 2, 188 / 160 / 3, 362 / 161 / 2, 301 / 162 / 4, 179 / 163 / 2, 338 / 164 / 2, 354 / 165 / 4, 284 / 166 / 2, 148 / 167 / 2, 225 / 168 / 3, 193 / 169 / 2, 187 / 170 / 3, 80 / 171 / 2, 18 / 172 / 3, 237 / 173 / 2, 157 / 174 / 3, 190 / 175 / 2, 342 / 176 / 3, 340 / 177 / 2, 107 / 178 / 2, 178 / 179 / 3, 141 / 180 / 2, 250 / 181 / 6, 9 / 182 / 2, 67 / 183 / 2, 122 / 184 / 2, 65 / 185 / 2, 348 / 186 / 2, 120 / 187 / 2, 320 / 188 / 3, 79 / 189 / 2, 196 / 190 / 3, 205 / 191 / 2, 6 / 192 / 4, 291 / 193 / 2, 38 / 194 / 2, 33 / 195 / 4, 304 / 196 / 2, 192 / 197 / 2, 129 / 198 / 2, 326 / 199 / 3, 344 / 200 / 2, 3 / 201 / 5, 221 / 202 / 2, 360 / 203 / 2, 297 / 204 / 2, 50 / 205 / 2, 111 / 206 / 2, 27 / 207 / 4, 59 / 208 / 2, 258 / 209 / 3, 118 / 210 / 2, 266 / 211 / 2, 232 / 212 / 3, 88 / 213 / 2, 43 / 214 / 3, 165 / 215 / 2, 265 / 216 / 3, 374 / 217 / 2, 70 / 218 / 3, 60 / 219 / 2, 298 / 220 / 2, 260 / 221 / 2, 314 / 222 / 2, 182 / 223 / 2, 355 / 224 / 2, 367 / 225 / 6, 5 / 226 / 2, 274 / 227 / 2, 84 / 228 / 3, 290 / 229 / 2, 283 / 230 / 2, 296 / 231 / 2, 155 / 232 / 3, 329 / 233 / 2, 281 / 234 / 2, 132 / 235 / 2, 255 / 236 / 2, 371 / 237 / 2, 253 / 238 / 2, 180 / 239 / 3, 12 / 240 / 2, 373 / 241 / 2, 243 / 242 / 2, 198 / 243 / 2, 302 / 244 / 4, 247 / 245 / 2, 87 / 246 / 2, 264 / 247 / 3, 76 / 248 / 2, 292 / 249 / 2, 372 / 250 / 2, 270 / 251 / 3, 231 / 252 / 2, 2 / 253 / 3, 321 / 254 / 2, 191 / 255 / 3, 63 / 256 / 2, 110 / 257 / 3, 151 / 258 / 2, 208 / 259 / 2, 162 / 260 / 3, 181 / 261 / 2, 134 / 262 / 3, 20 / 263 / 2, 204 / 264 / 2, 102 / 265 / 2, 149 / 266 / 2, 99 / 267 / 2, 89 / 268 / 2, 183 / 269 / 10, 174 / 270 / 2, 177 / 271 / 2, 299 / 272 / 2, 66 / 273 / 4, 248 / 274 / 2, 8 / 275 / 2, 40 / 276 / 2, 361 / 277 / 2, 224 / 278 / 3, 45 / 279 / 2, 168 / 280 / 3, 337 / 281 / 2, 52 / 282 / 2, 305 / 283 / 2, 16 / 284 / 2, 85 / 285 / 2, 216 / 286 / 3, 48 / 287 / 2, 154 / 288 / 2, 218 / 289 / 3, 241 / 290 / 2, 167 / 291 / 2, 235 / 292 / 2, 202 / 293 / 4, 160 / 294 / 2, 109 / 295 / 3, 318 / 296 / 2, 312 / 297 / 3, 97 / 298 / 2, 49 / 299 / 3, 100 / 300 / 2, 267 / 301 / 2, 339 / 302 / 2, 176 / 303 / 2, 279 / 304 / 2, 341 / 305 / 2, 234 / 306 / 2, 127 / 307 / 3, 77 / 308 / 2, 189 / 309 / 2, 303 / 310 / 3, 346 / 311 / 2, 186 / 312 / 3, 278 / 313 / 2, 343 / 314 / 3, 325 / 315 / 2, 64 / 316 / 2, 286 / 317 / 2, 159 / 318 / 2, 13 / 319 / 4, 14 / 320 / 2, 203 / 321 / 2, 29 / 322 / 2, 24 / 323 / 2, 137 / 324 / 2, 147 / 325 / 2, 359 / 326 / 2, 352 / 327 / 2, 21 / 328 / 2, 150 / 329 / 3, 194 / 330 / 2, 212 / 331 / 2, 327 / 332 / 3, 57 / 333 / 2, 295 / 334 / 3, 133 / 335 / 2, 91 / 336 / 3, 140 / 337 / 2, 75 / 338 / 6, 226 / 339 / 2, 317 / 340 / 2, 313 / 341 / 3, 276 / 342 / 2, 349 / 343 / 3, 223 / 344 / 2, 271 / 345 / 3, 115 / 346 / 2, 306 / 347 / 2, 259 / 348 / 3, 54 / 349 / 2, 363 / 350 / 2, 128 / 351 / 2, 114 / 352 / 2, 138 / 353 / 2, 311 / 354 / 2, 356 / 355 / 2, 131 / 356 / 2, 72 / 357 / 2, 35 / 358 / 3, 200 / 359 / 2, 214 / 360 / 2, 78 / 361 / 2, 197 / 362 / 2, 26 / 363 / 2, 69 / 364 / 3, 124 / 365 / 2, 300 / 366 / 2, 350 / 367 / 2, 310 / 368 / 2, 10 / 369 / 3, 238 / 370 / 2, 1 / 371 / 2, 244 / 372 / 5, 220 / 373 / 2, 130 / 374 / 3
singlecenter-alpha_1-12-n500.txt, 1, 1, 500, 3481.04, 3836, 3336, 8, 499,179 / 1 / 3, 415 / 2 / 2, 25 / 3 / 2, 238 / 4 / 4, 422 / 5 / 2, 102 / 6 / 2, 61 / 7 / 3, 175 / 8 / 2, 131 / 9 / 3, 306 / 10 / 2, 401 / 11 / 2, 446 / 12 / 2, 360 / 13 / 2, 463 / 14 / 2, 468 / 15 / 2, 168 / 16 / 2, 172 / 17 / 2, 497 / 18 / 3, 483 / 19 / 2, 291 / 20 / 3, 322 / 21 / 2, 185 / 22 / 2, 451 / 23 / 3, 338 / 24 / 2, 155 / 25 / 3, 342 / 26 / 2, 26 / 27 / 2, 467 / 28 / 2, 198 / 29 / 3, 404 / 30 / 2, 101 / 31 / 4, 245 / 32 / 2, 85 / 33 / 2, 328 / 34 / 2, 458 / 35 / 2, 251 / 36 / 3, 140 / 37 / 2, 66 / 38 / 5, 308 / 39 / 2, 313 / 40 / 3, 269 / 41 / 2, 489 / 42 / 4, 333 / 43 / 2, 174 / 44 / 2, 391 / 45 / 4, 183 / 46 / 2, 495 / 47 / 2, 344 / 48 / 2, 28 / 49 / 2, 137 / 50 / 3, 437 / 51 / 2, 208 / 52 / 2, 43 / 53 / 2, 75 / 54 / 2, 263 / 55 / 4, 321 / 56 / 2, 377 / 57 / 3, 145 / 58 / 2, 240 / 59 / 2, 130 / 60 / 2, 273 / 61 / 5, 178 / 62 / 2, 14 / 63 / 2, 358 / 64 / 3, 398 / 65 / 2, 233 / 66 / 2, 166 / 67 / 2, 15 / 68 / 3, 121 / 69 / 2, 286 / 70 / 2, 139 / 71 / 2, 107 / 72 / 4, 290 / 73 / 2, 302 / 74 / 2, 421 / 75 / 3, 414 / 76 / 2, 158 / 77 / 2, 456 / 78 / 2, 24 / 79 / 2, 242 / 80 / 2, 387 / 81 / 2, 95 / 82 / 2, 392 / 83 / 2, 74 / 84 / 2, 277 / 85 / 2, 450 / 86 / 5, 317 / 87 / 2, 97 / 88 / 2, 465 / 89 / 4, 173 / 90 / 2, 307 / 91 / 2, 193 / 92 / 2, 46 / 93 / 3, 149 / 94 / 2, 461 / 95 / 3, 67 / 96 / 2, 222 / 97 / 3, 355 / 98 / 2, 480 / 99 / 2, 469 / 100 / 3, 62 / 101 / 2, 323 / 102 / 2, 356 / 103 / 2, 491 / 104 / 2, 436 / 105 / 3, 370 / 106 / 2, 124 / 107 / 2, 57 / 108 / 2, 58 / 109 / 2, 207 / 110 / 4, 380 / 111 / 2, 31 / 112 / 2, 59 / 113 / 2, 122 / 114 / 2, 210 / 115 / 2, 259 / 116 / 2, 4 / 117 / 2, 448 / 118 / 2, 364 / 119 / 2, 73 / 120 / 2, 462 / 121 / 3, 200 / 122 / 2, 274 / 123 / 2, 287 / 124 / 3, 416 / 125 / 2, 326 / 126 / 2, 7 / 127 / 3, 87 / 128 / 2, 111 / 129 / 2, 52 / 130 / 2, 199 / 131 / 2, 69 / 132 / 2, 336 / 133 / 2, 189 / 134 / 2, 474 / 135 / 2, 50 / 136 / 2, 195 / 137 / 2, 499 / 138 / 2, 123 / 139 / 3, 352 / 140 / 2, 498 / 141 / 3, 432 / 142 / 2, 281 / 143 / 3, 53 / 144 / 2, 298 / 145 / 3, 318 / 146 / 2, 79 / 147 / 3, 148 / 148 / 2, 457 / 149 / 2, 232 / 150 / 3, 33 / 151 / 2, 204 / 152 / 3, 86 / 153 / 2, 494 / 154 / 3, 16 / 155 / 2, 38 / 156 / 3, 343 / 157 / 2, 379 / 158 / 2, 484 / 159 / 3, 487 / 160 / 2, 470 / 161 / 4, 434 / 162 / 2, 279 / 163 / 3, 346 / 164 / 2, 112 / 165 / 2, 440 / 166 / 2, 471 / 167 / 2, 170 / 168 / 2, 276 / 169 / 2, 280 / 170 / 3, 64 / 171 / 2, 115 / 172 / 3, 169 / 173 / 2, 337 / 174 / 2, 109 / 175 / 3, 45 / 176 / 2, 37 / 177 / 3, 324 / 178 / 2, 396 / 179 / 3, 203 / 180 / 2, 299 / 181 / 3, 77 / 182 / 2, 485 / 183 / 3, 357 / 184 / 2, 96 / 185 / 2, 78 / 186 / 3, 152 / 187 / 2, 227 / 188 / 2, 381 / 189 / 3, 117 / 190 / 2, 125 / 191 / 2, 192 / 192 / 2, 258 / 193 / 2, 253 / 194 / 3, 231 / 195 / 2, 133 / 196 / 2, 36 / 197 / 2, 132 / 198 / 3, 383 / 199 / 2, 18 / 200 / 2, 250 / 201 / 2, 472 / 202 / 2, 171 / 203 / 2, 252 / 204 / 2, 284 / 205 / 2, 215 / 206 / 2, 339 / 207 / 2, 397 / 208 / 2, 335 / 209 / 2, 331 / 210 / 2, 29 / 211 / 2, 49 / 212 / 3, 319 / 213 / 2, 234 / 214 / 5, 229 / 215 / 2, 142 / 216 / 2, 363 / 217 / 3, 153 / 218 / 2, 216 / 219 / 2, 218 / 220 / 4, 150 / 221 / 2, 271 / 222 / 2, 368 / 223 / 4, 249 / 224 / 2, 5 / 225 / 2, 427 / 226 / 4, 51 / 227 / 2, 256 / 228 / 2, 119 / 229 / 2, 39 / 230 / 3, 390 / 231 / 2, 196 / 232 / 2, 479 / 233 / 2, 223 / 234 / 3, 113 / 235 / 2, 156 / 236 / 2, 262 / 237 / 3, 378 / 238 / 2, 341 / 239 / 3, 375 / 240 / 2, 410 / 241 / 2, 194 / 242 / 2, 214 / 243 / 4, 205 / 244 / 2, 351 / 245 / 3, 372 / 246 / 2, 92 / 247 / 3, 88 / 248 / 2, 219 / 249 / 3, 452 / 250 / 2, 406 / 251 / 3, 40 / 252 / 2, 230 / 253 / 3, 257 / 254 / 2, 181 / 255 / 3, 475 / 256 / 2, 476 / 257 / 2, 99 / 258 / 2, 359 / 259 / 5, 81 / 260 / 2, 237 / 261 / 2, 473 / 262 / 2, 329 / 263 / 3, 68 / 264 / 2, 146 / 265 / 2, 11 / 266 / 4, 76 / 267 / 2, 393 / 268 / 2, 296 / 269 / 4, 60 / 270 / 2, 444 / 271 / 2, 135 / 272 / 2, 10 / 273 / 2, 261 / 274 / 2, 433 / 275 / 2, 228 / 276 / 2, 182 / 277 / 2, 151 / 278 / 3, 134 / 279 / 2, 413 / 280 / 3, 315 / 281 / 2, 103 / 282 / 2, 71 / 283 / 2, 118 / 284 / 5, 275 / 285 / 2, 184 / 286 / 2, 442 / 287 / 2, 426 / 288 / 5, 412 / 289 / 2, 143 / 290 / 2, 492 / 291 / 2, 266 / 292 / 2, 345 / 293 / 2, 160 / 294 / 2, 83 / 295 / 3, 254 / 296 / 2, 488 / 297 / 2, 165 / 298 / 3, 6 / 299 / 2, 443 / 300 / 2, 310 / 301 / 4, 316 / 302 / 2, 47 / 303 / 2, 305 / 304 / 3, 21 / 305 / 2, 209 / 306 / 2, 221 / 307 / 2, 27 / 308 / 2, 264 / 309 / 3, 247 / 310 / 2, 128 / 311 / 2, 144 / 312 / 3, 394 / 313 / 2, 431 / 314 / 3, 105 / 315 / 2, 300 / 316 / 2, 224 / 317 / 3, 369 / 318 / 2, 20 / 319 / 3, 55 / 320 / 2, 477 / 321 / 2, 327 / 322 / 3, 226 / 323 / 2, 418 / 324 / 2, 490 / 325 / 2, 110 / 326 / 3, 430 / 327 / 2, 187 / 328 / 2, 167 / 329 / 2, 84 / 330 / 3, 89 / 331 / 2, 270 / 332 / 3, 285 / 333 / 2, 268 / 334 / 2, 303 / 335 / 2, 3 / 336 / 2, 371 / 337 / 3, 278 / 338 / 2, 382 / 339 / 3, 496 / 340 / 2, 80 / 341 / 2, 35 / 342 / 2, 366 / 343 / 2, 373 / 344 / 3, 94 / 345 / 2, 292 / 346 / 4, 385 / 347 / 2, 120 / 348 / 2, 241 / 349 / 2, 425 / 350 / 5, 294 / 351 / 2, 399 / 352 / 2, 297 / 353 / 2, 365 / 354 / 2, 201 / 355 / 2, 419 / 356 / 2, 386 / 357 / 2, 91 / 358 / 3, 478 / 359 / 2, 212 / 360 / 2, 411 / 361 / 2, 32 / 362 / 5, 384 / 363 / 2, 361 / 364 / 3, 301 / 365 / 2, 23 / 366 / 2, 82 / 367 / 2, 197 / 368 / 2, 417 / 369 / 2, 30 / 370 / 3, 453 / 371 / 2, 248 / 372 / 3, 282 / 373 / 2, 129 / 374 / 2, 188 / 375 / 2, 157 / 376 / 6, 350 / 377 / 2, 220 / 378 / 3, 70 / 379 / 2, 98 / 380 / 2, 309 / 381 / 2, 244 / 382 / 3, 260 / 383 / 2, 347 / 384 / 4, 106 / 385 / 2, 420 / 386 / 2, 349 / 387 / 2, 108 / 388 / 2, 334 / 389 / 3, 239 / 390 / 2, 428 / 391 / 2, 213 / 392 / 2, 454 / 393 / 2, 295 / 394 / 2, 374 / 395 / 3, 44 / 396 / 2, 388 / 397 / 2, 22 / 398 / 2, 100 / 399 / 2, 161 / 400 / 3, 405 / 401 / 2, 164 / 402 / 3, 114 / 403 / 2, 63 / 404 / 2, 235 / 405 / 3, 447 / 406 / 2, 48 / 407 / 5, 206 / 408 / 2, 367 / 409 / 3, 162 / 410 / 2, 34 / 411 / 3, 464 / 412 / 2, 330 / 413 / 3, 127 / 414 / 2, 376 / 415 / 2, 265 / 416 / 4, 202 / 417 / 2, 159 / 418 / 2, 493 / 419 / 3, 126 / 420 / 2, 424 / 421 / 2, 423 / 422 / 3, 289 / 423 / 2, 180 / 424 / 2, 435 / 425 / 2, 445 / 426 / 2, 354 / 427 / 2, 400 / 428 / 2, 455 / 429 / 5, 403 / 430 / 2, 65 / 431 / 2, 19 / 432 / 2, 482 / 433 / 2, 320 / 434 / 2, 429 / 435 / 3, 348 / 436 / 2, 191 / 437 / 2, 93 / 438 / 2, 481 / 439 / 3, 116 / 440 / 2, 409 / 441 / 2, 362 / 442 / 3, 283 / 443 / 2, 441 / 444 / 3, 163 / 445 / 2, 190 / 446 / 2, 449 / 447 / 4, 141 / 448 / 2, 288 / 449 / 2, 9 / 450 / 2, 389 / 451 / 5, 459 / 452 / 2, 460 / 453 / 2, 13 / 454 / 3, 246 / 455 / 2, 407 / 456 / 3, 186 / 457 / 2, 154 / 458 / 3, 2 / 459 / 2, 104 / 460 / 2, 138 / 461 / 3, 353 / 462 / 2, 211 / 463 / 2, 325 / 464 / 3, 8 / 465 / 2, 312 / 466 / 4, 243 / 467 / 2, 90 / 468 / 2, 314 / 469 / 2, 176 / 470 / 3, 54 / 471 / 2, 41 / 472 / 2, 486 / 473 / 4, 56 / 474 / 2, 332 / 475 / 2, 402 / 476 / 6, 225 / 477 / 2, 395 / 478 / 3, 304 / 479 / 2, 147 / 480 / 2, 1 / 481 / 2, 177 / 482 / 3, 340 / 483 / 2, 217 / 484 / 2, 293 / 485 / 2, 255 / 486 / 3, 272 / 487 / 2, 466 / 488 / 2, 267 / 489 / 3, 17 / 490 / 2, 236 / 491 / 8, 408 / 492 / 2, 438 / 493 / 2, 136 / 494 / 2, 72 / 495 / 2, 439 / 496 / 3, 311 / 497 / 2, 12 / 498 / 2, 42 / 499 / 4
singlecenter-alpha_1-12-n6.txt, 1, 1, 6, 254.028, 27, 21, 6, 5,5 / 1 / 4, 2 / 2 / 2, 1 / 3 / 2, 4 / 4 / 6, 3 / 5 / 2
singlecenter-alpha_1-120-n250.txt, 1, 1, 250, 2115.12, 1800, 1550, 6, 249,87 / 1 / 5, 121 / 2 / 2, 142 / 3 / 3, 202 / 4 / 2, 191 / 5 / 3, 74 / 6 / 2, 152 / 7 / 2, 153 / 8 / 2, 30 / 9 / 2, 231 / 10 / 2, 185 / 11 / 2, 20 / 12 / 2, 224 / 13 / 6, 26 / 14 / 2, 3 / 15 / 2, 242 / 16 / 3, 134 / 17 / 2, 79 / 18 / 3, 78 / 19 / 2, 18 / 20 / 3, 120 / 21 / 2, 54 / 22 / 2, 100 / 23 / 2, 201 / 24 / 2, 15 / 25 / 4, 162 / 26 / 2, 186 / 27 / 2, 105 / 28 / 2, 137 / 29 / 2, 241 / 30 / 2, 68 / 31 / 3, 61 / 32 / 2, 69 / 33 / 4, 31 / 34 / 2, 172 / 35 / 3, 174 / 36 / 2, 189 / 37 / 2, 53 / 38 / 3, 43 / 39 / 2, 38 / 40 / 2, 109 / 41 / 5, 173 / 42 / 2, 158 / 43 / 2, 127 / 44 / 2, 178 / 45 / 2, 248 / 46 / 3, 32 / 47 / 2, 146 / 48 / 2, 131 / 49 / 2, 106 / 50 / 2, 194 / 51 / 3, 45 / 52 / 2, 206 / 53 / 3, 46 / 54 / 2, 217 / 55 / 2, 107 / 56 / 2, 34 / 57 / 3, 117 / 58 / 2, 132 / 59 / 2, 151 / 60 / 2, 102 / 61 / 3, 19 / 62 / 2, 244 / 63 / 2, 230 / 64 / 2, 115 / 65 / 2, 179 / 66 / 3, 238 / 67 / 2, 17 / 68 / 3, 157 / 69 / 2, 130 / 70 / 3, 192 / 71 / 2, 176 / 72 / 2, 187 / 73 / 2, 14 / 74 / 2, 29 / 75 / 4, 98 / 76 / 2, 145 / 77 / 2, 232 / 78 / 4, 77 / 79 / 2, 13 / 80 / 2, 101 / 81 / 2, 236 / 82 / 4, 199 / 83 / 2, 21 / 84 / 2, 196 / 85 / 2, 214 / 86 / 4, 125 / 87 / 2, 240 / 88 / 3, 103 / 89 / 2, 136 / 90 / 2, 245 / 91 / 4, 221 / 92 / 2, 156 / 93 / 2, 24 / 94 / 2, 227 / 95 / 3, 190 / 96 / 2, 10 / 97 / 4, 184 / 98 / 2, 222 / 99 / 2, 116 / 100 / 2, 44 / 101 / 2, 167 / 102 / 3, 97 / 103 / 2, 91 / 104 / 2, 28 / 105 / 2, 60 / 106 / 6, 86 / 107 / 2, 12 / 108 / 2, 93 / 109 / 2, 7 / 110 / 2, 52 / 111 / 3, 229 / 112 / 2, 200 / 113 / 2, 155 / 114 / 3, 11 / 115 / 2, 81 / 116 / 2, 66 / 117 / 3, 63 / 118 / 2, 40 / 119 / 2, 228 / 120 / 2, 88 / 121 / 4, 112 / 122 / 2, 56 / 123 / 2, 49 / 124 / 4, 171 / 125 / 2, 198 / 126 / 2, 96 / 127 / 3, 208 / 128 / 2, 223 / 129 / 3, 210 / 130 / 2, 216 / 131 / 2, 226 / 132 / 2, 57 / 133 / 2, 35 / 134 / 2, 209 / 135 / 2, 160 / 136 / 3, 84 / 137 / 2, 70 / 138 / 2, 233 / 139 / 3, 4 / 140 / 2, 90 / 141 / 3, 144 / 142 / 2, 166 / 143 / 2, 239 / 144 / 3, 99 / 145 / 2, 71 / 146 / 2, 235 / 147 / 3, 76 / 148 / 2, 168 / 149 / 2, 246 / 150 / 2, 114 / 151 / 2, 148 / 152 / 2, 220 / 153 / 4, 89 / 154 / 2, 94 / 155 / 2, 138 / 156 / 2, 180 / 157 / 3, 59 / 158 / 2, 225 / 159 / 3, 2 / 160 / 2, 67 / 161 / 2, 83 / 162 / 3, 27 / 163 / 2, 110 / 164 / 2, 164 / 165 / 3, 23 / 166 / 2, 234 / 167 / 2, 95 / 168 / 2, 123 / 169 / 3, 215 / 170 / 2, 9 / 171 / 3, 175 / 172 / 2, 37 / 173 / 2, 16 / 174 / 3, 133 / 175 / 2, 85 / 176 / 3, 181 / 177 / 2, 249 / 178 / 3, 211 / 179 / 2, 122 / 180 / 2, 50 / 181 / 3, 62 / 182 / 2, 204 / 183 / 3, 111 / 184 / 2, 8 / 185 / 2, 183 / 186 / 2, 237 / 187 / 3, 108 / 188 / 2, 213 / 189 / 2, 169 / 190 / 2, 140 / 191 / 2, 41 / 192 / 2, 177 / 193 / 2, 33 / 194 / 2, 39 / 195 / 2, 65 / 196 / 2, 218 / 197 / 2, 150 / 198 / 3, 159 / 199 / 2, 118 / 200 / 3, 243 / 201 / 2, 1 / 202 / 3, 128 / 203 / 2, 193 / 204 / 2, 72 / 205 / 4, 47 / 206 / 2, 207 / 207 / 2, 36 / 208 / 2, 139 / 209 / 4, 147 / 210 / 2, 247 / 211 / 2, 58 / 212 / 2, 75 / 213 / 3, 113 / 214 / 2, 161 / 215 / 2, 124 / 216 / 2, 22 / 217 / 4, 165 / 218 / 2, 48 / 219 / 2, 212 / 220 / 3, 170 / 221 / 2, 92 / 222 / 3, 163 / 223 / 2, 5 / 224 / 2, 55 / 225 / 3, 188 / 226 / 2, 80 / 227 / 4, 135 / 228 / 2, 82 / 229 / 2, 6 / 230 / 2, 195 / 231 / 3, 119 / 232 / 2, 104 / 233 / 2, 197 / 234 / 2, 129 / 235 / 2, 51 / 236 / 3, 64 / 237 / 2, 219 / 238 / 2, 73 / 239 / 2, 205 / 240 / 2, 42 / 241 / 2, 25 / 242 / 3, 143 / 243 / 2, 182 / 244 / 2, 141 / 245 / 2, 203 / 246 / 3, 126 / 247 / 2, 154 / 248 / 4, 149 / 249 / 2
singlecenter-alpha_1-13-n375.txt, 1, 1, 375, 2656.35, 2746, 2371, 7, 374,179 / 1 / 4, 210 / 2 / 2, 354 / 3 / 2, 123 / 4 / 4, 37 / 5 / 2, 25 / 6 / 2, 145 / 7 / 3, 13 / 8 / 2, 246 / 9 / 3, 258 / 10 / 2, 111 / 11 / 3, 372 / 12 / 2, 201 / 13 / 4, 339 / 14 / 2, 86 / 15 / 2, 254 / 16 / 2, 122 / 17 / 2, 105 / 18 / 3, 222 / 19 / 2, 234 / 20 / 3, 208 / 21 / 2, 291 / 22 / 3, 160 / 23 / 2, 260 / 24 / 2, 289 / 25 / 2, 53 / 26 / 2, 118 / 27 / 2, 148 / 28 / 2, 332 / 29 / 2, 309 / 30 / 2, 362 / 31 / 4, 138 / 32 / 2, 129 / 33 / 2, 325 / 34 / 5, 345 / 35 / 2, 192 / 36 / 2, 82 / 37 / 3, 143 / 38 / 2, 293 / 39 / 2, 226 / 40 / 3, 219 / 41 / 2, 134 / 42 / 2, 5 / 43 / 3, 285 / 44 / 2, 30 / 45 / 2, 108 / 46 / 3, 181 / 47 / 2, 232 / 48 / 2, 352 / 49 / 2, 88 / 50 / 3, 189 / 51 / 2, 176 / 52 / 3, 33 / 53 / 2, 151 / 54 / 2, 117 / 55 / 3, 261 / 56 / 2, 268 / 57 / 3, 195 / 58 / 2, 184 / 59 / 3, 272 / 60 / 2, 301 / 61 / 2, 74 / 62 / 2, 97 / 63 / 4, 67 / 64 / 2, 65 / 65 / 2, 121 / 66 / 2, 99 / 67 / 2, 56 / 68 / 4, 190 / 69 / 2, 85 / 70 / 2, 355 / 71 / 2, 251 / 72 / 2, 367 / 73 / 2, 141 / 74 / 2, 347 / 75 / 2, 87 / 76 / 2, 169 / 77 / 3, 324 / 78 / 2, 228 / 79 / 2, 162 / 80 / 2, 248 / 81 / 2, 209 / 82 / 2, 241 / 83 / 2, 40 / 84 / 2, 369 / 85 / 4, 58 / 86 / 2, 31 / 87 / 2, 280 / 88 / 3, 366 / 89 / 2, 341 / 90 / 3, 69 / 91 / 2, 110 / 92 / 3, 116 / 93 / 2, 77 / 94 / 2, 6 / 95 / 2, 199 / 96 / 2, 318 / 97 / 2, 112 / 98 / 3, 194 / 99 / 2, 161 / 100 / 2, 153 / 101 / 2, 125 / 102 / 2, 257 / 103 / 2, 175 / 104 / 2, 21 / 105 / 4, 66 / 106 / 2, 230 / 107 / 2, 344 / 108 / 4, 120 / 109 / 2, 227 / 110 / 2, 311 / 111 / 4, 32 / 112 / 2, 101 / 113 / 2, 238 / 114 / 2, 299 / 115 / 2, 249 / 116 / 2, 73 / 117 / 3, 71 / 118 / 2, 327 / 119 / 3, 236 / 120 / 2, 340 / 121 / 3, 93 / 122 / 2, 170 / 123 / 3, 166 / 124 / 2, 371 / 125 / 2, 323 / 126 / 2, 49 / 127 / 2, 305 / 128 / 3, 316 / 129 / 2, 183 / 130 / 2, 204 / 131 / 2, 370 / 132 / 3, 158 / 133 / 2, 127 / 134 / 3, 229 / 135 / 2, 334 / 136 / 2, 326 / 137 / 3, 36 / 138 / 2, 276 / 139 / 5, 282 / 140 / 2, 139 / 141 / 2, 231 / 142 / 3, 287 / 143 / 2, 250 / 144 / 2, 124 / 145 / 4, 106 / 146 / 2, 279 / 147 / 3, 223 / 148 / 2, 48 / 149 / 5, 187 / 150 / 2, 207 / 151 / 2, 178 / 152 / 2, 47 / 153 / 2, 211 / 154 / 2, 35 / 155 / 2, 22 / 156 / 5, 307 / 157 / 2, 64 / 158 / 2, 3 / 159 / 2, 356 / 160 / 4, 98 / 161 / 2, 314 / 162 / 2, 96 / 163 / 4, 113 / 164 / 2, 203 / 165 / 2, 11 / 166 / 3, 114 / 167 / 2, 336 / 168 / 3, 346 / 169 / 2, 91 / 170 / 2, 218 / 171 / 3, 79 / 172 / 2, 16 / 173 / 3, 296 / 174 / 2, 275 / 175 / 2, 342 / 176 / 3, 266 / 177 / 2, 46 / 178 / 3, 295 / 179 / 2, 4 / 180 / 3, 373 / 181 / 2, 273 / 182 / 2, 186 / 183 / 3, 15 / 184 / 2, 320 / 185 / 3, 191 / 186 / 2, 224 / 187 / 2, 212 / 188 / 2, 185 / 189 / 5, 14 / 190 / 2, 214 / 191 / 2, 221 / 192 / 2, 72 / 193 / 2, 270 / 194 / 3, 140 / 195 / 2, 150 / 196 / 4, 315 / 197 / 2, 300 / 198 / 2, 298 / 199 / 4, 303 / 200 / 2, 216 / 201 / 2, 103 / 202 / 2, 281 / 203 / 2, 337 / 204 / 3, 119 / 205 / 2, 242 / 206 / 2, 172 / 207 / 2, 220 / 208 / 2, 361 / 209 / 3, 360 / 210 / 2, 265 / 211 / 2, 144 / 212 / 3, 343 / 213 / 2, 292 / 214 / 2, 349 / 215 / 3, 8 / 216 / 2, 317 / 217 / 3, 27 / 218 / 2, 182 / 219 / 2, 286 / 220 / 2, 23 / 221 / 2, 50 / 222 / 2, 63 / 223 / 2, 126 / 224 / 3, 331 / 225 / 2, 164 / 226 / 2, 284 / 227 / 3, 75 / 228 / 2, 41 / 229 / 3, 253 / 230 / 2, 364 / 231 / 2, 147 / 232 / 2, 200 / 233 / 2, 213 / 234 / 2, 288 / 235 / 3, 359 / 236 / 2, 44 / 237 / 2, 62 / 238 / 2, 142 / 239 / 2, 202 / 240 / 2, 20 / 241 / 2, 163 / 242 / 2, 168 / 243 / 3, 237 / 244 / 2, 157 / 245 / 3, 256 / 246 / 2, 245 / 247 / 2, 128 / 248 / 3, 217 / 249 / 2, 328 / 250 / 3, 104 / 251 / 2, 136 / 252 / 3, 363 / 253 / 2, 338 / 254 / 2, 271 / 255 / 2, 259 / 256 / 3, 283 / 257 / 2, 351 / 258 / 2, 51 / 259 / 3, 156 / 260 / 2, 188 / 261 / 3, 154 / 262 / 2, 109 / 263 / 3, 24 / 264 / 2, 52 / 265 / 2, 54 / 266 / 2, 60 / 267 / 2, 68 / 268 / 3, 43 / 269 / 2, 267 / 270 / 2, 131 / 271 / 2, 319 / 272 / 3, 29 / 273 / 2, 76 / 274 / 3, 215 / 275 / 2, 94 / 276 / 4, 239 / 277 / 2, 130 / 278 / 3, 133 / 279 / 2, 17 / 280 / 3, 247 / 281 / 2, 55 / 282 / 2, 165 / 283 / 3, 252 / 284 / 2, 92 / 285 / 4, 353 / 286 / 2, 329 / 287 / 3, 12 / 288 / 2, 302 / 289 / 2, 90 / 290 / 3, 70 / 291 / 2, 196 / 292 / 2, 1 / 293 / 2, 304 / 294 / 4, 9 / 295 / 2, 348 / 296 / 2, 269 / 297 / 3, 83 / 298 / 2, 206 / 299 / 2, 240 / 300 / 4, 321 / 301 / 2, 26 / 302 / 2, 365 / 303 / 3, 262 / 304 / 2, 102 / 305 / 6, 81 / 306 / 2, 177 / 307 / 2, 115 / 308 / 2, 278 / 309 / 2, 159 / 310 / 2, 264 / 311 / 2, 205 / 312 / 2, 61 / 313 / 2, 42 / 314 / 2, 225 / 315 / 3, 34 / 316 / 2, 180 / 317 / 3, 193 / 318 / 2, 155 / 319 / 3, 57 / 320 / 2, 374 / 321 / 2, 174 / 322 / 2, 89 / 323 / 2, 7 / 324 / 2, 152 / 325 / 2, 312 / 326 / 2, 100 / 327 / 3, 10 / 328 / 2, 198 / 329 / 2, 171 / 330 / 2, 197 / 331 / 2, 84 / 332 / 2, 358 / 333 / 2, 244 / 334 / 2, 322 / 335 / 2, 95 / 336 / 2, 107 / 337 / 3, 294 / 338 / 2, 310 / 339 / 2, 135 / 340 / 3, 297 / 341 / 2, 39 / 342 / 2, 350 / 343 / 3, 335 / 344 / 2, 38 / 345 / 2, 308 / 346 / 3, 18 / 347 / 2, 132 / 348 / 3, 2 / 349 / 2, 137 / 350 / 2, 255 / 351 / 2, 243 / 352 / 3, 146 / 353 / 2, 59 / 354 / 3, 80 / 355 / 2, 28 / 356 / 3, 263 / 357 / 2, 277 / 358 / 2, 173 / 359 / 2, 78 / 360 / 4, 330 / 361 / 2, 357 / 362 / 2, 235 / 363 / 3, 333 / 364 / 2, 290 / 365 / 2, 313 / 366 / 5, 306 / 367 / 2, 19 / 368 / 2, 274 / 369 / 2, 233 / 370 / 2, 167 / 371 / 2, 149 / 372 / 7, 368 / 373 / 2, 45 / 374 / 3
singlecenter-alpha_1-13-n500.txt, 1, 1, 500, 3169.35, 3890, 3390, 8, 499,56 / 1 / 3, 423 / 2 / 2, 419 / 3 / 3, 173 / 4 / 2, 196 / 5 / 2, 217 / 6 / 2, 393 / 7 / 2, 334 / 8 / 2, 314 / 9 / 3, 340 / 10 / 2, 369 / 11 / 3, 247 / 12 / 2, 46 / 13 / 2, 86 / 14 / 2, 415 / 15 / 2, 127 / 16 / 3, 437 / 17 / 2, 443 / 18 / 2, 285 / 19 / 3, 112 / 20 / 2, 38 / 21 / 3, 186 / 22 / 2, 487 / 23 / 4, 493 / 24 / 2, 455 / 25 / 2, 337 / 26 / 2, 168 / 27 / 2, 199 / 28 / 3, 237 / 29 / 2, 219 / 30 / 2, 335 / 31 / 2, 462 / 32 / 3, 351 / 33 / 2, 307 / 34 / 2, 184 / 35 / 8, 466 / 36 / 2, 476 / 37 / 3, 310 / 38 / 2, 288 / 39 / 2, 436 / 40 / 3, 183 / 41 / 2, 367 / 42 / 2, 45 / 43 / 6, 317 / 44 / 2, 34 / 45 / 2, 459 / 46 / 3, 385 / 47 / 2, 470 / 48 / 3, 226 / 49 / 2, 251 / 50 / 2, 238 / 51 / 2, 329 / 52 / 2, 259 / 53 / 4, 188 / 54 / 2, 151 / 55 / 2, 143 / 56 / 2, 149 / 57 / 2, 456 / 58 / 2, 355 / 59 / 2, 37 / 60 / 5, 181 / 61 / 2, 338 / 62 / 2, 135 / 63 / 2, 411 / 64 / 3, 333 / 65 / 2, 398 / 66 / 3, 138 / 67 / 2, 479 / 68 / 2, 182 / 69 / 3, 405 / 70 / 2, 486 / 71 / 3, 489 / 72 / 2, 433 / 73 / 2, 95 / 74 / 2, 64 / 75 / 2, 336 / 76 / 2, 200 / 77 / 3, 482 / 78 / 2, 31 / 79 / 2, 257 / 80 / 4, 364 / 81 / 2, 175 / 82 / 2, 408 / 83 / 2, 281 / 84 / 2, 472 / 85 / 4, 427 / 86 / 2, 461 / 87 / 2, 185 / 88 / 2, 308 / 89 / 5, 136 / 90 / 2, 268 / 91 / 2, 35 / 92 / 2, 24 / 93 / 2, 491 / 94 / 2, 150 / 95 / 2, 123 / 96 / 5, 417 / 97 / 2, 15 / 98 / 2, 306 / 99 / 2, 109 / 100 / 4, 13 / 101 / 2, 243 / 102 / 2, 311 / 103 / 2, 293 / 104 / 5, 261 / 105 / 2, 78 / 106 / 2, 197 / 107 / 2, 85 / 108 / 4, 9 / 109 / 2, 309 / 110 / 2, 446 / 111 / 3, 305 / 112 / 2, 220 / 113 / 3, 161 / 114 / 2, 350 / 115 / 2, 386 / 116 / 3, 19 / 117 / 2, 16 / 118 / 2, 353 / 119 / 2, 160 / 120 / 4, 21 / 121 / 2, 90 / 122 / 2, 372 / 123 / 2, 434 / 124 / 5, 190 / 125 / 2, 280 / 126 / 2, 139 / 127 / 3, 33 / 128 / 2, 279 / 129 / 2, 76 / 130 / 2, 370 / 131 / 3, 8 / 132 / 2, 166 / 133 / 2, 153 / 134 / 2, 63 / 135 / 5, 187 / 136 / 2, 358 / 137 / 2, 452 / 138 / 2, 246 / 139 / 2, 291 / 140 / 2, 359 / 141 / 2, 278 / 142 / 2, 106 / 143 / 2, 18 / 144 / 3, 380 / 145 / 2, 215 / 146 / 6, 39 / 147 / 2, 441 / 148 / 2, 416 / 149 / 2, 484 / 150 / 2, 460 / 151 / 4, 471 / 152 / 2, 137 / 153 / 2, 23 / 154 / 3, 3 / 155 / 2, 71 / 156 / 2, 341 / 157 / 2, 431 / 158 / 2, 235 / 159 / 2, 146 / 160 / 3, 292 / 161 / 2, 229 / 162 / 3, 397 / 163 / 2, 418 / 164 / 3, 496 / 165 / 2, 230 / 166 / 2, 57 / 167 / 2, 28 / 168 / 3, 260 / 169 / 2, 289 / 170 / 2, 488 / 171 / 3, 224 / 172 / 2, 48 / 173 / 3, 22 / 174 / 2, 213 / 175 / 3, 412 / 176 / 2, 368 / 177 / 2, 99 / 178 / 2, 11 / 179 / 3, 494 / 180 / 2, 316 / 181 / 2, 6 / 182 / 3, 72 / 183 / 2, 448 / 184 / 2, 331 / 185 / 2, 478 / 186 / 2, 103 / 187 / 2, 312 / 188 / 2, 345 / 189 / 3, 208 / 190 / 2, 327 / 191 / 2, 492 / 192 / 2, 349 / 193 / 2, 154 / 194 / 4, 447 / 195 / 2, 383 / 196 / 3, 269 / 197 / 2, 426 / 198 / 3, 344 / 199 / 2, 209 / 200 / 2, 399 / 201 / 4, 89 / 202 / 2, 75 / 203 / 2, 67 / 204 / 3, 47 / 205 / 2, 111 / 206 / 3, 177 / 207 / 2, 178 / 208 / 2, 357 / 209 / 2, 352 / 210 / 4, 273 / 211 / 2, 435 / 212 / 2, 62 / 213 / 3, 7 / 214 / 2, 404 / 215 / 2, 299 / 216 / 2, 410 / 217 / 3, 382 / 218 / 2, 255 / 219 / 2, 270 / 220 / 3, 122 / 221 / 2, 490 / 222 / 2, 481 / 223 / 4, 130 / 224 / 2, 465 / 225 / 2, 110 / 226 / 2, 77 / 227 / 3, 323 / 228 / 2, 14 / 229 / 2, 1 / 230 / 3, 142 / 231 / 2, 396 / 232 / 2, 430 / 233 / 2, 221 / 234 / 2, 473 / 235 / 2, 303 / 236 / 2, 454 / 237 / 4, 180 / 238 / 2, 91 / 239 / 2, 475 / 240 / 3, 148 / 241 / 2, 51 / 242 / 2, 425 / 243 / 2, 58 / 244 / 3, 100 / 245 / 2, 234 / 246 / 2, 29 / 247 / 3, 453 / 248 / 2, 356 / 249 / 2, 204 / 250 / 4, 300 / 251 / 2, 391 / 252 / 2, 348 / 253 / 3, 440 / 254 / 2, 176 / 255 / 3, 248 / 256 / 2, 222 / 257 / 2, 274 / 258 / 2, 214 / 259 / 2, 210 / 260 / 2, 17 / 261 / 2, 474 / 262 / 5, 424 / 263 / 2, 400 / 264 / 3, 233 / 265 / 2, 118 / 266 / 2, 256 / 267 / 3, 225 / 268 / 2, 83 / 269 / 2, 117 / 270 / 4, 277 / 271 / 2, 20 / 272 / 2, 420 / 273 / 2, 227 / 274 / 3, 116 / 275 / 2, 304 / 276 / 3, 445 / 277 / 2, 361 / 278 / 3, 128 / 279 / 2, 115 / 280 / 2, 498 / 281 / 2, 403 / 282 / 2, 2 / 283 / 2, 172 / 284 / 2, 499 / 285 / 2, 144 / 286 / 3, 401 / 287 / 2, 158 / 288 / 2, 469 / 289 / 2, 422 / 290 / 2, 467 / 291 / 2, 464 / 292 / 3, 377 / 293 / 2, 495 / 294 / 2, 253 / 295 / 5, 30 / 296 / 2, 107 / 297 / 3, 169 / 298 / 2, 70 / 299 / 3, 92 / 300 / 2, 439 / 301 / 2, 108 / 302 / 3, 271 / 303 / 2, 87 / 304 / 2, 101 / 305 / 2, 394 / 306 / 3, 402 / 307 / 2, 126 / 308 / 3, 73 / 309 / 2, 432 / 310 / 2, 82 / 311 / 3, 258 / 312 / 2, 267 / 313 / 2, 195 / 314 / 3, 105 / 315 / 2, 360 / 316 / 4, 298 / 317 / 2, 339 / 318 / 2, 155 / 319 / 3, 165 / 320 / 2, 249 / 321 / 2, 244 / 322 / 2, 346 / 323 / 2, 286 / 324 / 3, 263 / 325 / 2, 25 / 326 / 2, 302 / 327 / 4, 276 / 328 / 2, 42 / 329 / 2, 371 / 330 / 2, 114 / 331 / 2, 322 / 332 / 2, 61 / 333 / 2, 266 / 334 / 6, 207 / 335 / 2, 157 / 336 / 2, 102 / 337 / 2, 134 / 338 / 2, 318 / 339 / 2, 428 / 340 / 4, 141 / 341 / 2, 332 / 342 / 3, 442 / 343 / 2, 297 / 344 / 2, 131 / 345 / 2, 315 / 346 / 2, 171 / 347 / 3, 203 / 348 / 2, 26 / 349 / 3, 365 / 350 / 2, 379 / 351 / 2, 296 / 352 / 2, 374 / 353 / 3, 290 / 354 / 2, 4 / 355 / 2, 252 / 356 / 5, 313 / 357 / 2, 191 / 358 / 3, 206 / 359 / 2, 10 / 360 / 2, 275 / 361 / 2, 104 / 362 / 3, 69 / 363 / 2, 414 / 364 / 2, 376 / 365 / 2, 174 / 366 / 2, 50 / 367 / 2, 450 / 368 / 2, 84 / 369 / 2, 36 / 370 / 2, 52 / 371 / 3, 449 / 372 / 2, 205 / 373 / 2, 421 / 374 / 2, 468 / 375 / 3, 216 / 376 / 2, 202 / 377 / 2, 343 / 378 / 3, 192 / 379 / 2, 156 / 380 / 3, 363 / 381 / 2, 147 / 382 / 3, 294 / 383 / 2, 272 / 384 / 3, 53 / 385 / 2, 265 / 386 / 2, 384 / 387 / 2, 330 / 388 / 4, 43 / 389 / 2, 74 / 390 / 2, 284 / 391 / 3, 232 / 392 / 2, 413 / 393 / 2, 79 / 394 / 3, 218 / 395 / 2, 287 / 396 / 3, 55 / 397 / 2, 319 / 398 / 2, 163 / 399 / 2, 198 / 400 / 2, 133 / 401 / 2, 66 / 402 / 2, 212 / 403 / 2, 223 / 404 / 2, 347 / 405 / 2, 129 / 406 / 2, 59 / 407 / 2, 27 / 408 / 2, 194 / 409 / 4, 96 / 410 / 2, 325 / 411 / 2, 121 / 412 / 2, 179 / 413 / 2, 164 / 414 / 3, 485 / 415 / 2, 295 / 416 / 3, 162 / 417 / 2, 262 / 418 / 2, 49 / 419 / 2, 328 / 420 / 3, 97 / 421 / 2, 98 / 422 / 3, 264 / 423 / 2, 387 / 424 / 2, 44 / 425 / 3, 438 / 426 / 2, 132 / 427 / 3, 245 / 428 / 2, 282 / 429 / 2, 395 / 430 / 2, 378 / 431 / 2, 301 / 432 / 2, 373 / 433 / 3, 390 / 434 / 2, 241 / 435 / 2, 362 / 436 / 2, 140 / 437 / 2, 240 / 438 / 3, 320 / 439 / 2, 354 / 440 / 3, 483 / 441 / 2, 68 / 442 / 2, 124 / 443 / 3, 242 / 444 / 2, 388 / 445 / 2, 167 / 446 / 2, 407 / 447 / 3, 32 / 448 / 2, 119 / 449 / 3, 60 / 450 / 2, 80 / 451 / 4, 236 / 452 / 2, 366 / 453 / 2, 159 / 454 / 2, 239 / 455 / 2, 326 / 456 / 2, 250 / 457 / 2, 228 / 458 / 2, 324 / 459 / 2, 120 / 460 / 2, 497 / 461 / 3, 5 / 462 / 2, 113 / 463 / 2, 81 / 464 / 3, 65 / 465 / 2, 480 / 466 / 2, 88 / 467 / 2, 389 / 468 / 3, 93 / 469 / 2, 211 / 470 / 4, 254 / 471 / 2, 12 / 472 / 2, 41 / 473 / 3, 170 / 474 / 2, 392 / 475 / 3, 283 / 476 / 2, 375 / 477 / 3, 231 / 478 / 2, 125 / 479 / 2, 193 / 480 / 2, 429 / 481 / 2, 145 / 482 / 4, 152 / 483 / 2, 321 / 484 / 2, 201 / 485 / 3, 54 / 486 / 2, 40 / 487 / 3, 342 / 488 / 2, 406 / 489 / 2, 458 / 490 / 3, 381 / 491 / 2, 409 / 492 / 4, 189 / 493 / 2, 463 / 494 / 2, 451 / 495 / 3, 457 / 496 / 2, 94 / 497 / 2, 444 / 498 / 2, 477 / 499 / 4
singlecenter-alpha_1-13-n6.txt, 1, 1, 6, 379.725, 26, 20, 6, 5,1 / 1 / 2, 5 / 2 / 2, 3 / 3 / 6, 2 / 4 / 2, 4 / 5 / 3
singlecenter-alpha_1-14-n375.txt, 1, 1, 375, 2923.24, 3088, 2713, 8, 374,279 / 1 / 4, 155 / 2 / 2, 129 / 3 / 2, 235 / 4 / 3, 275 / 5 / 2, 75 / 6 / 2, 373 / 7 / 2, 197 / 8 / 4, 246 / 9 / 2, 252 / 10 / 2, 2 / 11 / 2, 171 / 12 / 2, 255 / 13 / 2, 347 / 14 / 4, 88 / 15 / 2, 179 / 16 / 3, 90 / 17 / 2, 356 / 18 / 2, 98 / 19 / 2, 130 / 20 / 2, 43 / 21 / 2, 57 / 22 / 2, 215 / 23 / 2, 190 / 24 / 3, 100 / 25 / 2, 62 / 26 / 2, 49 / 27 / 2, 162 / 28 / 2, 315 / 29 / 2, 180 / 30 / 3, 224 / 31 / 2, 178 / 32 / 3, 320 / 33 / 2, 144 / 34 / 2, 118 / 35 / 3, 216 / 36 / 2, 16 / 37 / 3, 357 / 38 / 2, 187 / 39 / 2, 206 / 40 / 5, 4 / 41 / 2, 234 / 42 / 3, 208 / 43 / 2, 248 / 44 / 3, 191 / 45 / 2, 210 / 46 / 4, 293 / 47 / 2, 105 / 48 / 2, 156 / 49 / 3, 3 / 50 / 2, 54 / 51 / 2, 104 / 52 / 5, 168 / 53 / 2, 337 / 54 / 3, 87 / 55 / 2, 249 / 56 / 2, 241 / 57 / 2, 328 / 58 / 2, 167 / 59 / 2, 218 / 60 / 2, 183 / 61 / 3, 245 / 62 / 2, 194 / 63 / 3, 12 / 64 / 2, 29 / 65 / 2, 149 / 66 / 2, 301 / 67 / 2, 177 / 68 / 3, 367 / 69 / 2, 184 / 70 / 2, 221 / 71 / 2, 128 / 72 / 4, 270 / 73 / 2, 135 / 74 / 2, 114 / 75 / 3, 78 / 76 / 2, 229 / 77 / 2, 286 / 78 / 3, 24 / 79 / 2, 125 / 80 / 2, 348 / 81 / 2, 195 / 82 / 3, 306 / 83 / 2, 344 / 84 / 2, 222 / 85 / 2, 147 / 86 / 4, 318 / 87 / 2, 259 / 88 / 3, 211 / 89 / 2, 363 / 90 / 3, 133 / 91 / 2, 31 / 92 / 3, 219 / 93 / 2, 360 / 94 / 3, 303 / 95 / 2, 121 / 96 / 3, 354 / 97 / 2, 61 / 98 / 3, 66 / 99 / 2, 170 / 100 / 3, 19 / 101 / 2, 323 / 102 / 2, 94 / 103 / 3, 298 / 104 / 2, 317 / 105 / 2, 158 / 106 / 2, 304 / 107 / 2, 230 / 108 / 3, 1 / 109 / 2, 188 / 110 / 2, 64 / 111 / 2, 251 / 112 / 2, 300 / 113 / 2, 223 / 114 / 4, 28 / 115 / 2, 160 / 116 / 2, 355 / 117 / 2, 27 / 118 / 2, 291 / 119 / 2, 372 / 120 / 2, 199 / 121 / 2, 343 / 122 / 2, 310 / 123 / 2, 107 / 124 / 2, 101 / 125 / 2, 213 / 126 / 2, 6 / 127 / 3, 136 / 128 / 2, 267 / 129 / 2, 242 / 130 / 2, 127 / 131 / 3, 345 / 132 / 2, 109 / 133 / 2, 266 / 134 / 2, 309 / 135 / 2, 36 / 136 / 2, 11 / 137 / 3, 297 / 138 / 2, 313 / 139 / 2, 253 / 140 / 4, 14 / 141 / 2, 280 / 142 / 3, 60 / 143 / 2, 55 / 144 / 3, 85 / 145 / 2, 341 / 146 / 2, 50 / 147 / 2, 256 / 148 / 2, 146 / 149 / 3, 287 / 150 / 2, 25 / 151 / 2, 295 / 152 / 2, 41 / 153 / 3, 240 / 154 / 2, 30 / 155 / 3, 231 / 156 / 2, 91 / 157 / 3, 192 / 158 / 2, 7 / 159 / 3, 196 / 160 / 2, 65 / 161 / 2, 80 / 162 / 2, 18 / 163 / 3, 308 / 164 / 2, 282 / 165 / 2, 5 / 166 / 3, 185 / 167 / 2, 274 / 168 / 2, 154 / 169 / 3, 302 / 170 / 2, 339 / 171 / 4, 122 / 172 / 2, 172 / 173 / 2, 72 / 174 / 2, 132 / 175 / 5, 278 / 176 / 2, 296 / 177 / 3, 263 / 178 / 2, 346 / 179 / 2, 307 / 180 / 3, 69 / 181 / 2, 244 / 182 / 3, 22 / 183 / 2, 276 / 184 / 2, 202 / 185 / 2, 164 / 186 / 2, 311 / 187 / 5, 321 / 188 / 2, 226 / 189 / 2, 120 / 190 / 3, 59 / 191 / 2, 95 / 192 / 5, 108 / 193 / 2, 212 / 194 / 3, 63 / 195 / 2, 151 / 196 / 5, 322 / 197 / 2, 89 / 198 / 2, 124 / 199 / 2, 361 / 200 / 2, 269 / 201 / 2, 37 / 202 / 2, 33 / 203 / 4, 233 / 204 / 2, 272 / 205 / 3, 139 / 206 / 2, 76 / 207 / 2, 169 / 208 / 5, 71 / 209 / 2, 325 / 210 / 3, 225 / 211 / 2, 334 / 212 / 2, 152 / 213 / 5, 163 / 214 / 2, 123 / 215 / 2, 106 / 216 / 4, 44 / 217 / 2, 201 / 218 / 2, 26 / 219 / 2, 39 / 220 / 2, 138 / 221 / 3, 228 / 222 / 2, 365 / 223 / 3, 250 / 224 / 2, 131 / 225 / 2, 336 / 226 / 2, 265 / 227 / 3, 209 / 228 / 2, 182 / 229 / 3, 342 / 230 / 2, 305 / 231 / 2, 32 / 232 / 5, 258 / 233 / 2, 74 / 234 / 2, 111 / 235 / 3, 159 / 236 / 2, 115 / 237 / 5, 200 / 238 / 2, 299 / 239 / 3, 53 / 240 / 2, 193 / 241 / 5, 203 / 242 / 2, 284 / 243 / 3, 92 / 244 / 2, 102 / 245 / 3, 294 / 246 / 2, 173 / 247 / 3, 157 / 248 / 2, 9 / 249 / 3, 13 / 250 / 2, 204 / 251 / 4, 150 / 252 / 2, 268 / 253 / 2, 364 / 254 / 2, 205 / 255 / 2, 314 / 256 / 4, 116 / 257 / 2, 350 / 258 / 2, 277 / 259 / 3, 340 / 260 / 2, 237 / 261 / 3, 283 / 262 / 2, 143 / 263 / 2, 370 / 264 / 2, 236 / 265 / 2, 247 / 266 / 6, 349 / 267 / 2, 68 / 268 / 2, 34 / 269 / 2, 81 / 270 / 2, 93 / 271 / 3, 46 / 272 / 2, 326 / 273 / 4, 262 / 274 / 2, 359 / 275 / 3, 335 / 276 / 2, 58 / 277 / 2, 99 / 278 / 3, 174 / 279 / 2, 289 / 280 / 3, 79 / 281 / 2, 86 / 282 / 2, 52 / 283 / 3, 358 / 284 / 2, 281 / 285 / 2, 220 / 286 / 3, 56 / 287 / 2, 312 / 288 / 3, 20 / 289 / 2, 176 / 290 / 2, 15 / 291 / 4, 181 / 292 / 2, 73 / 293 / 2, 140 / 294 / 2, 371 / 295 / 2, 331 / 296 / 2, 327 / 297 / 2, 271 / 298 / 2, 292 / 299 / 2, 261 / 300 / 6, 186 / 301 / 2, 227 / 302 / 2, 351 / 303 / 2, 333 / 304 / 3, 38 / 305 / 2, 35 / 306 / 4, 40 / 307 / 2, 112 / 308 / 2, 10 / 309 / 2, 329 / 310 / 3, 362 / 311 / 2, 21 / 312 / 8, 113 / 313 / 2, 161 / 314 / 2, 110 / 315 / 2, 137 / 316 / 2, 207 / 317 / 2, 82 / 318 / 2, 126 / 319 / 3, 96 / 320 / 2, 254 / 321 / 2, 288 / 322 / 2, 330 / 323 / 4, 166 / 324 / 2, 142 / 325 / 2, 264 / 326 / 2, 368 / 327 / 4, 42 / 328 / 2, 232 / 329 / 2, 217 / 330 / 4, 239 / 331 / 2, 103 / 332 / 2, 189 / 333 / 2, 141 / 334 / 3, 23 / 335 / 2, 153 / 336 / 3, 48 / 337 / 2, 77 / 338 / 2, 97 / 339 / 2, 117 / 340 / 2, 332 / 341 / 3, 134 / 342 / 2, 316 / 343 / 2, 198 / 344 / 3, 290 / 345 / 2, 67 / 346 / 3, 369 / 347 / 2, 366 / 348 / 2, 165 / 349 / 2, 70 / 350 / 2, 8 / 351 / 2, 119 / 352 / 4, 285 / 353 / 2, 175 / 354 / 2, 273 / 355 / 2, 338 / 356 / 5, 243 / 357 / 2, 17 / 358 / 3, 84 / 359 / 2, 238 / 360 / 5, 145 / 361 / 2, 260 / 362 / 3, 214 / 363 / 2, 83 / 364 / 2, 45 / 365 / 2, 353 / 366 / 5, 47 / 367 / 2, 319 / 368 / 2, 374 / 369 / 2, 51 / 370 / 3, 148 / 371 / 2, 324 / 372 / 3, 352 / 373 / 2, 257 / 374 / 2
singlecenter-alpha_1-14-n500.txt, 1, 1, 500, 2978.55, 3880, 3380, 7, 499,188 / 1 / 2, 292 / 2 / 2, 212 / 3 / 4, 51 / 4 / 2, 86 / 5 / 2, 209 / 6 / 3, 242 / 7 / 2, 268 / 8 / 3, 16 / 9 / 2, 496 / 10 / 2, 326 / 11 / 4, 369 / 12 / 2, 480 / 13 / 3, 355 / 14 / 2, 52 / 15 / 3, 384 / 16 / 2, 12 / 17 / 2, 15 / 18 / 2, 459 / 19 / 4, 307 / 20 / 2, 159 / 21 / 2, 145 / 22 / 4, 191 / 23 / 2, 168 / 24 / 2, 39 / 25 / 2, 263 / 26 / 2, 225 / 27 / 4, 439 / 28 / 2, 443 / 29 / 2, 262 / 30 / 2, 17 / 31 / 5, 229 / 32 / 2, 79 / 33 / 2, 172 / 34 / 2, 373 / 35 / 3, 278 / 36 / 2, 80 / 37 / 2, 422 / 38 / 2, 27 / 39 / 2, 161 / 40 / 3, 332 / 41 / 2, 169 / 42 / 2, 433 / 43 / 2, 107 / 44 / 6, 19 / 45 / 2, 85 / 46 / 2, 403 / 47 / 2, 83 / 48 / 3, 265 / 49 / 2, 478 / 50 / 2, 197 / 51 / 3, 372 / 52 / 2, 336 / 53 / 2, 337 / 54 / 2, 329 / 55 / 2, 118 / 56 / 2, 328 / 57 / 2, 321 / 58 / 3, 198 / 59 / 2, 180 / 60 / 3, 299 / 61 / 2, 400 / 62 / 2, 251 / 63 / 3, 421 / 64 / 2, 277 / 65 / 3, 250 / 66 / 2, 411 / 67 / 3, 217 / 68 / 2, 330 / 69 / 2, 53 / 70 / 4, 48 / 71 / 2, 485 / 72 / 2, 429 / 73 / 4, 164 / 74 / 2, 3 / 75 / 2, 109 / 76 / 4, 220 / 77 / 2, 136 / 78 / 2, 487 / 79 / 2, 379 / 80 / 2, 362 / 81 / 2, 22 / 82 / 2, 149 / 83 / 2, 342 / 84 / 2, 68 / 85 / 3, 492 / 86 / 2, 393 / 87 / 2, 412 / 88 / 2, 162 / 89 / 3, 294 / 90 / 2, 97 / 91 / 4, 190 / 92 / 2, 204 / 93 / 2, 378 / 94 / 2, 125 / 95 / 5, 59 / 96 / 2, 81 / 97 / 2, 354 / 98 / 2, 309 / 99 / 2, 99 / 100 / 4, 475 / 101 / 2, 178 / 102 / 2, 293 / 103 / 4, 232 / 104 / 2, 175 / 105 / 2, 71 / 106 / 2, 74 / 107 / 2, 138 / 108 / 2, 167 / 109 / 3, 222 / 110 / 2, 239 / 111 / 2, 50 / 112 / 2, 6 / 113 / 2, 461 / 114 / 2, 350 / 115 / 6, 133 / 116 / 2, 224 / 117 / 2, 474 / 118 / 2, 240 / 119 / 2, 374 / 120 / 4, 452 / 121 / 2, 428 / 122 / 3, 65 / 123 / 2, 368 / 124 / 2, 202 / 125 / 2, 207 / 126 / 2, 298 / 127 / 2, 256 / 128 / 2, 195 / 129 / 2, 447 / 130 / 5, 343 / 131 / 2, 426 / 132 / 2, 183 / 133 / 3, 140 / 134 / 2, 129 / 135 / 2, 18 / 136 / 2, 98 / 137 / 2, 120 / 138 / 2, 77 / 139 / 3, 148 / 140 / 2, 231 / 141 / 2, 127 / 142 / 2, 445 / 143 / 4, 187 / 144 / 2, 237 / 145 / 2, 186 / 146 / 2, 25 / 147 / 2, 234 / 148 / 2, 408 / 149 / 2, 196 / 150 / 2, 245 / 151 / 3, 82 / 152 / 2, 410 / 153 / 3, 66 / 154 / 2, 467 / 155 / 2, 397 / 156 / 2, 486 / 157 / 2, 391 / 158 / 2, 147 / 159 / 2, 103 / 160 / 2, 287 / 161 / 5, 311 / 162 / 2, 102 / 163 / 2, 194 / 164 / 2, 358 / 165 / 3, 423 / 166 / 2, 404 / 167 / 2, 323 / 168 / 2, 451 / 169 / 2, 67 / 170 / 2, 96 / 171 / 3, 226 / 172 / 2, 375 / 173 / 4, 124 / 174 / 2, 165 / 175 / 2, 112 / 176 / 3, 8 / 177 / 2, 279 / 178 / 2, 495 / 179 / 2, 441 / 180 / 2, 396 / 181 / 3, 230 / 182 / 2, 280 / 183 / 3, 64 / 184 / 2, 417 / 185 / 2, 139 / 186 / 2, 11 / 187 / 3, 406 / 188 / 2, 221 / 189 / 3, 457 / 190 / 2, 41 / 191 / 2, 295 / 192 / 3, 345 / 193 / 2, 87 / 194 / 6, 110 / 195 / 2, 376 / 196 / 2, 456 / 197 / 4, 267 / 198 / 2, 90 / 199 / 2, 45 / 200 / 4, 419 / 201 / 2, 264 / 202 / 2, 141 / 203 / 2, 205 / 204 / 2, 132 / 205 / 3, 438 / 206 / 2, 335 / 207 / 3, 94 / 208 / 2, 493 / 209 / 3, 28 / 210 / 2, 218 / 211 / 3, 463 / 212 / 2, 318 / 213 / 2, 243 / 214 / 3, 460 / 215 / 2, 153 / 216 / 3, 151 / 217 / 2, 206 / 218 / 2, 215 / 219 / 2, 392 / 220 / 3, 319 / 221 / 2, 54 / 222 / 3, 320 / 223 / 2, 285 / 224 / 2, 223 / 225 / 2, 46 / 226 / 4, 115 / 227 / 2, 173 / 228 / 2, 95 / 229 / 2, 154 / 230 / 3, 416 / 231 / 2, 92 / 232 / 2, 370 / 233 / 3, 70 / 234 / 2, 228 / 235 / 2, 182 / 236 / 3, 89 / 237 / 2, 252 / 238 / 2, 377 / 239 / 4, 121 / 240 / 2, 347 / 241 / 2, 36 / 242 / 2, 91 / 243 / 4, 246 / 244 / 2, 23 / 245 / 3, 270 / 246 / 2, 101 / 247 / 2, 119 / 248 / 3, 152 / 249 / 2, 359 / 250 / 3, 455 / 251 / 2, 437 / 252 / 2, 494 / 253 / 4, 44 / 254 / 2, 199 / 255 / 2, 113 / 256 / 3, 324 / 257 / 2, 430 / 258 / 3, 5 / 259 / 2, 476 / 260 / 3, 236 / 261 / 2, 283 / 262 / 3, 436 / 263 / 2, 275 / 264 / 2, 143 / 265 / 4, 176 / 266 / 2, 477 / 267 / 3, 481 / 268 / 2, 35 / 269 / 2, 213 / 270 / 2, 394 / 271 / 5, 14 / 272 / 2, 418 / 273 / 2, 105 / 274 / 2, 216 / 275 / 2, 104 / 276 / 4, 466 / 277 / 2, 462 / 278 / 2, 100 / 279 / 3, 334 / 280 / 2, 497 / 281 / 2, 211 / 282 / 2, 297 / 283 / 4, 312 / 284 / 2, 123 / 285 / 2, 450 / 286 / 3, 78 / 287 / 2, 290 / 288 / 2, 470 / 289 / 2, 32 / 290 / 2, 361 / 291 / 2, 163 / 292 / 2, 156 / 293 / 3, 157 / 294 / 2, 21 / 295 / 2, 389 / 296 / 2, 9 / 297 / 3, 415 / 298 / 2, 353 / 299 / 3, 117 / 300 / 2, 184 / 301 / 3, 29 / 302 / 2, 179 / 303 / 3, 352 / 304 / 2, 454 / 305 / 3, 57 / 306 / 2, 272 / 307 / 2, 407 / 308 / 2, 257 / 309 / 2, 244 / 310 / 2, 473 / 311 / 2, 126 / 312 / 7, 144 / 313 / 2, 34 / 314 / 2, 166 / 315 / 2, 313 / 316 / 2, 241 / 317 / 2, 479 / 318 / 2, 266 / 319 / 2, 424 / 320 / 2, 106 / 321 / 3, 458 / 322 / 2, 446 / 323 / 2, 286 / 324 / 2, 93 / 325 / 3, 364 / 326 / 2, 13 / 327 / 3, 388 / 328 / 2, 84 / 329 / 2, 171 / 330 / 2, 69 / 331 / 2, 193 / 332 / 2, 30 / 333 / 2, 382 / 334 / 2, 288 / 335 / 2, 254 / 336 / 2, 253 / 337 / 3, 383 / 338 / 2, 214 / 339 / 4, 322 / 340 / 2, 420 / 341 / 2, 390 / 342 / 2, 435 / 343 / 2, 371 / 344 / 2, 150 / 345 / 3, 348 / 346 / 2, 315 / 347 / 3, 181 / 348 / 2, 399 / 349 / 3, 489 / 350 / 2, 203 / 351 / 2, 331 / 352 / 3, 200 / 353 / 2, 10 / 354 / 2, 381 / 355 / 3, 314 / 356 / 2, 73 / 357 / 4, 177 / 358 / 2, 386 / 359 / 2, 130 / 360 / 2, 385 / 361 / 2, 72 / 362 / 3, 40 / 363 / 2, 469 / 364 / 3, 442 / 365 / 2, 289 / 366 / 2, 434 / 367 / 3, 351 / 368 / 2, 356 / 369 / 3, 49 / 370 / 2, 131 / 371 / 2, 62 / 372 / 2, 33 / 373 / 2, 327 / 374 / 2, 303 / 375 / 2, 219 / 376 / 2, 409 / 377 / 3, 413 / 378 / 2, 24 / 379 / 3, 281 / 380 / 2, 58 / 381 / 3, 453 / 382 / 2, 135 / 383 / 2, 440 / 384 / 2, 247 / 385 / 3, 137 / 386 / 2, 449 / 387 / 2, 464 / 388 / 2, 448 / 389 / 2, 325 / 390 / 3, 276 / 391 / 2, 282 / 392 / 2, 366 / 393 / 2, 116 / 394 / 4, 88 / 395 / 2, 111 / 396 / 3, 341 / 397 / 2, 170 / 398 / 3, 414 / 399 / 2, 471 / 400 / 3, 344 / 401 / 2, 108 / 402 / 2, 432 / 403 / 2, 387 / 404 / 3, 363 / 405 / 2, 2 / 406 / 4, 305 / 407 / 2, 499 / 408 / 2, 274 / 409 / 3, 63 / 410 / 2, 465 / 411 / 5, 484 / 412 / 2, 317 / 413 / 3, 349 / 414 / 2, 302 / 415 / 2, 346 / 416 / 3, 395 / 417 / 2, 427 / 418 / 2, 490 / 419 / 7, 271 / 420 / 2, 233 / 421 / 3, 128 / 422 / 2, 468 / 423 / 2, 174 / 424 / 2, 258 / 425 / 2, 4 / 426 / 2, 402 / 427 / 2, 405 / 428 / 2, 31 / 429 / 2, 238 / 430 / 4, 304 / 431 / 2, 483 / 432 / 2, 210 / 433 / 4, 158 / 434 / 2, 56 / 435 / 2, 26 / 436 / 2, 227 / 437 / 2, 340 / 438 / 3, 155 / 439 / 2, 498 / 440 / 2, 43 / 441 / 4, 37 / 442 / 2, 273 / 443 / 2, 306 / 444 / 4, 185 / 445 / 2, 261 / 446 / 2, 75 / 447 / 2, 189 / 448 / 3, 7 / 449 / 2, 61 / 450 / 2, 316 / 451 / 4, 20 / 452 / 2, 333 / 453 / 2, 472 / 454 / 3, 235 / 455 / 2, 431 / 456 / 2, 134 / 457 / 3, 296 / 458 / 2, 357 / 459 / 3, 76 / 460 / 2, 360 / 461 / 2, 1 / 462 / 2, 249 / 463 / 4, 425 / 464 / 2, 488 / 465 / 2, 38 / 466 / 4, 192 / 467 / 2, 208 / 468 / 3, 444 / 469 / 2, 310 / 470 / 2, 60 / 471 / 3, 401 / 472 / 2, 255 / 473 / 3, 259 / 474 / 2, 122 / 475 / 3, 301 / 476 / 2, 114 / 477 / 3, 308 / 478 / 2, 142 / 479 / 3, 160 / 480 / 2, 482 / 481 / 2, 284 / 482 / 2, 398 / 483 / 3, 365 / 484 / 2, 367 / 485 / 3, 248 / 486 / 2, 380 / 487 / 2, 47 / 488 / 3, 339 / 489 / 2, 55 / 490 / 2, 291 / 491 / 2, 300 / 492 / 2, 146 / 493 / 4, 201 / 494 / 2, 42 / 495 / 3, 338 / 496 / 2, 491 / 497 / 5, 260 / 498 / 2, 269 / 499 / 2
singlecenter-alpha_1-14-n6.txt, 1, 1, 6, 287.196, 25, 19, 6, 5,4 / 1 / 2, 5 / 2 / 2, 3 / 3 / 2, 1 / 4 / 2, 2 / 5 / 6
singlecenter-alpha_1-15-n375.txt, 1, 1, 375, 2744.46, 2845, 2470, 9, 374,245 / 1 / 4, 165 / 2 / 2, 13 / 3 / 2, 284 / 4 / 2, 208 / 5 / 2, 198 / 6 / 3, 246 / 7 / 2, 39 / 8 / 3, 29 / 9 / 2, 345 / 10 / 2, 3 / 11 / 3, 107 / 12 / 2, 370 / 13 / 2, 226 / 14 / 2, 19 / 15 / 2, 290 / 16 / 3, 229 / 17 / 2, 164 / 18 / 2, 145 / 19 / 3, 43 / 20 / 2, 146 / 21 / 3, 269 / 22 / 2, 328 / 23 / 2, 308 / 24 / 2, 2 / 25 / 3, 220 / 26 / 2, 230 / 27 / 2, 176 / 28 / 2, 265 / 29 / 2, 340 / 30 / 3, 311 / 31 / 2, 263 / 32 / 2, 149 / 33 / 2, 228 / 34 / 2, 363 / 35 / 2, 225 / 36 / 3, 244 / 37 / 2, 336 / 38 / 3, 63 / 39 / 2, 185 / 40 / 2, 325 / 41 / 2, 366 / 42 / 3, 202 / 43 / 2, 86 / 44 / 2, 212 / 45 / 2, 14 / 46 / 5, 247 / 47 / 2, 93 / 48 / 3, 138 / 49 / 2, 159 / 50 / 3, 330 / 51 / 2, 333 / 52 / 2, 173 / 53 / 3, 104 / 54 / 2, 302 / 55 / 2, 144 / 56 / 3, 204 / 57 / 2, 252 / 58 / 2, 150 / 59 / 3, 17 / 60 / 2, 71 / 61 / 3, 326 / 62 / 2, 122 / 63 / 2, 110 / 64 / 2, 293 / 65 / 2, 40 / 66 / 2, 99 / 67 / 3, 359 / 68 / 2, 79 / 69 / 3, 276 / 70 / 2, 282 / 71 / 3, 91 / 72 / 2, 191 / 73 / 3, 68 / 74 / 2, 98 / 75 / 2, 303 / 76 / 3, 332 / 77 / 2, 264 / 78 / 3, 20 / 79 / 2, 232 / 80 / 2, 301 / 81 / 4, 329 / 82 / 2, 270 / 83 / 2, 6 / 84 / 3, 128 / 85 / 2, 357 / 86 / 3, 234 / 87 / 2, 286 / 88 / 2, 350 / 89 / 2, 15 / 90 / 4, 69 / 91 / 2, 295 / 92 / 2, 163 / 93 / 2, 7 / 94 / 2, 320 / 95 / 5, 154 / 96 / 2, 324 / 97 / 2, 199 / 98 / 3, 321 / 99 / 2, 195 / 100 / 2, 364 / 101 / 2, 254 / 102 / 2, 74 / 103 / 2, 55 / 104 / 2, 215 / 105 / 2, 236 / 106 / 2, 262 / 107 / 3, 81 / 108 / 2, 82 / 109 / 2, 70 / 110 / 2, 126 / 111 / 2, 97 / 112 / 2, 62 / 113 / 2, 174 / 114 / 3, 119 / 115 / 2, 310 / 116 / 3, 137 / 117 / 2, 260 / 118 / 2, 346 / 119 / 5, 291 / 120 / 2, 21 / 121 / 2, 147 / 122 / 2, 188 / 123 / 2, 318 / 124 / 2, 218 / 125 / 2, 25 / 126 / 2, 327 / 127 / 5, 111 / 128 / 2, 253 / 129 / 2, 314 / 130 / 2, 80 / 131 / 5, 64 / 132 / 2, 280 / 133 / 2, 298 / 134 / 3, 151 / 135 / 2, 238 / 136 / 2, 88 / 137 / 2, 322 / 138 / 2, 51 / 139 / 3, 214 / 140 / 2, 369 / 141 / 2, 358 / 142 / 2, 156 / 143 / 2, 102 / 144 / 3, 42 / 145 / 2, 123 / 146 / 3, 109 / 147 / 2, 112 / 148 / 3, 181 / 149 / 2, 259 / 150 / 2, 373 / 151 / 2, 160 / 152 / 2, 66 / 153 / 2, 217 / 154 / 2, 249 / 155 / 2, 135 / 156 / 2, 323 / 157 / 2, 186 / 158 / 2, 114 / 159 / 2, 200 / 160 / 3, 306 / 161 / 2, 162 / 162 / 2, 113 / 163 / 2, 334 / 164 / 2, 201 / 165 / 3, 224 / 166 / 2, 190 / 167 / 2, 28 / 168 / 2, 309 / 169 / 2, 34 / 170 / 4, 158 / 171 / 2, 31 / 172 / 2, 223 / 173 / 2, 283 / 174 / 4, 317 / 175 / 2, 4 / 176 / 3, 67 / 177 / 2, 239 / 178 / 3, 255 / 179 / 2, 95 / 180 / 2, 338 / 181 / 3, 300 / 182 / 2, 203 / 183 / 2, 84 / 184 / 2, 127 / 185 / 2, 231 / 186 / 2, 153 / 187 / 3, 130 / 188 / 2, 155 / 189 / 2, 279 / 190 / 3, 371 / 191 / 2, 116 / 192 / 3, 12 / 193 / 2, 175 / 194 / 2, 56 / 195 / 2, 58 / 196 / 2, 16 / 197 / 3, 60 / 198 / 2, 352 / 199 / 2, 182 / 200 / 3, 9 / 201 / 2, 348 / 202 / 3, 237 / 203 / 2, 319 / 204 / 4, 243 / 205 / 2, 241 / 206 / 2, 275 / 207 / 2, 94 / 208 / 2, 37 / 209 / 2, 257 / 210 / 2, 106 / 211 / 2, 251 / 212 / 4, 142 / 213 / 2, 297 / 214 / 2, 179 / 215 / 2, 100 / 216 / 3, 368 / 217 / 2, 233 / 218 / 3, 242 / 219 / 2, 271 / 220 / 3, 296 / 221 / 2, 278 / 222 / 2, 141 / 223 / 2, 353 / 224 / 3, 27 / 225 / 2, 177 / 226 / 2, 256 / 227 / 2, 57 / 228 / 3, 194 / 229 / 2, 96 / 230 / 3, 1 / 231 / 2, 240 / 232 / 3, 189 / 233 / 2, 87 / 234 / 3, 258 / 235 / 2, 170 / 236 / 2, 287 / 237 / 3, 315 / 238 / 2, 281 / 239 / 3, 213 / 240 / 2, 316 / 241 / 3, 161 / 242 / 2, 85 / 243 / 9, 374 / 244 / 2, 65 / 245 / 2, 335 / 246 / 2, 169 / 247 / 2, 61 / 248 / 2, 184 / 249 / 3, 294 / 250 / 2, 337 / 251 / 3, 197 / 252 / 2, 77 / 253 / 2, 261 / 254 / 3, 157 / 255 / 2, 35 / 256 / 3, 192 / 257 / 2, 90 / 258 / 2, 143 / 259 / 2, 288 / 260 / 2, 372 / 261 / 2, 187 / 262 / 3, 307 / 263 / 2, 120 / 264 / 2, 52 / 265 / 4, 117 / 266 / 2, 32 / 267 / 2, 54 / 268 / 3, 272 / 269 / 2, 207 / 270 / 3, 134 / 271 / 2, 50 / 272 / 3, 342 / 273 / 2, 367 / 274 / 2, 235 / 275 / 2, 24 / 276 / 3, 219 / 277 / 2, 180 / 278 / 2, 59 / 279 / 3, 23 / 280 / 2, 351 / 281 / 3, 210 / 282 / 2, 305 / 283 / 3, 355 / 284 / 2, 356 / 285 / 6, 274 / 286 / 2, 11 / 287 / 2, 168 / 288 / 2, 36 / 289 / 3, 22 / 290 / 2, 250 / 291 / 2, 103 / 292 / 3, 26 / 293 / 2, 227 / 294 / 2, 206 / 295 / 3, 44 / 296 / 2, 75 / 297 / 2, 193 / 298 / 2, 347 / 299 / 2, 172 / 300 / 4, 133 / 301 / 2, 101 / 302 / 2, 129 / 303 / 2, 83 / 304 / 3, 131 / 305 / 2, 92 / 306 / 3, 152 / 307 / 2, 343 / 308 / 4, 268 / 309 / 2, 139 / 310 / 3, 362 / 311 / 2, 140 / 312 / 2, 38 / 313 / 3, 132 / 314 / 2, 211 / 315 / 2, 221 / 316 / 4, 166 / 317 / 2, 344 / 318 / 3, 33 / 319 / 2, 183 / 320 / 3, 136 / 321 / 2, 277 / 322 / 2, 48 / 323 / 3, 354 / 324 / 2, 205 / 325 / 3, 8 / 326 / 2, 289 / 327 / 2, 30 / 328 / 2, 49 / 329 / 2, 18 / 330 / 2, 285 / 331 / 2, 118 / 332 / 2, 121 / 333 / 2, 312 / 334 / 3, 10 / 335 / 2, 167 / 336 / 5, 222 / 337 / 2, 248 / 338 / 2, 46 / 339 / 2, 292 / 340 / 2, 341 / 341 / 2, 331 / 342 / 2, 339 / 343 / 4, 196 / 344 / 2, 41 / 345 / 2, 89 / 346 / 3, 178 / 347 / 2, 360 / 348 / 4, 313 / 349 / 2, 76 / 350 / 2, 365 / 351 / 2, 171 / 352 / 2, 148 / 353 / 4, 53 / 354 / 2, 47 / 355 / 2, 115 / 356 / 3, 5 / 357 / 2, 349 / 358 / 3, 124 / 359 / 2, 361 / 360 / 3, 73 / 361 / 2, 108 / 362 / 2, 299 / 363 / 2, 304 / 364 / 2, 105 / 365 / 2, 216 / 366 / 2, 273 / 367 / 3, 209 / 368 / 2, 78 / 369 / 2, 266 / 370 / 4, 72 / 371 / 2, 267 / 372 / 2, 125 / 373 / 2, 45 / 374 / 4
singlecenter-alpha_1-15-n6.txt, 1, 1, 6, 267.249, 26, 20, 6, 5,5 / 1 / 2, 4 / 2 / 2, 2 / 3 / 6, 3 / 4 / 2, 1 / 5 / 3
singlecenter-alpha_1-16-n375.txt, 1, 1, 375, 2608.19, 2907, 2532, 8, 374,252 / 1 / 2, 220 / 2 / 2, 207 / 3 / 3, 103 / 4 / 2, 11 / 5 / 2, 253 / 6 / 2, 341 / 7 / 5, 277 / 8 / 2, 77 / 9 / 3, 372 / 10 / 2, 318 / 11 / 2, 312 / 12 / 2, 276 / 13 / 3, 106 / 14 / 2, 225 / 15 / 3, 44 / 16 / 2, 351 / 17 / 2, 139 / 18 / 2, 76 / 19 / 5, 300 / 20 / 2, 229 / 21 / 2, 274 / 22 / 2, 181 / 23 / 2, 256 / 24 / 2, 36 / 25 / 2, 289 / 26 / 4, 275 / 27 / 2, 299 / 28 / 3, 109 / 29 / 2, 7 / 30 / 3, 46 / 31 / 2, 281 / 32 / 3, 315 / 33 / 2, 350 / 34 / 2, 230 / 35 / 4, 8 / 36 / 2, 191 / 37 / 2, 197 / 38 / 4, 245 / 39 / 2, 125 / 40 / 2, 43 / 41 / 2, 364 / 42 / 4, 90 / 43 / 2, 68 / 44 / 2, 367 / 45 / 2, 231 / 46 / 3, 112 / 47 / 2, 255 / 48 / 2, 162 / 49 / 3, 60 / 50 / 2, 57 / 51 / 5, 374 / 52 / 2, 261 / 53 / 2, 70 / 54 / 3, 173 / 55 / 2, 48 / 56 / 3, 50 / 57 / 2, 244 / 58 / 2, 178 / 59 / 3, 161 / 60 / 2, 267 / 61 / 2, 91 / 62 / 3, 346 / 63 / 2, 160 / 64 / 3, 150 / 65 / 2, 51 / 66 / 2, 328 / 67 / 2, 171 / 68 / 2, 360 / 69 / 2, 120 / 70 / 3, 137 / 71 / 2, 343 / 72 / 2, 354 / 73 / 2, 301 / 74 / 2, 65 / 75 / 2, 297 / 76 / 2, 158 / 77 / 2, 170 / 78 / 2, 52 / 79 / 5, 279 / 80 / 2, 258 / 81 / 3, 182 / 82 / 2, 282 / 83 / 2, 316 / 84 / 2, 105 / 85 / 2, 35 / 86 / 2, 208 / 87 / 2, 55 / 88 / 2, 94 / 89 / 2, 357 / 90 / 2, 25 / 91 / 2, 359 / 92 / 3, 198 / 93 / 2, 333 / 94 / 2, 334 / 95 / 2, 345 / 96 / 2, 293 / 97 / 2, 114 / 98 / 2, 111 / 99 / 3, 122 / 100 / 2, 219 / 101 / 3, 128 / 102 / 2, 218 / 103 / 2, 168 / 104 / 4, 262 / 105 / 2, 148 / 106 / 2, 324 / 107 / 3, 32 / 108 / 2, 342 / 109 / 2, 5 / 110 / 2, 115 / 111 / 3, 365 / 112 / 2, 155 / 113 / 2, 33 / 114 / 2, 180 / 115 / 2, 156 / 116 / 4, 93 / 117 / 2, 142 / 118 / 2, 136 / 119 / 2, 248 / 120 / 6, 15 / 121 / 2, 288 / 122 / 3, 373 / 123 / 2, 286 / 124 / 3, 242 / 125 / 2, 89 / 126 / 4, 326 / 127 / 2, 303 / 128 / 2, 165 / 129 / 3, 196 / 130 / 2, 368 / 131 / 4, 66 / 132 / 2, 363 / 133 / 2, 265 / 134 / 2, 332 / 135 / 2, 254 / 136 / 2, 135 / 137 / 2, 227 / 138 / 2, 323 / 139 / 2, 188 / 140 / 2, 71 / 141 / 2, 320 / 142 / 2, 13 / 143 / 2, 264 / 144 / 2, 200 / 145 / 5, 154 / 146 / 2, 18 / 147 / 3, 163 / 148 / 2, 95 / 149 / 2, 232 / 150 / 2, 296 / 151 / 2, 133 / 152 / 2, 9 / 153 / 4, 96 / 154 / 2, 1 / 155 / 3, 45 / 156 / 2, 187 / 157 / 3, 228 / 158 / 2, 214 / 159 / 3, 64 / 160 / 2, 349 / 161 / 2, 127 / 162 / 3, 291 / 163 / 2, 329 / 164 / 2, 339 / 165 / 2, 221 / 166 / 2, 151 / 167 / 3, 147 / 168 / 2, 251 / 169 / 4, 166 / 170 / 2, 75 / 171 / 2, 16 / 172 / 3, 243 / 173 / 2, 83 / 174 / 3, 17 / 175 / 2, 263 / 176 / 5, 309 / 177 / 2, 268 / 178 / 2, 271 / 179 / 2, 205 / 180 / 2, 49 / 181 / 3, 246 / 182 / 2, 31 / 183 / 2, 78 / 184 / 4, 240 / 185 / 2, 131 / 186 / 2, 119 / 187 / 2, 54 / 188 / 3, 138 / 189 / 2, 69 / 190 / 3, 193 / 191 / 2, 59 / 192 / 2, 308 / 193 / 2, 152 / 194 / 8, 141 / 195 / 2, 4 / 196 / 2, 195 / 197 / 2, 257 / 198 / 2, 215 / 199 / 3, 338 / 200 / 2, 223 / 201 / 3, 217 / 202 / 2, 2 / 203 / 3, 199 / 204 / 2, 202 / 205 / 2, 203 / 206 / 4, 92 / 207 / 2, 132 / 208 / 2, 213 / 209 / 3, 190 / 210 / 2, 210 / 211 / 2, 209 / 212 / 3, 307 / 213 / 2, 361 / 214 / 2, 298 / 215 / 2, 340 / 216 / 2, 81 / 217 / 3, 369 / 218 / 2, 58 / 219 / 3, 104 / 220 / 2, 176 / 221 / 2, 238 / 222 / 3, 21 / 223 / 2, 134 / 224 / 3, 330 / 225 / 2, 30 / 226 / 3, 226 / 227 / 2, 319 / 228 / 3, 23 / 229 / 2, 87 / 230 / 2, 270 / 231 / 2, 236 / 232 / 2, 144 / 233 / 2, 113 / 234 / 3, 347 / 235 / 2, 72 / 236 / 3, 130 / 237 / 2, 302 / 238 / 2, 206 / 239 / 3, 14 / 240 / 2, 313 / 241 / 3, 336 / 242 / 2, 6 / 243 / 2, 325 / 244 / 3, 84 / 245 / 2, 352 / 246 / 3, 117 / 247 / 2, 224 / 248 / 3, 186 / 249 / 2, 129 / 250 / 3, 280 / 251 / 2, 179 / 252 / 2, 41 / 253 / 3, 233 / 254 / 2, 222 / 255 / 3, 235 / 256 / 2, 124 / 257 / 2, 82 / 258 / 3, 100 / 259 / 2, 12 / 260 / 2, 140 / 261 / 5, 247 / 262 / 2, 204 / 263 / 2, 260 / 264 / 2, 237 / 265 / 2, 157 / 266 / 2, 290 / 267 / 3, 355 / 268 / 2, 272 / 269 / 2, 241 / 270 / 2, 86 / 271 / 2, 99 / 272 / 4, 159 / 273 / 2, 102 / 274 / 3, 88 / 275 / 2, 80 / 276 / 5, 126 / 277 / 2, 20 / 278 / 2, 321 / 279 / 2, 39 / 280 / 2, 273 / 281 / 3, 370 / 282 / 2, 337 / 283 / 2, 362 / 284 / 2, 234 / 285 / 2, 305 / 286 / 2, 42 / 287 / 3, 73 / 288 / 2, 108 / 289 / 2, 348 / 290 / 2, 123 / 291 / 4, 85 / 292 / 2, 143 / 293 / 3, 294 / 294 / 2, 211 / 295 / 3, 97 / 296 / 2, 310 / 297 / 2, 353 / 298 / 3, 153 / 299 / 2, 283 / 300 / 2, 67 / 301 / 2, 259 / 302 / 4, 110 / 303 / 2, 284 / 304 / 2, 344 / 305 / 3, 194 / 306 / 2, 28 / 307 / 2, 107 / 308 / 2, 10 / 309 / 2, 172 / 310 / 3, 189 / 311 / 2, 38 / 312 / 3, 269 / 313 / 2, 356 / 314 / 2, 27 / 315 / 3, 174 / 316 / 2, 192 / 317 / 3, 366 / 318 / 2, 149 / 319 / 2, 249 / 320 / 4, 306 / 321 / 2, 287 / 322 / 2, 56 / 323 / 2, 121 / 324 / 5, 212 / 325 / 2, 24 / 326 / 2, 184 / 327 / 3, 164 / 328 / 2, 34 / 329 / 3, 98 / 330 / 2, 311 / 331 / 2, 175 / 332 / 2, 145 / 333 / 5, 327 / 334 / 2, 358 / 335 / 3, 295 / 336 / 2, 239 / 337 / 2, 317 / 338 / 2, 29 / 339 / 2, 47 / 340 / 3, 371 / 341 / 2, 40 / 342 / 2, 37 / 343 / 2, 278 / 344 / 3, 167 / 345 / 2, 177 / 346 / 2, 322 / 347 / 2, 19 / 348 / 3, 285 / 349 / 2, 331 / 350 / 2, 304 / 351 / 5, 335 / 352 / 2, 53 / 353 / 3, 314 / 354 / 2, 74 / 355 / 2, 79 / 356 / 5, 61 / 357 / 2, 169 / 358 / 2, 3 / 359 / 2, 201 / 360 / 2, 22 / 361 / 2, 62 / 362 / 2, 216 / 363 / 2, 118 / 364 / 3, 183 / 365 / 2, 250 / 366 / 2, 185 / 367 / 3, 266 / 368 / 2, 146 / 369 / 2, 292 / 370 / 2, 63 / 371 / 2, 116 / 372 / 2, 26 / 373 / 2, 101 / 374 / 3
singlecenter-alpha_1-16-n6.txt, 1, 1, 6, 252.949, 26, 20, 4, 5,4 / 1 / 2, 5 / 2 / 4, 2 / 3 / 2, 3 / 4 / 2, 1 / 5 / 4
singlecenter-alpha_1-17-n375.txt, 1, 1, 375, 2543.31, 2754, 2379, 6, 374,274 / 1 / 2, 224 / 2 / 2, 161 / 3 / 3, 350 / 4 / 2, 80 / 5 / 2, 197 / 6 / 3, 163 / 7 / 2, 103 / 8 / 3, 76 / 9 / 2, 373 / 10 / 2, 108 / 11 / 3, 37 / 12 / 2, 51 / 13 / 2, 81 / 14 / 2, 276 / 15 / 2, 92 / 16 / 2, 227 / 17 / 3, 255 / 18 / 2, 309 / 19 / 3, 22 / 20 / 2, 241 / 21 / 4, 176 / 22 / 2, 194 / 23 / 2, 185 / 24 / 2, 336 / 25 / 4, 262 / 26 / 2, 164 / 27 / 2, 297 / 28 / 2, 91 / 29 / 2, 228 / 30 / 2, 306 / 31 / 4, 269 / 32 / 2, 356 / 33 / 2, 85 / 34 / 3, 315 / 35 / 2, 20 / 36 / 4, 121 / 37 / 2, 90 / 38 / 2, 371 / 39 / 3, 117 / 40 / 2, 169 / 41 / 2, 214 / 42 / 3, 361 / 43 / 2, 346 / 44 / 2, 337 / 45 / 2, 244 / 46 / 3, 349 / 47 / 2, 42 / 48 / 6, 180 / 49 / 2, 353 / 50 / 2, 202 / 51 / 2, 307 / 52 / 2, 239 / 53 / 2, 247 / 54 / 3, 162 / 55 / 2, 204 / 56 / 3, 45 / 57 / 2, 273 / 58 / 2, 319 / 59 / 2, 261 / 60 / 2, 369 / 61 / 2, 44 / 62 / 2, 41 / 63 / 4, 166 / 64 / 2, 1 / 65 / 2, 140 / 66 / 3, 231 / 67 / 2, 57 / 68 / 2, 147 / 69 / 2, 316 / 70 / 4, 235 / 71 / 2, 68 / 72 / 2, 246 / 73 / 2, 285 / 74 / 4, 98 / 75 / 2, 186 / 76 / 3, 138 / 77 / 2, 181 / 78 / 3, 139 / 79 / 2, 26 / 80 / 2, 75 / 81 / 5, 23 / 82 / 2, 19 / 83 / 2, 93 / 84 / 3, 201 / 85 / 2, 31 / 86 / 2, 24 / 87 / 3, 146 / 88 / 2, 328 / 89 / 2, 177 / 90 / 2, 322 / 91 / 3, 160 / 92 / 2, 192 / 93 / 5, 252 / 94 / 2, 137 / 95 / 2, 208 / 96 / 2, 6 / 97 / 4, 223 / 98 / 2, 49 / 99 / 2, 332 / 100 / 3, 40 / 101 / 2, 266 / 102 / 2, 267 / 103 / 2, 312 / 104 / 3, 344 / 105 / 2, 8 / 106 / 2, 132 / 107 / 3, 229 / 108 / 2, 203 / 109 / 2, 362 / 110 / 4, 74 / 111 / 2, 61 / 112 / 2, 3 / 113 / 3, 94 / 114 / 2, 131 / 115 / 3, 104 / 116 / 2, 25 / 117 / 2, 338 / 118 / 4, 134 / 119 / 2, 120 / 120 / 2, 207 / 121 / 3, 254 / 122 / 2, 374 / 123 / 3, 278 / 124 / 2, 153 / 125 / 3, 148 / 126 / 2, 28 / 127 / 2, 234 / 128 / 2, 341 / 129 / 2, 209 / 130 / 3, 333 / 131 / 2, 78 / 132 / 2, 233 / 133 / 2, 154 / 134 / 2, 155 / 135 / 2, 368 / 136 / 2, 189 / 137 / 4, 272 / 138 / 2, 73 / 139 / 2, 106 / 140 / 4, 303 / 141 / 2, 326 / 142 / 2, 124 / 143 / 2, 212 / 144 / 2, 170 / 145 / 3, 225 / 146 / 2, 300 / 147 / 2, 35 / 148 / 3, 183 / 149 / 2, 221 / 150 / 3, 308 / 151 / 2, 71 / 152 / 4, 69 / 153 / 2, 271 / 154 / 2, 16 / 155 / 2, 178 / 156 / 5, 216 / 157 / 2, 95 / 158 / 2, 299 / 159 / 2, 345 / 160 / 5, 230 / 161 / 2, 358 / 162 / 3, 320 / 163 / 2, 113 / 164 / 3, 222 / 165 / 2, 190 / 166 / 2, 290 / 167 / 4, 366 / 168 / 2, 248 / 169 / 2, 313 / 170 / 3, 339 / 171 / 2, 324 / 172 / 2, 165 / 173 / 3, 4 / 174 / 2, 268 / 175 / 3, 360 / 176 / 2, 5 / 177 / 2, 367 / 178 / 2, 296 / 179 / 2, 206 / 180 / 2, 168 / 181 / 4, 34 / 182 / 2, 56 / 183 / 2, 334 / 184 / 2, 301 / 185 / 3, 30 / 186 / 2, 10 / 187 / 2, 111 / 188 / 3, 217 / 189 / 2, 286 / 190 / 2, 277 / 191 / 2, 340 / 192 / 3, 211 / 193 / 2, 128 / 194 / 3, 210 / 195 / 2, 33 / 196 / 2, 305 / 197 / 3, 259 / 198 / 2, 63 / 199 / 2, 107 / 200 / 2, 265 / 201 / 3, 284 / 202 / 2, 115 / 203 / 3, 127 / 204 / 2, 260 / 205 / 2, 48 / 206 / 2, 55 / 207 / 2, 251 / 208 / 2, 188 / 209 / 2, 243 / 210 / 5, 125 / 211 / 2, 38 / 212 / 3, 257 / 213 / 2, 96 / 214 / 4, 60 / 215 / 2, 144 / 216 / 2, 318 / 217 / 2, 173 / 218 / 2, 291 / 219 / 2, 218 / 220 / 3, 109 / 221 / 2, 372 / 222 / 3, 359 / 223 / 2, 275 / 224 / 3, 7 / 225 / 2, 27 / 226 / 2, 263 / 227 / 2, 102 / 228 / 3, 133 / 229 / 2, 86 / 230 / 3, 351 / 231 / 2, 105 / 232 / 2, 21 / 233 / 2, 191 / 234 / 3, 114 / 235 / 2, 205 / 236 / 2, 70 / 237 / 2, 184 / 238 / 3, 66 / 239 / 2, 145 / 240 / 3, 365 / 241 / 2, 352 / 242 / 2, 310 / 243 / 2, 270 / 244 / 2, 54 / 245 / 2, 82 / 246 / 2, 198 / 247 / 2, 99 / 248 / 2, 364 / 249 / 3, 39 / 250 / 2, 141 / 251 / 2, 135 / 252 / 4, 295 / 253 / 2, 89 / 254 / 2, 62 / 255 / 2, 343 / 256 / 3, 101 / 257 / 2, 87 / 258 / 3, 342 / 259 / 2, 283 / 260 / 2, 175 / 261 / 2, 172 / 262 / 2, 118 / 263 / 3, 321 / 264 / 2, 149 / 265 / 3, 213 / 266 / 2, 331 / 267 / 3, 317 / 268 / 2, 58 / 269 / 3, 330 / 270 / 2, 129 / 271 / 4, 72 / 272 / 2, 130 / 273 / 2, 302 / 274 / 3, 347 / 275 / 2, 280 / 276 / 2, 314 / 277 / 2, 187 / 278 / 3, 152 / 279 / 2, 53 / 280 / 3, 12 / 281 / 2, 226 / 282 / 2, 174 / 283 / 2, 97 / 284 / 3, 335 / 285 / 2, 237 / 286 / 3, 77 / 287 / 2, 122 / 288 / 2, 287 / 289 / 2, 355 / 290 / 2, 156 / 291 / 2, 59 / 292 / 2, 199 / 293 / 4, 29 / 294 / 2, 348 / 295 / 2, 196 / 296 / 2, 242 / 297 / 4, 182 / 298 / 2, 159 / 299 / 2, 279 / 300 / 2, 354 / 301 / 2, 15 / 302 / 3, 236 / 303 / 2, 238 / 304 / 3, 14 / 305 / 2, 9 / 306 / 3, 18 / 307 / 2, 370 / 308 / 2, 110 / 309 / 2, 142 / 310 / 2, 288 / 311 / 2, 123 / 312 / 2, 195 / 313 / 2, 250 / 314 / 4, 323 / 315 / 2, 64 / 316 / 2, 264 / 317 / 2, 329 / 318 / 2, 245 / 319 / 2, 200 / 320 / 4, 119 / 321 / 2, 157 / 322 / 2, 2 / 323 / 3, 298 / 324 / 2, 171 / 325 / 2, 50 / 326 / 2, 79 / 327 / 3, 325 / 328 / 2, 52 / 329 / 2, 143 / 330 / 2, 281 / 331 / 2, 293 / 332 / 2, 65 / 333 / 2, 84 / 334 / 3, 151 / 335 / 2, 249 / 336 / 2, 219 / 337 / 2, 179 / 338 / 3, 327 / 339 / 2, 357 / 340 / 2, 258 / 341 / 3, 83 / 342 / 2, 11 / 343 / 2, 88 / 344 / 6, 43 / 345 / 2, 311 / 346 / 2, 289 / 347 / 2, 47 / 348 / 2, 240 / 349 / 2, 46 / 350 / 4, 112 / 351 / 2, 292 / 352 / 2, 150 / 353 / 4, 100 / 354 / 2, 304 / 355 / 2, 253 / 356 / 4, 36 / 357 / 2, 294 / 358 / 2, 193 / 359 / 2, 256 / 360 / 2, 167 / 361 / 3, 32 / 362 / 2, 282 / 363 / 3, 232 / 364 / 2, 136 / 365 / 2, 126 / 366 / 2, 220 / 367 / 4, 13 / 368 / 2, 17 / 369 / 3, 158 / 370 / 2, 67 / 371 / 3, 363 / 372 / 2, 215 / 373 / 3, 116 / 374 / 2
singlecenter-alpha_1-17-n6.txt, 1, 1, 6, 543.347, 24, 18, 4, 5,3 / 1 / 4, 2 / 2 / 2, 5 / 3 / 2, 4 / 4 / 3, 1 / 5 / 2
singlecenter-alpha_1-18-n375.txt, 1, 1, 375, 2831.77, 3109, 2734, 9, 374,162 / 1 / 2, 222 / 2 / 3, 176 / 3 / 2, 189 / 4 / 2, 42 / 5 / 2, 262 / 6 / 2, 206 / 7 / 2, 40 / 8 / 2, 129 / 9 / 2, 132 / 10 / 3, 41 / 11 / 2, 191 / 12 / 7, 328 / 13 / 2, 280 / 14 / 3, 237 / 15 / 2, 342 / 16 / 2, 57 / 17 / 2, 264 / 18 / 2, 123 / 19 / 3, 213 / 20 / 2, 243 / 21 / 3, 348 / 22 / 2, 198 / 23 / 4, 53 / 24 / 2, 357 / 25 / 2, 283 / 26 / 2, 261 / 27 / 7, 196 / 28 / 2, 111 / 29 / 2, 43 / 30 / 2, 304 / 31 / 2, 299 / 32 / 2, 170 / 33 / 3, 148 / 34 / 2, 245 / 35 / 3, 285 / 36 / 2, 7 / 37 / 3, 2 / 38 / 2, 239 / 39 / 2, 44 / 40 / 3, 28 / 41 / 2, 80 / 42 / 2, 54 / 43 / 2, 227 / 44 / 3, 51 / 45 / 2, 71 / 46 / 2, 11 / 47 / 2, 65 / 48 / 5, 134 / 49 / 2, 279 / 50 / 2, 178 / 51 / 2, 293 / 52 / 5, 225 / 53 / 2, 205 / 54 / 3, 67 / 55 / 2, 353 / 56 / 2, 281 / 57 / 2, 292 / 58 / 2, 347 / 59 / 3, 352 / 60 / 2, 173 / 61 / 3, 179 / 62 / 2, 305 / 63 / 2, 75 / 64 / 3, 104 / 65 / 2, 118 / 66 / 2, 46 / 67 / 2, 78 / 68 / 3, 296 / 69 / 2, 327 / 70 / 2, 169 / 71 / 2, 215 / 72 / 4, 326 / 73 / 2, 366 / 74 / 2, 275 / 75 / 2, 263 / 76 / 2, 19 / 77 / 4, 207 / 78 / 2, 334 / 79 / 2, 265 / 80 / 4, 312 / 81 / 2, 105 / 82 / 3, 202 / 83 / 2, 291 / 84 / 2, 61 / 85 / 3, 31 / 86 / 2, 99 / 87 / 3, 133 / 88 / 2, 356 / 89 / 2, 199 / 90 / 2, 27 / 91 / 2, 83 / 92 / 2, 360 / 93 / 2, 346 / 94 / 3, 371 / 95 / 2, 142 / 96 / 3, 317 / 97 / 2, 165 / 98 / 4, 259 / 99 / 2, 116 / 100 / 2, 313 / 101 / 2, 374 / 102 / 2, 146 / 103 / 3, 22 / 104 / 2, 181 / 105 / 2, 337 / 106 / 2, 242 / 107 / 3, 50 / 108 / 2, 158 / 109 / 3, 107 / 110 / 2, 212 / 111 / 2, 144 / 112 / 2, 238 / 113 / 5, 322 / 114 / 2, 149 / 115 / 2, 216 / 116 / 2, 210 / 117 / 2, 166 / 118 / 2, 185 / 119 / 4, 310 / 120 / 2, 137 / 121 / 2, 82 / 122 / 4, 20 / 123 / 2, 315 / 124 / 2, 244 / 125 / 2, 16 / 126 / 4, 332 / 127 / 2, 335 / 128 / 3, 220 / 129 / 2, 33 / 130 / 2, 336 / 131 / 3, 139 / 132 / 2, 217 / 133 / 3, 221 / 134 / 2, 314 / 135 / 3, 73 / 136 / 2, 247 / 137 / 2, 226 / 138 / 2, 355 / 139 / 2, 96 / 140 / 4, 287 / 141 / 2, 70 / 142 / 2, 145 / 143 / 2, 32 / 144 / 2, 38 / 145 / 4, 343 / 146 / 2, 52 / 147 / 2, 235 / 148 / 4, 354 / 149 / 2, 274 / 150 / 2, 4 / 151 / 2, 108 / 152 / 2, 349 / 153 / 3, 316 / 154 / 2, 359 / 155 / 3, 24 / 156 / 2, 193 / 157 / 2, 126 / 158 / 2, 121 / 159 / 2, 272 / 160 / 3, 194 / 161 / 2, 172 / 162 / 2, 362 / 163 / 3, 323 / 164 / 2, 159 / 165 / 3, 91 / 166 / 2, 143 / 167 / 2, 330 / 168 / 3, 92 / 169 / 2, 201 / 170 / 3, 6 / 171 / 2, 321 / 172 / 3, 372 / 173 / 2, 276 / 174 / 2, 231 / 175 / 3, 124 / 176 / 2, 223 / 177 / 2, 306 / 178 / 3, 290 / 179 / 2, 153 / 180 / 2, 308 / 181 / 2, 138 / 182 / 2, 367 / 183 / 2, 135 / 184 / 5, 288 / 185 / 2, 128 / 186 / 2, 55 / 187 / 4, 186 / 188 / 2, 171 / 189 / 2, 277 / 190 / 2, 203 / 191 / 3, 59 / 192 / 2, 269 / 193 / 2, 309 / 194 / 2, 155 / 195 / 2, 246 / 196 / 2, 36 / 197 / 3, 21 / 198 / 2, 229 / 199 / 2, 56 / 200 / 3, 270 / 201 / 2, 224 / 202 / 3, 125 / 203 / 2, 48 / 204 / 3, 267 / 205 / 2, 151 / 206 / 2, 76 / 207 / 3, 228 / 208 / 2, 62 / 209 / 2, 320 / 210 / 2, 204 / 211 / 5, 266 / 212 / 2, 175 / 213 / 2, 94 / 214 / 2, 211 / 215 / 4, 297 / 216 / 2, 34 / 217 / 2, 39 / 218 / 2, 88 / 219 / 2, 295 / 220 / 5, 257 / 221 / 2, 9 / 222 / 3, 131 / 223 / 2, 15 / 224 / 3, 37 / 225 / 2, 164 / 226 / 5, 307 / 227 / 2, 64 / 228 / 3, 180 / 229 / 2, 273 / 230 / 3, 30 / 231 / 2, 160 / 232 / 3, 268 / 233 / 2, 110 / 234 / 3, 101 / 235 / 2, 86 / 236 / 2, 341 / 237 / 2, 350 / 238 / 2, 66 / 239 / 2, 77 / 240 / 2, 329 / 241 / 2, 183 / 242 / 2, 364 / 243 / 3, 338 / 244 / 2, 363 / 245 / 2, 89 / 246 / 3, 369 / 247 / 2, 192 / 248 / 2, 190 / 249 / 3, 248 / 250 / 2, 258 / 251 / 2, 233 / 252 / 4, 58 / 253 / 2, 370 / 254 / 3, 102 / 255 / 2, 152 / 256 / 2, 345 / 257 / 2, 90 / 258 / 4, 260 / 259 / 2, 63 / 260 / 2, 300 / 261 / 3, 1 / 262 / 2, 319 / 263 / 2, 249 / 264 / 3, 69 / 265 / 2, 85 / 266 / 2, 79 / 267 / 2, 232 / 268 / 6, 187 / 269 / 2, 154 / 270 / 2, 93 / 271 / 4, 100 / 272 / 2, 302 / 273 / 2, 253 / 274 / 2, 331 / 275 / 3, 256 / 276 / 2, 35 / 277 / 3, 289 / 278 / 2, 254 / 279 / 2, 373 / 280 / 3, 351 / 281 / 2, 136 / 282 / 2, 250 / 283 / 2, 49 / 284 / 9, 234 / 285 / 2, 214 / 286 / 2, 106 / 287 / 3, 120 / 288 / 2, 188 / 289 / 2, 339 / 290 / 2, 365 / 291 / 3, 325 / 292 / 2, 252 / 293 / 4, 163 / 294 / 2, 282 / 295 / 3, 219 / 296 / 2, 156 / 297 / 2, 197 / 298 / 2, 161 / 299 / 2, 368 / 300 / 2, 298 / 301 / 4, 98 / 302 / 2, 119 / 303 / 2, 113 / 304 / 3, 318 / 305 / 2, 358 / 306 / 3, 209 / 307 / 2, 18 / 308 / 2, 361 / 309 / 2, 157 / 310 / 2, 130 / 311 / 2, 184 / 312 / 2, 230 / 313 / 3, 168 / 314 / 2, 127 / 315 / 3, 23 / 316 / 2, 182 / 317 / 3, 303 / 318 / 2, 29 / 319 / 3, 218 / 320 / 2, 340 / 321 / 3, 13 / 322 / 2, 8 / 323 / 2, 81 / 324 / 2, 167 / 325 / 2, 174 / 326 / 2, 301 / 327 / 5, 271 / 328 / 2, 95 / 329 / 2, 97 / 330 / 2, 333 / 331 / 5, 12 / 332 / 2, 84 / 333 / 2, 311 / 334 / 4, 112 / 335 / 2, 115 / 336 / 2, 10 / 337 / 3, 5 / 338 / 2, 141 / 339 / 4, 3 / 340 / 2, 68 / 341 / 2, 286 / 342 / 3, 74 / 343 / 2, 60 / 344 / 3, 251 / 345 / 2, 150 / 346 / 2, 25 / 347 / 3, 241 / 348 / 2, 240 / 349 / 3, 109 / 350 / 2, 294 / 351 / 2, 344 / 352 / 3, 14 / 353 / 2, 122 / 354 / 2, 236 / 355 / 3, 208 / 356 / 2, 114 / 357 / 3, 177 / 358 / 2, 195 / 359 / 3, 117 / 360 / 2, 278 / 361 / 3, 147 / 362 / 2, 200 / 363 / 2, 47 / 364 / 3, 255 / 365 / 2, 324 / 366 / 2, 87 / 367 / 3, 284 / 368 / 2, 140 / 369 / 2, 72 / 370 / 3, 45 / 371 / 2, 103 / 372 / 2, 26 / 373 / 4, 17 / 374 / 2
singlecenter-alpha_1-18-n6.txt, 1, 1, 6, 451.076, 23, 17, 3, 5,5 / 1 / 2, 4 / 2 / 2, 1 / 3 / 2, 3 / 4 / 2, 2 / 5 / 3
singlecenter-alpha_1-19-n375.txt, 1, 1, 375, 2672.1, 2768, 2393, 8, 374,20 / 1 / 2, 285 / 2 / 2, 187 / 3 / 3, 257 / 4 / 2, 40 / 5 / 2, 322 / 6 / 3, 372 / 7 / 2, 121 / 8 / 2, 3 / 9 / 3, 338 / 10 / 2, 351 / 11 / 2, 116 / 12 / 3, 319 / 13 / 2, 89 / 14 / 2, 225 / 15 / 4, 222 / 16 / 2, 173 / 17 / 2, 30 / 18 / 3, 289 / 19 / 2, 230 / 20 / 3, 237 / 21 / 2, 36 / 22 / 4, 341 / 23 / 2, 35 / 24 / 3, 112 / 25 / 2, 290 / 26 / 2, 360 / 27 / 2, 157 / 28 / 3, 287 / 29 / 2, 345 / 30 / 3, 295 / 31 / 2, 94 / 32 / 3, 181 / 33 / 2, 71 / 34 / 3, 128 / 35 / 2, 79 / 36 / 2, 266 / 37 / 3, 69 / 38 / 2, 240 / 39 / 2, 336 / 40 / 2, 168 / 41 / 2, 320 / 42 / 3, 256 / 43 / 2, 134 / 44 / 3, 149 / 45 / 2, 162 / 46 / 2, 141 / 47 / 3, 232 / 48 / 2, 85 / 49 / 2, 331 / 50 / 3, 167 / 51 / 2, 217 / 52 / 2, 311 / 53 / 2, 84 / 54 / 2, 373 / 55 / 2, 305 / 56 / 3, 41 / 57 / 2, 292 / 58 / 2, 248 / 59 / 2, 28 / 60 / 2, 46 / 61 / 3, 190 / 62 / 2, 371 / 63 / 3, 8 / 64 / 2, 300 / 65 / 2, 210 / 66 / 3, 316 / 67 / 2, 243 / 68 / 2, 97 / 69 / 3, 361 / 70 / 2, 114 / 71 / 2, 245 / 72 / 2, 74 / 73 / 2, 374 / 74 / 2, 129 / 75 / 2, 357 / 76 / 2, 124 / 77 / 2, 136 / 78 / 2, 212 / 79 / 2, 199 / 80 / 2, 109 / 81 / 4, 177 / 82 / 2, 49 / 83 / 2, 277 / 84 / 2, 26 / 85 / 2, 215 / 86 / 2, 234 / 87 / 2, 195 / 88 / 2, 53 / 89 / 2, 56 / 90 / 2, 106 / 91 / 2, 183 / 92 / 2, 156 / 93 / 2, 174 / 94 / 2, 346 / 95 / 3, 126 / 96 / 2, 296 / 97 / 2, 204 / 98 / 4, 247 / 99 / 2, 6 / 100 / 2, 21 / 101 / 2, 172 / 102 / 2, 146 / 103 / 3, 261 / 104 / 2, 274 / 105 / 2, 366 / 106 / 2, 288 / 107 / 3, 332 / 108 / 2, 139 / 109 / 2, 143 / 110 / 2, 314 / 111 / 3, 339 / 112 / 2, 52 / 113 / 2, 327 / 114 / 4, 150 / 115 / 2, 209 / 116 / 2, 34 / 117 / 3, 82 / 118 / 2, 218 / 119 / 5, 224 / 120 / 2, 226 / 121 / 3, 91 / 122 / 2, 22 / 123 / 2, 200 / 124 / 2, 302 / 125 / 2, 29 / 126 / 2, 325 / 127 / 2, 201 / 128 / 4, 208 / 129 / 2, 145 / 130 / 2, 64 / 131 / 2, 107 / 132 / 2, 101 / 133 / 3, 185 / 134 / 2, 67 / 135 / 3, 166 / 136 / 2, 321 / 137 / 2, 253 / 138 / 3, 63 / 139 / 2, 133 / 140 / 2, 113 / 141 / 2, 123 / 142 / 2, 66 / 143 / 3, 279 / 144 / 2, 31 / 145 / 3, 92 / 146 / 2, 317 / 147 / 4, 192 / 148 / 2, 244 / 149 / 2, 137 / 150 / 2, 47 / 151 / 2, 142 / 152 / 3, 191 / 153 / 2, 356 / 154 / 2, 86 / 155 / 2, 155 / 156 / 2, 194 / 157 / 2, 353 / 158 / 5, 333 / 159 / 2, 83 / 160 / 3, 220 / 161 / 2, 179 / 162 / 2, 298 / 163 / 3, 312 / 164 / 2, 307 / 165 / 3, 144 / 166 / 2, 159 / 167 / 2, 267 / 168 / 2, 297 / 169 / 2, 184 / 170 / 2, 254 / 171 / 2, 76 / 172 / 2, 189 / 173 / 3, 43 / 174 / 2, 48 / 175 / 3, 329 / 176 / 2, 294 / 177 / 6, 286 / 178 / 2, 5 / 179 / 2, 310 / 180 / 3, 228 / 181 / 2, 78 / 182 / 2, 216 / 183 / 2, 90 / 184 / 3, 231 / 185 / 2, 186 / 186 / 2, 175 / 187 / 2, 10 / 188 / 2, 263 / 189 / 3, 138 / 190 / 2, 54 / 191 / 3, 337 / 192 / 2, 259 / 193 / 3, 291 / 194 / 2, 233 / 195 / 2, 93 / 196 / 2, 131 / 197 / 2, 33 / 198 / 4, 268 / 199 / 2, 75 / 200 / 2, 98 / 201 / 2, 301 / 202 / 2, 103 / 203 / 2, 23 / 204 / 2, 280 / 205 / 2, 4 / 206 / 3, 211 / 207 / 2, 115 / 208 / 3, 70 / 209 / 2, 55 / 210 / 2, 251 / 211 / 2, 44 / 212 / 2, 334 / 213 / 3, 262 / 214 / 2, 58 / 215 / 2, 164 / 216 / 2, 135 / 217 / 2, 255 / 218 / 3, 105 / 219 / 2, 348 / 220 / 3, 241 / 221 / 2, 182 / 222 / 3, 132 / 223 / 2, 326 / 224 / 2, 11 / 225 / 2, 16 / 226 / 2, 80 / 227 / 2, 213 / 228 / 2, 62 / 229 / 3, 368 / 230 / 2, 140 / 231 / 3, 59 / 232 / 2, 235 / 233 / 3, 299 / 234 / 2, 99 / 235 / 2, 171 / 236 / 3, 57 / 237 / 2, 342 / 238 / 2, 45 / 239 / 2, 223 / 240 / 4, 42 / 241 / 2, 1 / 242 / 2, 118 / 243 / 2, 180 / 244 / 4, 229 / 245 / 2, 196 / 246 / 2, 362 / 247 / 8, 273 / 248 / 2, 246 / 249 / 3, 260 / 250 / 2, 318 / 251 / 4, 193 / 252 / 2, 27 / 253 / 2, 309 / 254 / 3, 214 / 255 / 2, 202 / 256 / 2, 369 / 257 / 2, 161 / 258 / 3, 352 / 259 / 2, 32 / 260 / 2, 147 / 261 / 3, 227 / 262 / 2, 282 / 263 / 2, 221 / 264 / 3, 203 / 265 / 2, 206 / 266 / 2, 340 / 267 / 3, 130 / 268 / 2, 153 / 269 / 2, 364 / 270 / 2, 77 / 271 / 3, 178 / 272 / 2, 315 / 273 / 2, 236 / 274 / 3, 160 / 275 / 2, 87 / 276 / 3, 125 / 277 / 2, 313 / 278 / 2, 14 / 279 / 2, 270 / 280 / 3, 355 / 281 / 2, 284 / 282 / 2, 335 / 283 / 4, 365 / 284 / 2, 154 / 285 / 2, 205 / 286 / 2, 265 / 287 / 2, 252 / 288 / 2, 127 / 289 / 3, 151 / 290 / 2, 354 / 291 / 3, 39 / 292 / 2, 19 / 293 / 5, 249 / 294 / 2, 367 / 295 / 3, 250 / 296 / 2, 17 / 297 / 3, 119 / 298 / 2, 120 / 299 / 2, 197 / 300 / 3, 148 / 301 / 2, 239 / 302 / 3, 304 / 303 / 2, 303 / 304 / 2, 276 / 305 / 3, 165 / 306 / 2, 73 / 307 / 2, 272 / 308 / 2, 207 / 309 / 3, 176 / 310 / 2, 370 / 311 / 3, 264 / 312 / 2, 25 / 313 / 2, 271 / 314 / 3, 13 / 315 / 2, 269 / 316 / 3, 188 / 317 / 2, 72 / 318 / 3, 12 / 319 / 2, 281 / 320 / 2, 349 / 321 / 3, 170 / 322 / 2, 158 / 323 / 3, 283 / 324 / 2, 344 / 325 / 2, 330 / 326 / 4, 347 / 327 / 2, 50 / 328 / 2, 104 / 329 / 4, 359 / 330 / 2, 88 / 331 / 2, 24 / 332 / 3, 358 / 333 / 2, 323 / 334 / 4, 198 / 335 / 2, 152 / 336 / 2, 278 / 337 / 4, 163 / 338 / 2, 308 / 339 / 3, 9 / 340 / 2, 111 / 341 / 2, 108 / 342 / 2, 219 / 343 / 2, 169 / 344 / 2, 65 / 345 / 2, 100 / 346 / 2, 117 / 347 / 2, 81 / 348 / 3, 324 / 349 / 2, 350 / 350 / 2, 238 / 351 / 3, 7 / 352 / 2, 38 / 353 / 3, 306 / 354 / 2, 95 / 355 / 2, 293 / 356 / 3, 343 / 357 / 2, 2 / 358 / 2, 242 / 359 / 2, 37 / 360 / 4, 18 / 361 / 2, 15 / 362 / 2, 110 / 363 / 2, 61 / 364 / 3, 363 / 365 / 2, 60 / 366 / 4, 68 / 367 / 2, 328 / 368 / 2, 258 / 369 / 2, 102 / 370 / 2, 96 / 371 / 2, 122 / 372 / 2, 275 / 373 / 2, 51 / 374 / 4
singlecenter-alpha_1-19-n6.txt, 1, 1, 6, 298.648, 24, 18, 4, 5,3 / 1 / 2, 2 / 2 / 2, 4 / 3 / 2, 1 / 4 / 2, 5 / 5 / 4
singlecenter-alpha_1-2-n250.txt, 1, 1, 250, 2239.62, 1934, 1684, 6, 249,157 / 1 / 2, 67 / 2 / 3, 140 / 3 / 2, 240 / 4 / 3, 100 / 5 / 2, 22 / 6 / 2, 62 / 7 / 3, 224 / 8 / 2, 147 / 9 / 3, 213 / 10 / 2, 178 / 11 / 2, 56 / 12 / 2, 5 / 13 / 3, 146 / 14 / 2, 37 / 15 / 2, 170 / 16 / 2, 49 / 17 / 2, 86 / 18 / 2, 79 / 19 / 2, 84 / 20 / 3, 234 / 21 / 2, 115 / 22 / 4, 217 / 23 / 2, 180 / 24 / 2, 216 / 25 / 2, 181 / 26 / 3, 246 / 27 / 2, 63 / 28 / 2, 125 / 29 / 2, 12 / 30 / 2, 30 / 31 / 5, 29 / 32 / 2, 35 / 33 / 3, 80 / 34 / 2, 201 / 35 / 2, 144 / 36 / 2, 71 / 37 / 3, 19 / 38 / 2, 112 / 39 / 3, 81 / 40 / 2, 192 / 41 / 2, 111 / 42 / 2, 50 / 43 / 3, 93 / 44 / 2, 120 / 45 / 3, 102 / 46 / 2, 129 / 47 / 2, 172 / 48 / 2, 99 / 49 / 2, 136 / 50 / 2, 45 / 51 / 2, 85 / 52 / 2, 106 / 53 / 2, 239 / 54 / 3, 18 / 55 / 2, 32 / 56 / 2, 222 / 57 / 3, 152 / 58 / 2, 160 / 59 / 2, 28 / 60 / 2, 221 / 61 / 4, 51 / 62 / 2, 236 / 63 / 3, 218 / 64 / 2, 247 / 65 / 3, 208 / 66 / 2, 36 / 67 / 3, 227 / 68 / 2, 87 / 69 / 2, 88 / 70 / 2, 209 / 71 / 3, 197 / 72 / 2, 133 / 73 / 2, 143 / 74 / 4, 232 / 75 / 2, 94 / 76 / 2, 104 / 77 / 3, 196 / 78 / 2, 245 / 79 / 2, 223 / 80 / 2, 134 / 81 / 2, 183 / 82 / 4, 184 / 83 / 2, 3 / 84 / 2, 159 / 85 / 3, 66 / 86 / 2, 7 / 87 / 2, 179 / 88 / 2, 61 / 89 / 2, 229 / 90 / 3, 161 / 91 / 2, 46 / 92 / 2, 14 / 93 / 3, 17 / 94 / 2, 109 / 95 / 3, 248 / 96 / 2, 176 / 97 / 3, 76 / 98 / 2, 41 / 99 / 3, 215 / 100 / 2, 137 / 101 / 2, 58 / 102 / 2, 96 / 103 / 4, 118 / 104 / 2, 2 / 105 / 2, 135 / 106 / 3, 73 / 107 / 2, 13 / 108 / 2, 9 / 109 / 2, 151 / 110 / 3, 128 / 111 / 2, 242 / 112 / 3, 148 / 113 / 2, 182 / 114 / 4, 153 / 115 / 2, 4 / 116 / 2, 131 / 117 / 2, 174 / 118 / 2, 226 / 119 / 3, 165 / 120 / 2, 10 / 121 / 2, 27 / 122 / 4, 110 / 123 / 2, 154 / 124 / 2, 238 / 125 / 3, 11 / 126 / 2, 43 / 127 / 2, 105 / 128 / 2, 75 / 129 / 5, 177 / 130 / 2, 68 / 131 / 2, 47 / 132 / 3, 230 / 133 / 2, 186 / 134 / 2, 193 / 135 / 3, 117 / 136 / 2, 175 / 137 / 5, 31 / 138 / 2, 42 / 139 / 2, 156 / 140 / 2, 243 / 141 / 5, 40 / 142 / 2, 15 / 143 / 2, 77 / 144 / 2, 142 / 145 / 4, 130 / 146 / 2, 167 / 147 / 2, 65 / 148 / 3, 237 / 149 / 2, 166 / 150 / 3, 168 / 151 / 2, 187 / 152 / 2, 1 / 153 / 3, 145 / 154 / 2, 55 / 155 / 2, 163 / 156 / 2, 191 / 157 / 2, 59 / 158 / 2, 72 / 159 / 4, 185 / 160 / 2, 225 / 161 / 2, 214 / 162 / 3, 52 / 163 / 2, 122 / 164 / 3, 53 / 165 / 2, 155 / 166 / 3, 82 / 167 / 2, 139 / 168 / 2, 26 / 169 / 3, 90 / 170 / 2, 60 / 171 / 4, 103 / 172 / 2, 171 / 173 / 3, 89 / 174 / 2, 244 / 175 / 2, 48 / 176 / 3, 8 / 177 / 2, 150 / 178 / 3, 95 / 179 / 2, 204 / 180 / 2, 198 / 181 / 2, 92 / 182 / 3, 44 / 183 / 2, 212 / 184 / 3, 64 / 185 / 2, 124 / 186 / 2, 97 / 187 / 4, 34 / 188 / 2, 220 / 189 / 2, 25 / 190 / 2, 195 / 191 / 2, 126 / 192 / 6, 101 / 193 / 2, 173 / 194 / 2, 141 / 195 / 2, 113 / 196 / 2, 231 / 197 / 3, 78 / 198 / 2, 190 / 199 / 2, 149 / 200 / 2, 219 / 201 / 4, 211 / 202 / 2, 228 / 203 / 3, 114 / 204 / 2, 249 / 205 / 3, 132 / 206 / 2, 23 / 207 / 2, 70 / 208 / 2, 98 / 209 / 2, 108 / 210 / 3, 91 / 211 / 2, 74 / 212 / 2, 169 / 213 / 3, 189 / 214 / 2, 116 / 215 / 2, 69 / 216 / 2, 38 / 217 / 2, 33 / 218 / 2, 206 / 219 / 4, 210 / 220 / 2, 203 / 221 / 3, 83 / 222 / 2, 107 / 223 / 2, 202 / 224 / 3, 20 / 225 / 2, 205 / 226 / 2, 123 / 227 / 3, 199 / 228 / 2, 39 / 229 / 3, 194 / 230 / 2, 188 / 231 / 3, 162 / 232 / 2, 138 / 233 / 3, 24 / 234 / 2, 158 / 235 / 2, 16 / 236 / 2, 6 / 237 / 3, 119 / 238 / 2, 164 / 239 / 5, 21 / 240 / 2, 54 / 241 / 3, 127 / 242 / 2, 241 / 243 / 3, 200 / 244 / 2, 207 / 245 / 2, 235 / 246 / 2, 121 / 247 / 2, 57 / 248 / 4, 233 / 249 / 2
singlecenter-alpha_1-2-n375.txt, 1, 1, 375, 2715.74, 3068, 2693, 9, 374,162 / 1 / 3, 25 / 2 / 2, 324 / 3 / 2, 251 / 4 / 2, 297 / 5 / 2, 42 / 6 / 2, 188 / 7 / 3, 83 / 8 / 2, 340 / 9 / 2, 372 / 10 / 5, 319 / 11 / 2, 331 / 12 / 2, 115 / 13 / 3, 117 / 14 / 2, 186 / 15 / 2, 151 / 16 / 3, 100 / 17 / 2, 173 / 18 / 3, 80 / 19 / 2, 70 / 20 / 2, 318 / 21 / 2, 238 / 22 / 9, 264 / 23 / 2, 351 / 24 / 2, 215 / 25 / 2, 120 / 26 / 2, 290 / 27 / 2, 373 / 28 / 2, 7 / 29 / 2, 94 / 30 / 2, 222 / 31 / 5, 323 / 32 / 2, 142 / 33 / 2, 344 / 34 / 3, 84 / 35 / 2, 131 / 36 / 2, 169 / 37 / 2, 128 / 38 / 2, 136 / 39 / 2, 159 / 40 / 3, 53 / 41 / 2, 245 / 42 / 2, 220 / 43 / 6, 193 / 44 / 2, 48 / 45 / 2, 281 / 46 / 3, 285 / 47 / 2, 236 / 48 / 2, 369 / 49 / 2, 51 / 50 / 3, 335 / 51 / 2, 269 / 52 / 3, 121 / 53 / 2, 242 / 54 / 3, 212 / 55 / 2, 189 / 56 / 2, 144 / 57 / 2, 247 / 58 / 7, 143 / 59 / 2, 164 / 60 / 3, 55 / 61 / 2, 221 / 62 / 2, 156 / 63 / 2, 211 / 64 / 3, 66 / 65 / 2, 105 / 66 / 2, 146 / 67 / 2, 252 / 68 / 2, 141 / 69 / 2, 301 / 70 / 2, 309 / 71 / 3, 137 / 72 / 2, 364 / 73 / 3, 282 / 74 / 2, 81 / 75 / 2, 223 / 76 / 2, 371 / 77 / 4, 88 / 78 / 2, 167 / 79 / 2, 359 / 80 / 3, 326 / 81 / 2, 93 / 82 / 2, 122 / 83 / 5, 227 / 84 / 2, 49 / 85 / 3, 12 / 86 / 2, 22 / 87 / 2, 68 / 88 / 3, 304 / 89 / 2, 107 / 90 / 2, 232 / 91 / 3, 26 / 92 / 2, 77 / 93 / 2, 11 / 94 / 4, 148 / 95 / 2, 209 / 96 / 2, 300 / 97 / 4, 13 / 98 / 2, 27 / 99 / 3, 357 / 100 / 2, 3 / 101 / 2, 268 / 102 / 6, 204 / 103 / 2, 125 / 104 / 3, 205 / 105 / 2, 76 / 106 / 2, 178 / 107 / 3, 152 / 108 / 2, 253 / 109 / 2, 113 / 110 / 2, 150 / 111 / 3, 135 / 112 / 2, 87 / 113 / 2, 306 / 114 / 2, 338 / 115 / 2, 244 / 116 / 3, 194 / 117 / 2, 336 / 118 / 2, 243 / 119 / 3, 149 / 120 / 2, 295 / 121 / 2, 308 / 122 / 2, 9 / 123 / 3, 175 / 124 / 2, 180 / 125 / 2, 161 / 126 / 3, 349 / 127 / 2, 155 / 128 / 2, 181 / 129 / 2, 288 / 130 / 2, 330 / 131 / 2, 132 / 132 / 3, 5 / 133 / 2, 96 / 134 / 2, 33 / 135 / 2, 296 / 136 / 3, 179 / 137 / 2, 291 / 138 / 2, 255 / 139 / 5, 182 / 140 / 2, 337 / 141 / 2, 225 / 142 / 2, 104 / 143 / 4, 78 / 144 / 2, 343 / 145 / 2, 153 / 146 / 4, 129 / 147 / 2, 280 / 148 / 2, 241 / 149 / 3, 261 / 150 / 2, 292 / 151 / 3, 4 / 152 / 2, 95 / 153 / 3, 298 / 154 / 2, 216 / 155 / 2, 165 / 156 / 2, 118 / 157 / 2, 219 / 158 / 2, 36 / 159 / 2, 347 / 160 / 2, 353 / 161 / 4, 224 / 162 / 2, 15 / 163 / 2, 315 / 164 / 3, 116 / 165 / 2, 134 / 166 / 4, 366 / 167 / 2, 72 / 168 / 2, 370 / 169 / 3, 358 / 170 / 2, 279 / 171 / 2, 254 / 172 / 2, 158 / 173 / 2, 230 / 174 / 2, 2 / 175 / 4, 39 / 176 / 2, 362 / 177 / 2, 311 / 178 / 2, 82 / 179 / 2, 231 / 180 / 2, 43 / 181 / 2, 192 / 182 / 2, 85 / 183 / 2, 187 / 184 / 2, 21 / 185 / 3, 54 / 186 / 2, 322 / 187 / 2, 69 / 188 / 3, 31 / 189 / 2, 196 / 190 / 2, 57 / 191 / 4, 44 / 192 / 2, 312 / 193 / 2, 184 / 194 / 2, 38 / 195 / 5, 18 / 196 / 2, 133 / 197 / 2, 332 / 198 / 2, 127 / 199 / 2, 284 / 200 / 3, 303 / 201 / 2, 174 / 202 / 3, 108 / 203 / 2, 130 / 204 / 3, 267 / 205 / 2, 157 / 206 / 4, 208 / 207 / 2, 139 / 208 / 2, 35 / 209 / 4, 240 / 210 / 2, 47 / 211 / 2, 75 / 212 / 3, 356 / 213 / 2, 28 / 214 / 3, 20 / 215 / 2, 274 / 216 / 2, 111 / 217 / 2, 67 / 218 / 2, 276 / 219 / 3, 233 / 220 / 2, 200 / 221 / 2, 160 / 222 / 2, 147 / 223 / 4, 277 / 224 / 2, 313 / 225 / 2, 40 / 226 / 3, 293 / 227 / 2, 89 / 228 / 2, 71 / 229 / 4, 170 / 230 / 2, 60 / 231 / 2, 368 / 232 / 2, 34 / 233 / 2, 210 / 234 / 2, 41 / 235 / 2, 329 / 236 / 7, 262 / 237 / 2, 213 / 238 / 3, 260 / 239 / 2, 321 / 240 / 2, 98 / 241 / 2, 61 / 242 / 3, 202 / 243 / 2, 30 / 244 / 2, 258 / 245 / 2, 86 / 246 / 2, 367 / 247 / 2, 50 / 248 / 2, 62 / 249 / 4, 263 / 250 / 2, 6 / 251 / 2, 123 / 252 / 2, 361 / 253 / 2, 59 / 254 / 2, 328 / 255 / 2, 191 / 256 / 3, 259 / 257 / 2, 198 / 258 / 2, 350 / 259 / 2, 106 / 260 / 2, 327 / 261 / 2, 299 / 262 / 2, 363 / 263 / 2, 114 / 264 / 2, 352 / 265 / 3, 24 / 266 / 2, 307 / 267 / 3, 249 / 268 / 2, 176 / 269 / 3, 197 / 270 / 2, 316 / 271 / 2, 320 / 272 / 3, 226 / 273 / 2, 97 / 274 / 2, 90 / 275 / 3, 190 / 276 / 2, 56 / 277 / 2, 99 / 278 / 2, 16 / 279 / 3, 91 / 280 / 2, 217 / 281 / 2, 314 / 282 / 4, 206 / 283 / 2, 172 / 284 / 2, 346 / 285 / 2, 64 / 286 / 3, 354 / 287 / 2, 65 / 288 / 3, 250 / 289 / 2, 305 / 290 / 2, 234 / 291 / 3, 229 / 292 / 2, 185 / 293 / 3, 110 / 294 / 2, 183 / 295 / 2, 374 / 296 / 2, 58 / 297 / 2, 339 / 298 / 2, 154 / 299 / 2, 218 / 300 / 3, 112 / 301 / 2, 177 / 302 / 2, 365 / 303 / 2, 265 / 304 / 2, 199 / 305 / 4, 355 / 306 / 2, 8 / 307 / 2, 286 / 308 / 2, 138 / 309 / 2, 19 / 310 / 2, 256 / 311 / 2, 145 / 312 / 2, 195 / 313 / 2, 228 / 314 / 2, 74 / 315 / 2, 283 / 316 / 3, 168 / 317 / 2, 52 / 318 / 2, 23 / 319 / 3, 207 / 320 / 2, 73 / 321 / 2, 163 / 322 / 2, 310 / 323 / 2, 278 / 324 / 2, 29 / 325 / 2, 342 / 326 / 2, 45 / 327 / 2, 119 / 328 / 4, 140 / 329 / 2, 124 / 330 / 2, 317 / 331 / 2, 79 / 332 / 3, 266 / 333 / 2, 257 / 334 / 2, 17 / 335 / 2, 237 / 336 / 2, 32 / 337 / 3, 271 / 338 / 2, 14 / 339 / 2, 103 / 340 / 3, 92 / 341 / 2, 294 / 342 / 2, 46 / 343 / 3, 63 / 344 / 2, 333 / 345 / 2, 37 / 346 / 2, 273 / 347 / 2, 248 / 348 / 2, 360 / 349 / 2, 272 / 350 / 3, 171 / 351 / 2, 102 / 352 / 2, 270 / 353 / 2, 348 / 354 / 2, 201 / 355 / 5, 341 / 356 / 2, 109 / 357 / 2, 1 / 358 / 2, 239 / 359 / 4, 214 / 360 / 2, 302 / 361 / 2, 334 / 362 / 2, 166 / 363 / 3, 235 / 364 / 2, 287 / 365 / 2, 325 / 366 / 3, 10 / 367 / 2, 246 / 368 / 2, 203 / 369 / 2, 345 / 370 / 2, 126 / 371 / 4, 101 / 372 / 2, 289 / 373 / 2, 275 / 374 / 4
singlecenter-alpha_1-2-n5.txt, 1, 1, 5, 301.242, 18, 13, 4, 4,1 / 1 / 2, 4 / 2 / 2, 3 / 3 / 2, 2 / 4 / 4
singlecenter-alpha_1-20-n375.txt, 1, 1, 375, 2839.26, 2861, 2486, 7, 374,336 / 1 / 2, 288 / 2 / 3, 22 / 3 / 2, 341 / 4 / 2, 105 / 5 / 4, 217 / 6 / 2, 183 / 7 / 2, 80 / 8 / 3, 309 / 9 / 2, 197 / 10 / 2, 157 / 11 / 3, 325 / 12 / 2, 65 / 13 / 2, 138 / 14 / 3, 357 / 15 / 2, 104 / 16 / 4, 279 / 17 / 2, 190 / 18 / 2, 206 / 19 / 3, 200 / 20 / 2, 144 / 21 / 3, 344 / 22 / 2, 135 / 23 / 2, 131 / 24 / 2, 351 / 25 / 2, 338 / 26 / 3, 48 / 27 / 2, 151 / 28 / 3, 363 / 29 / 2, 161 / 30 / 3, 370 / 31 / 2, 99 / 32 / 3, 81 / 33 / 2, 47 / 34 / 3, 334 / 35 / 2, 75 / 36 / 2, 275 / 37 / 3, 185 / 38 / 2, 132 / 39 / 2, 79 / 40 / 2, 40 / 41 / 2, 137 / 42 / 2, 133 / 43 / 3, 23 / 44 / 2, 175 / 45 / 3, 293 / 46 / 2, 216 / 47 / 2, 179 / 48 / 2, 366 / 49 / 2, 36 / 50 / 3, 46 / 51 / 2, 16 / 52 / 2, 18 / 53 / 3, 89 / 54 / 2, 313 / 55 / 3, 283 / 56 / 2, 70 / 57 / 4, 58 / 58 / 2, 1 / 59 / 2, 63 / 60 / 2, 149 / 61 / 3, 245 / 62 / 2, 51 / 63 / 3, 261 / 64 / 2, 156 / 65 / 2, 368 / 66 / 2, 287 / 67 / 5, 353 / 68 / 2, 303 / 69 / 2, 86 / 70 / 2, 3 / 71 / 2, 123 / 72 / 3, 256 / 73 / 2, 290 / 74 / 2, 225 / 75 / 2, 343 / 76 / 2, 310 / 77 / 4, 27 / 78 / 2, 186 / 79 / 3, 35 / 80 / 2, 260 / 81 / 2, 172 / 82 / 2, 71 / 83 / 3, 322 / 84 / 2, 219 / 85 / 2, 255 / 86 / 4, 69 / 87 / 2, 165 / 88 / 2, 74 / 89 / 2, 297 / 90 / 2, 67 / 91 / 3, 328 / 92 / 2, 249 / 93 / 3, 324 / 94 / 2, 146 / 95 / 2, 242 / 96 / 3, 294 / 97 / 2, 258 / 98 / 2, 145 / 99 / 2, 14 / 100 / 2, 221 / 101 / 2, 110 / 102 / 2, 329 / 103 / 4, 227 / 104 / 2, 246 / 105 / 3, 60 / 106 / 2, 6 / 107 / 2, 50 / 108 / 4, 319 / 109 / 2, 176 / 110 / 2, 238 / 111 / 2, 107 / 112 / 2, 358 / 113 / 4, 315 / 114 / 2, 330 / 115 / 2, 304 / 116 / 4, 333 / 117 / 2, 373 / 118 / 2, 268 / 119 / 3, 49 / 120 / 2, 25 / 121 / 2, 95 / 122 / 2, 226 / 123 / 2, 113 / 124 / 2, 365 / 125 / 3, 352 / 126 / 2, 119 / 127 / 2, 142 / 128 / 2, 317 / 129 / 3, 237 / 130 / 2, 222 / 131 / 2, 282 / 132 / 3, 207 / 133 / 2, 321 / 134 / 2, 354 / 135 / 3, 140 / 136 / 2, 162 / 137 / 2, 59 / 138 / 3, 306 / 139 / 2, 289 / 140 / 2, 92 / 141 / 3, 280 / 142 / 2, 155 / 143 / 2, 108 / 144 / 3, 125 / 145 / 2, 305 / 146 / 2, 262 / 147 / 2, 170 / 148 / 3, 254 / 149 / 2, 339 / 150 / 4, 127 / 151 / 2, 39 / 152 / 3, 5 / 153 / 2, 115 / 154 / 2, 213 / 155 / 2, 195 / 156 / 2, 191 / 157 / 2, 250 / 158 / 4, 169 / 159 / 2, 130 / 160 / 2, 188 / 161 / 2, 143 / 162 / 2, 106 / 163 / 2, 360 / 164 / 2, 265 / 165 / 5, 4 / 166 / 2, 252 / 167 / 2, 233 / 168 / 3, 230 / 169 / 2, 44 / 170 / 3, 41 / 171 / 2, 347 / 172 / 2, 24 / 173 / 4, 267 / 174 / 2, 28 / 175 / 3, 369 / 176 / 2, 239 / 177 / 3, 158 / 178 / 2, 299 / 179 / 2, 218 / 180 / 3, 273 / 181 / 2, 96 / 182 / 2, 367 / 183 / 2, 72 / 184 / 3, 311 / 185 / 2, 284 / 186 / 6, 187 / 187 / 2, 356 / 188 / 2, 45 / 189 / 2, 307 / 190 / 3, 331 / 191 / 2, 129 / 192 / 2, 359 / 193 / 3, 196 / 194 / 2, 173 / 195 / 2, 320 / 196 / 2, 62 / 197 / 2, 53 / 198 / 2, 371 / 199 / 3, 259 / 200 / 2, 241 / 201 / 2, 327 / 202 / 3, 244 / 203 / 2, 248 / 204 / 2, 364 / 205 / 3, 102 / 206 / 2, 57 / 207 / 3, 164 / 208 / 2, 128 / 209 / 2, 350 / 210 / 4, 117 / 211 / 2, 56 / 212 / 2, 281 / 213 / 2, 61 / 214 / 2, 87 / 215 / 5, 214 / 216 / 2, 272 / 217 / 2, 232 / 218 / 3, 271 / 219 / 2, 90 / 220 / 2, 276 / 221 / 2, 178 / 222 / 2, 8 / 223 / 3, 308 / 224 / 2, 29 / 225 / 2, 269 / 226 / 4, 180 / 227 / 2, 374 / 228 / 2, 43 / 229 / 3, 68 / 230 / 2, 38 / 231 / 3, 160 / 232 / 2, 345 / 233 / 3, 323 / 234 / 2, 291 / 235 / 2, 266 / 236 / 2, 54 / 237 / 2, 228 / 238 / 2, 126 / 239 / 2, 88 / 240 / 2, 2 / 241 / 2, 209 / 242 / 2, 235 / 243 / 2, 116 / 244 / 2, 120 / 245 / 2, 243 / 246 / 2, 84 / 247 / 3, 171 / 248 / 2, 198 / 249 / 3, 337 / 250 / 2, 335 / 251 / 3, 184 / 252 / 2, 203 / 253 / 2, 182 / 254 / 3, 208 / 255 / 2, 210 / 256 / 2, 285 / 257 / 7, 342 / 258 / 2, 77 / 259 / 2, 274 / 260 / 3, 21 / 261 / 2, 83 / 262 / 3, 189 / 263 / 2, 34 / 264 / 2, 361 / 265 / 2, 251 / 266 / 2, 152 / 267 / 3, 263 / 268 / 2, 314 / 269 / 2, 355 / 270 / 2, 55 / 271 / 2, 167 / 272 / 2, 340 / 273 / 3, 52 / 274 / 2, 91 / 275 / 3, 122 / 276 / 2, 253 / 277 / 2, 31 / 278 / 2, 298 / 279 / 2, 82 / 280 / 2, 19 / 281 / 3, 220 / 282 / 2, 12 / 283 / 3, 101 / 284 / 2, 302 / 285 / 3, 349 / 286 / 2, 295 / 287 / 2, 318 / 288 / 3, 109 / 289 / 2, 112 / 290 / 2, 100 / 291 / 2, 98 / 292 / 2, 78 / 293 / 2, 177 / 294 / 2, 332 / 295 / 2, 362 / 296 / 2, 166 / 297 / 3, 153 / 298 / 2, 194 / 299 / 2, 17 / 300 / 2, 121 / 301 / 5, 316 / 302 / 2, 11 / 303 / 2, 224 / 304 / 2, 199 / 305 / 3, 192 / 306 / 2, 64 / 307 / 2, 236 / 308 / 4, 147 / 309 / 2, 215 / 310 / 2, 193 / 311 / 3, 270 / 312 / 2, 326 / 313 / 3, 148 / 314 / 2, 264 / 315 / 2, 211 / 316 / 4, 85 / 317 / 2, 372 / 318 / 2, 204 / 319 / 4, 97 / 320 / 2, 139 / 321 / 2, 292 / 322 / 4, 7 / 323 / 2, 300 / 324 / 2, 296 / 325 / 3, 30 / 326 / 2, 247 / 327 / 2, 150 / 328 / 2, 202 / 329 / 2, 10 / 330 / 2, 15 / 331 / 5, 13 / 332 / 2, 76 / 333 / 2, 9 / 334 / 2, 33 / 335 / 2, 26 / 336 / 2, 42 / 337 / 4, 37 / 338 / 2, 348 / 339 / 2, 346 / 340 / 3, 229 / 341 / 2, 234 / 342 / 2, 301 / 343 / 2, 73 / 344 / 3, 231 / 345 / 2, 223 / 346 / 2, 114 / 347 / 3, 286 / 348 / 2, 124 / 349 / 3, 32 / 350 / 2, 66 / 351 / 2, 277 / 352 / 3, 168 / 353 / 2, 93 / 354 / 3, 240 / 355 / 2, 174 / 356 / 5, 118 / 357 / 2, 312 / 358 / 2, 111 / 359 / 2, 94 / 360 / 3, 212 / 361 / 2, 141 / 362 / 3, 163 / 363 / 2, 159 / 364 / 2, 154 / 365 / 2, 257 / 366 / 2, 181 / 367 / 3, 201 / 368 / 2, 103 / 369 / 3, 278 / 370 / 2, 205 / 371 / 2, 136 / 372 / 2, 134 / 373 / 2, 20 / 374 / 3
singlecenter-alpha_1-20-n6.txt, 1, 1, 6, 230.966, 25, 19, 4, 5,5 / 1 / 2, 2 / 2 / 2, 4 / 3 / 2, 3 / 4 / 4, 1 / 5 / 2
singlecenter-alpha_1-21-n7.txt, 1, 1, 7, 387.236, 32, 25, 4, 6,4 / 1 / 2, 3 / 2 / 4, 5 / 3 / 2, 1 / 4 / 2, 2 / 5 / 4, 6 / 6 / 2
singlecenter-alpha_1-22-n7.txt, 1, 1, 7, 361.737, 35, 28, 7, 6,6 / 1 / 2, 5 / 2 / 2, 3 / 3 / 7, 4 / 4 / 2, 2 / 5 / 2, 1 / 6 / 4
singlecenter-alpha_1-23-n7.txt, 1, 1, 7, 167.639, 33, 26, 4, 6,1 / 1 / 4, 2 / 2 / 2, 5 / 3 / 2, 3 / 4 / 3, 4 / 5 / 2, 6 / 6 / 3
singlecenter-alpha_1-24-n7.txt, 1, 1, 7, 299.706, 37, 30, 6, 6,1 / 1 / 6, 3 / 2 / 2, 4 / 3 / 2, 5 / 4 / 2, 6 / 5 / 2, 2 / 6 / 6
singlecenter-alpha_1-25-n7.txt, 1, 1, 7, 357.359, 34, 27, 7, 6,2 / 1 / 2, 3 / 2 / 2, 6 / 3 / 3, 5 / 4 / 2, 1 / 5 / 7, 4 / 6 / 2
singlecenter-alpha_1-26-n7.txt, 1, 1, 7, 202.192, 35, 28, 5, 6,3 / 1 / 5, 5 / 2 / 2, 4 / 3 / 3, 2 / 4 / 2, 1 / 5 / 5, 6 / 6 / 2
singlecenter-alpha_1-27-n7.txt, 1, 1, 7, 288.22, 34, 27, 7, 6,2 / 1 / 3, 6 / 2 / 2, 3 / 3 / 2, 1 / 4 / 7, 4 / 5 / 2, 5 / 6 / 2
singlecenter-alpha_1-28-n7.txt, 1, 1, 7, 326.378, 27, 20, 3, 6,3 / 1 / 2, 6 / 2 / 2, 4 / 3 / 2, 2 / 4 / 2, 1 / 5 / 3, 5 / 6 / 2
singlecenter-alpha_1-29-n7.txt, 1, 1, 7, 408.357, 32, 25, 3, 6,6 / 1 / 3, 4 / 2 / 2, 1 / 3 / 3, 3 / 4 / 2, 5 / 5 / 2, 2 / 6 / 3
singlecenter-alpha_1-3-n250.txt, 1, 1, 250, 2541.09, 2013, 1763, 8, 249,33 / 1 / 2, 246 / 2 / 2, 243 / 3 / 4, 245 / 4 / 2, 60 / 5 / 2, 12 / 6 / 3, 34 / 7 / 2, 68 / 8 / 3, 170 / 9 / 2, 122 / 10 / 2, 76 / 11 / 3, 126 / 12 / 2, 32 / 13 / 2, 47 / 14 / 2, 215 / 15 / 2, 124 / 16 / 4, 231 / 17 / 2, 79 / 18 / 2, 1 / 19 / 2, 57 / 20 / 2, 207 / 21 / 2, 228 / 22 / 2, 229 / 23 / 4, 55 / 24 / 2, 195 / 25 / 2, 106 / 26 / 2, 82 / 27 / 2, 84 / 28 / 2, 163 / 29 / 4, 138 / 30 / 2, 184 / 31 / 2, 168 / 32 / 2, 205 / 33 / 4, 95 / 34 / 2, 160 / 35 / 2, 102 / 36 / 3, 38 / 37 / 2, 8 / 38 / 2, 226 / 39 / 3, 238 / 40 / 2, 88 / 41 / 2, 242 / 42 / 4, 183 / 43 / 2, 232 / 44 / 2, 119 / 45 / 3, 72 / 46 / 2, 101 / 47 / 2, 73 / 48 / 2, 244 / 49 / 5, 10 / 50 / 2, 219 / 51 / 2, 247 / 52 / 2, 100 / 53 / 2, 87 / 54 / 2, 6 / 55 / 2, 136 / 56 / 3, 112 / 57 / 2, 158 / 58 / 3, 2 / 59 / 2, 111 / 60 / 2, 39 / 61 / 2, 105 / 62 / 2, 20 / 63 / 3, 27 / 64 / 2, 182 / 65 / 3, 16 / 66 / 2, 71 / 67 / 3, 186 / 68 / 2, 134 / 69 / 2, 9 / 70 / 2, 13 / 71 / 4, 94 / 72 / 2, 203 / 73 / 2, 208 / 74 / 2, 93 / 75 / 5, 222 / 76 / 2, 240 / 77 / 2, 97 / 78 / 2, 144 / 79 / 4, 110 / 80 / 2, 185 / 81 / 2, 159 / 82 / 2, 214 / 83 / 2, 52 / 84 / 2, 36 / 85 / 2, 217 / 86 / 2, 218 / 87 / 3, 189 / 88 / 2, 249 / 89 / 2, 62 / 90 / 2, 230 / 91 / 2, 37 / 92 / 2, 145 / 93 / 2, 86 / 94 / 4, 193 / 95 / 2, 152 / 96 / 3, 198 / 97 / 2, 28 / 98 / 2, 30 / 99 / 6, 200 / 100 / 2, 53 / 101 / 3, 74 / 102 / 2, 190 / 103 / 2, 3 / 104 / 2, 120 / 105 / 2, 212 / 106 / 5, 204 / 107 / 2, 25 / 108 / 2, 206 / 109 / 2, 121 / 110 / 3, 202 / 111 / 2, 17 / 112 / 3, 89 / 113 / 2, 220 / 114 / 3, 239 / 115 / 2, 151 / 116 / 3, 157 / 117 / 2, 77 / 118 / 3, 44 / 119 / 2, 128 / 120 / 3, 191 / 121 / 2, 146 / 122 / 2, 85 / 123 / 6, 61 / 124 / 2, 26 / 125 / 2, 11 / 126 / 3, 118 / 127 / 2, 22 / 128 / 2, 197 / 129 / 4, 78 / 130 / 2, 59 / 131 / 2, 114 / 132 / 3, 234 / 133 / 2, 165 / 134 / 3, 104 / 135 / 2, 175 / 136 / 2, 117 / 137 / 2, 98 / 138 / 2, 92 / 139 / 3, 69 / 140 / 2, 235 / 141 / 2, 142 / 142 / 4, 178 / 143 / 2, 75 / 144 / 2, 21 / 145 / 2, 90 / 146 / 2, 221 / 147 / 8, 236 / 148 / 2, 135 / 149 / 3, 46 / 150 / 2, 51 / 151 / 2, 40 / 152 / 3, 155 / 153 / 2, 131 / 154 / 3, 115 / 155 / 2, 227 / 156 / 2, 194 / 157 / 3, 43 / 158 / 2, 225 / 159 / 2, 132 / 160 / 6, 109 / 161 / 2, 18 / 162 / 2, 5 / 163 / 2, 153 / 164 / 2, 48 / 165 / 4, 24 / 166 / 2, 162 / 167 / 2, 49 / 168 / 2, 196 / 169 / 2, 99 / 170 / 5, 172 / 171 / 2, 150 / 172 / 2, 188 / 173 / 2, 14 / 174 / 3, 127 / 175 / 2, 83 / 176 / 3, 139 / 177 / 2, 187 / 178 / 2, 31 / 179 / 4, 241 / 180 / 2, 15 / 181 / 2, 42 / 182 / 2, 201 / 183 / 4, 199 / 184 / 2, 64 / 185 / 2, 103 / 186 / 2, 80 / 187 / 2, 233 / 188 / 3, 137 / 189 / 2, 91 / 190 / 2, 192 / 191 / 2, 133 / 192 / 4, 58 / 193 / 2, 181 / 194 / 2, 223 / 195 / 4, 141 / 196 / 2, 210 / 197 / 2, 129 / 198 / 2, 248 / 199 / 3, 123 / 200 / 2, 154 / 201 / 2, 140 / 202 / 2, 166 / 203 / 2, 167 / 204 / 3, 213 / 205 / 2, 169 / 206 / 3, 66 / 207 / 2, 224 / 208 / 3, 19 / 209 / 2, 113 / 210 / 3, 81 / 211 / 2, 148 / 212 / 2, 164 / 213 / 2, 7 / 214 / 3, 171 / 215 / 2, 174 / 216 / 2, 209 / 217 / 6, 70 / 218 / 2, 41 / 219 / 2, 156 / 220 / 3, 125 / 221 / 2, 211 / 222 / 3, 173 / 223 / 2, 149 / 224 / 3, 29 / 225 / 2, 50 / 226 / 2, 63 / 227 / 2, 161 / 228 / 2, 54 / 229 / 4, 67 / 230 / 2, 116 / 231 / 2, 96 / 232 / 3, 107 / 233 / 2, 237 / 234 / 2, 35 / 235 / 3, 130 / 236 / 2, 4 / 237 / 3, 108 / 238 / 2, 45 / 239 / 2, 177 / 240 / 2, 65 / 241 / 2, 147 / 242 / 3, 216 / 243 / 2, 176 / 244 / 2, 143 / 245 / 2, 179 / 246 / 2, 180 / 247 / 2, 56 / 248 / 2, 23 / 249 / 3
singlecenter-alpha_1-3-n375.txt, 1, 1, 375, 2628.15, 3037, 2662, 9, 374,287 / 1 / 3, 294 / 2 / 2, 197 / 3 / 2, 72 / 4 / 3, 192 / 5 / 2, 193 / 6 / 3, 152 / 7 / 2, 352 / 8 / 3, 292 / 9 / 2, 177 / 10 / 3, 163 / 11 / 2, 215 / 12 / 2, 144 / 13 / 2, 230 / 14 / 2, 227 / 15 / 3, 346 / 16 / 2, 148 / 17 / 3, 280 / 18 / 2, 372 / 19 / 2, 283 / 20 / 2, 243 / 21 / 2, 203 / 22 / 2, 74 / 23 / 2, 63 / 24 / 2, 89 / 25 / 2, 289 / 26 / 2, 39 / 27 / 4, 3 / 28 / 2, 343 / 29 / 2, 28 / 30 / 2, 13 / 31 / 2, 299 / 32 / 3, 8 / 33 / 2, 266 / 34 / 2, 19 / 35 / 2, 137 / 36 / 2, 251 / 37 / 2, 357 / 38 / 3, 295 / 39 / 2, 225 / 40 / 2, 242 / 41 / 2, 85 / 42 / 3, 135 / 43 / 2, 108 / 44 / 2, 101 / 45 / 2, 122 / 46 / 3, 274 / 47 / 2, 239 / 48 / 2, 184 / 49 / 2, 316 / 50 / 4, 257 / 51 / 2, 241 / 52 / 2, 100 / 53 / 3, 327 / 54 / 2, 221 / 55 / 4, 50 / 56 / 2, 26 / 57 / 2, 353 / 58 / 2, 339 / 59 / 2, 170 / 60 / 6, 70 / 61 / 2, 209 / 62 / 2, 97 / 63 / 2, 103 / 64 / 3, 92 / 65 / 2, 57 / 66 / 2, 140 / 67 / 2, 329 / 68 / 2, 60 / 69 / 2, 93 / 70 / 5, 267 / 71 / 2, 155 / 72 / 3, 157 / 73 / 2, 217 / 74 / 2, 264 / 75 / 3, 363 / 76 / 2, 207 / 77 / 2, 118 / 78 / 3, 5 / 79 / 2, 55 / 80 / 3, 107 / 81 / 2, 119 / 82 / 2, 311 / 83 / 2, 59 / 84 / 3, 58 / 85 / 2, 270 / 86 / 2, 342 / 87 / 2, 338 / 88 / 3, 249 / 89 / 2, 44 / 90 / 3, 54 / 91 / 2, 142 / 92 / 3, 235 / 93 / 2, 355 / 94 / 3, 232 / 95 / 2, 175 / 96 / 2, 139 / 97 / 3, 358 / 98 / 2, 61 / 99 / 9, 198 / 100 / 2, 271 / 101 / 3, 167 / 102 / 2, 337 / 103 / 3, 365 / 104 / 2, 180 / 105 / 3, 307 / 106 / 2, 43 / 107 / 3, 196 / 108 / 2, 106 / 109 / 2, 133 / 110 / 2, 205 / 111 / 2, 293 / 112 / 2, 258 / 113 / 2, 185 / 114 / 2, 171 / 115 / 2, 234 / 116 / 2, 159 / 117 / 2, 231 / 118 / 4, 288 / 119 / 2, 189 / 120 / 2, 120 / 121 / 4, 68 / 122 / 2, 173 / 123 / 2, 156 / 124 / 3, 226 / 125 / 2, 90 / 126 / 3, 201 / 127 / 2, 10 / 128 / 2, 371 / 129 / 3, 125 / 130 / 2, 282 / 131 / 3, 334 / 132 / 2, 349 / 133 / 2, 216 / 134 / 2, 131 / 135 / 4, 127 / 136 / 2, 102 / 137 / 2, 151 / 138 / 2, 15 / 139 / 3, 312 / 140 / 2, 18 / 141 / 3, 319 / 142 / 2, 42 / 143 / 4, 141 / 144 / 2, 134 / 145 / 2, 99 / 146 / 2, 172 / 147 / 2, 69 / 148 / 2, 306 / 149 / 3, 66 / 150 / 2, 279 / 151 / 2, 255 / 152 / 2, 194 / 153 / 2, 41 / 154 / 2, 88 / 155 / 4, 1 / 156 / 2, 14 / 157 / 2, 79 / 158 / 2, 351 / 159 / 2, 314 / 160 / 2, 84 / 161 / 2, 261 / 162 / 2, 117 / 163 / 2, 367 / 164 / 2, 25 / 165 / 2, 195 / 166 / 2, 347 / 167 / 2, 236 / 168 / 5, 51 / 169 / 2, 86 / 170 / 2, 147 / 171 / 2, 277 / 172 / 5, 199 / 173 / 2, 37 / 174 / 3, 6 / 175 / 2, 149 / 176 / 2, 21 / 177 / 3, 136 / 178 / 2, 321 / 179 / 2, 315 / 180 / 2, 168 / 181 / 4, 341 / 182 / 2, 296 / 183 / 2, 105 / 184 / 2, 53 / 185 / 3, 237 / 186 / 2, 211 / 187 / 2, 33 / 188 / 2, 361 / 189 / 2, 218 / 190 / 3, 222 / 191 / 2, 366 / 192 / 3, 330 / 193 / 2, 228 / 194 / 2, 317 / 195 / 2, 345 / 196 / 2, 67 / 197 / 3, 71 / 198 / 2, 46 / 199 / 2, 29 / 200 / 3, 27 / 201 / 2, 154 / 202 / 2, 281 / 203 / 2, 272 / 204 / 2, 309 / 205 / 2, 160 / 206 / 2, 362 / 207 / 2, 325 / 208 / 2, 161 / 209 / 2, 220 / 210 / 2, 186 / 211 / 6, 121 / 212 / 2, 187 / 213 / 2, 145 / 214 / 2, 200 / 215 / 2, 176 / 216 / 2, 150 / 217 / 2, 112 / 218 / 2, 322 / 219 / 2, 250 / 220 / 3, 233 / 221 / 2, 308 / 222 / 3, 20 / 223 / 2, 300 / 224 / 2, 190 / 225 / 2, 244 / 226 / 5, 115 / 227 / 2, 368 / 228 / 2, 336 / 229 / 2, 24 / 230 / 2, 303 / 231 / 3, 109 / 232 / 2, 158 / 233 / 3, 191 / 234 / 2, 11 / 235 / 2, 332 / 236 / 2, 360 / 237 / 3, 265 / 238 / 2, 49 / 239 / 3, 213 / 240 / 2, 364 / 241 / 3, 310 / 242 / 2, 128 / 243 / 2, 52 / 244 / 2, 238 / 245 / 2, 38 / 246 / 2, 275 / 247 / 3, 114 / 248 / 2, 323 / 249 / 2, 254 / 250 / 2, 260 / 251 / 3, 181 / 252 / 2, 164 / 253 / 3, 350 / 254 / 2, 132 / 255 / 2, 370 / 256 / 3, 320 / 257 / 2, 359 / 258 / 3, 302 / 259 / 2, 169 / 260 / 3, 9 / 261 / 2, 304 / 262 / 3, 298 / 263 / 2, 94 / 264 / 3, 78 / 265 / 2, 348 / 266 / 5, 12 / 267 / 2, 256 / 268 / 2, 2 / 269 / 2, 204 / 270 / 2, 182 / 271 / 4, 7 / 272 / 2, 91 / 273 / 3, 64 / 274 / 2, 138 / 275 / 3, 31 / 276 / 2, 30 / 277 / 2, 248 / 278 / 2, 246 / 279 / 3, 214 / 280 / 2, 123 / 281 / 4, 286 / 282 / 2, 318 / 283 / 2, 328 / 284 / 2, 210 / 285 / 2, 113 / 286 / 2, 174 / 287 / 2, 273 / 288 / 2, 126 / 289 / 2, 16 / 290 / 3, 263 / 291 / 2, 65 / 292 / 2, 77 / 293 / 2, 23 / 294 / 2, 276 / 295 / 2, 374 / 296 / 2, 224 / 297 / 3, 34 / 298 / 2, 111 / 299 / 3, 240 / 300 / 2, 290 / 301 / 2, 95 / 302 / 3, 75 / 303 / 2, 326 / 304 / 2, 47 / 305 / 2, 83 / 306 / 3, 212 / 307 / 2, 62 / 308 / 2, 269 / 309 / 2, 165 / 310 / 2, 81 / 311 / 2, 40 / 312 / 2, 344 / 313 / 2, 284 / 314 / 3, 96 / 315 / 2, 166 / 316 / 2, 179 / 317 / 2, 333 / 318 / 2, 206 / 319 / 2, 116 / 320 / 3, 253 / 321 / 2, 35 / 322 / 3, 32 / 323 / 2, 82 / 324 / 2, 129 / 325 / 2, 162 / 326 / 2, 76 / 327 / 2, 247 / 328 / 8, 36 / 329 / 2, 285 / 330 / 2, 252 / 331 / 2, 17 / 332 / 3, 48 / 333 / 2, 202 / 334 / 2, 124 / 335 / 3, 313 / 336 / 2, 56 / 337 / 2, 278 / 338 / 3, 356 / 339 / 2, 183 / 340 / 3, 73 / 341 / 2, 45 / 342 / 2, 291 / 343 / 4, 153 / 344 / 2, 87 / 345 / 2, 229 / 346 / 4, 130 / 347 / 2, 354 / 348 / 2, 262 / 349 / 2, 331 / 350 / 2, 259 / 351 / 5, 373 / 352 / 2, 245 / 353 / 2, 335 / 354 / 2, 297 / 355 / 2, 305 / 356 / 3, 4 / 357 / 2, 223 / 358 / 2, 208 / 359 / 2, 301 / 360 / 7, 110 / 361 / 2, 80 / 362 / 3, 369 / 363 / 2, 143 / 364 / 2, 340 / 365 / 3, 188 / 366 / 2, 268 / 367 / 3, 219 / 368 / 2, 104 / 369 / 2, 178 / 370 / 2, 324 / 371 / 2, 22 / 372 / 2, 98 / 373 / 3, 146 / 374 / 2
singlecenter-alpha_1-3-n5.txt, 1, 1, 5, 107.204, 18, 13, 3, 4,1 / 1 / 2, 4 / 2 / 3, 2 / 3 / 2, 3 / 4 / 3
singlecenter-alpha_1-30-n7.txt, 1, 1, 7, 310.78, 35, 28, 5, 6,4 / 1 / 5, 3 / 2 / 2, 2 / 3 / 3, 1 / 4 / 2, 5 / 5 / 5, 6 / 6 / 2
singlecenter-alpha_1-31-n8.txt, 1, 1, 8, 276.194, 44, 36, 5, 7,5 / 1 / 5, 2 / 2 / 2, 4 / 3 / 3, 7 / 4 / 2, 1 / 5 / 2, 6 / 6 / 2, 3 / 7 / 5
singlecenter-alpha_1-32-n8.txt, 1, 1, 8, 195.832, 38, 30, 4, 7,4 / 1 / 2, 6 / 2 / 4, 1 / 3 / 2, 5 / 4 / 3, 2 / 5 / 2, 7 / 6 / 2, 3 / 7 / 3
singlecenter-alpha_1-33-n8.txt, 1, 1, 8, 354.384, 44, 36, 8, 7,3 / 1 / 3, 7 / 2 / 2, 4 / 3 / 2, 6 / 4 / 3, 2 / 5 / 2, 5 / 6 / 8, 1 / 7 / 2
singlecenter-alpha_1-34-n8.txt, 1, 1, 8, 410.435, 37, 29, 4, 7,2 / 1 / 2, 1 / 2 / 3, 3 / 3 / 2, 5 / 4 / 3, 4 / 5 / 2, 6 / 6 / 2, 7 / 7 / 4
singlecenter-alpha_1-35-n8.txt, 1, 1, 8, 350.397, 36, 28, 3, 7,5 / 1 / 2, 1 / 2 / 2, 7 / 3 / 3, 6 / 4 / 2, 2 / 5 / 2, 4 / 6 / 3, 3 / 7 / 2
singlecenter-alpha_1-36-n8.txt, 1, 1, 8, 410.784, 41, 33, 5, 7,6 / 1 / 5, 1 / 2 / 2, 3 / 3 / 3, 5 / 4 / 2, 4 / 5 / 2, 2 / 6 / 2, 7 / 7 / 2
singlecenter-alpha_1-37-n8.txt, 1, 1, 8, 286.975, 44, 36, 4, 7,5 / 1 / 4, 7 / 2 / 2, 6 / 3 / 2, 2 / 4 / 4, 3 / 5 / 2, 4 / 6 / 3, 1 / 7 / 2
singlecenter-alpha_1-38-n8.txt, 1, 1, 8, 584.092, 39, 31, 4, 7,2 / 1 / 2, 1 / 2 / 3, 5 / 3 / 2, 3 / 4 / 3, 4 / 5 / 2, 6 / 6 / 4, 7 / 7 / 2
singlecenter-alpha_1-39-n8.txt, 1, 1, 8, 348.275, 41, 33, 8, 7,5 / 1 / 2, 3 / 2 / 3, 6 / 3 / 2, 2 / 4 / 2, 4 / 5 / 2, 1 / 6 / 8, 7 / 7 / 2
singlecenter-alpha_1-4-n250.txt, 1, 1, 250, 2250.1, 1935, 1685, 8, 249,241 / 1 / 2, 147 / 2 / 2, 161 / 3 / 2, 110 / 4 / 2, 18 / 5 / 3, 96 / 6 / 2, 236 / 7 / 3, 37 / 8 / 2, 224 / 9 / 2, 246 / 10 / 2, 218 / 11 / 2, 116 / 12 / 2, 190 / 13 / 2, 155 / 14 / 2, 206 / 15 / 2, 117 / 16 / 2, 186 / 17 / 2, 233 / 18 / 2, 209 / 19 / 3, 113 / 20 / 2, 10 / 21 / 3, 92 / 22 / 2, 228 / 23 / 3, 239 / 24 / 2, 146 / 25 / 2, 245 / 26 / 2, 41 / 27 / 2, 223 / 28 / 2, 202 / 29 / 3, 196 / 30 / 2, 78 / 31 / 2, 69 / 32 / 3, 33 / 33 / 2, 24 / 34 / 2, 145 / 35 / 2, 181 / 36 / 3, 226 / 37 / 2, 31 / 38 / 2, 100 / 39 / 3, 36 / 40 / 2, 148 / 41 / 2, 204 / 42 / 2, 13 / 43 / 2, 54 / 44 / 2, 225 / 45 / 6, 49 / 46 / 2, 75 / 47 / 3, 169 / 48 / 2, 85 / 49 / 2, 43 / 50 / 3, 238 / 51 / 2, 8 / 52 / 2, 232 / 53 / 4, 91 / 54 / 2, 11 / 55 / 2, 144 / 56 / 5, 193 / 57 / 2, 177 / 58 / 2, 137 / 59 / 2, 88 / 60 / 2, 176 / 61 / 2, 51 / 62 / 2, 143 / 63 / 2, 7 / 64 / 2, 166 / 65 / 2, 53 / 66 / 2, 20 / 67 / 2, 42 / 68 / 2, 67 / 69 / 2, 73 / 70 / 4, 26 / 71 / 2, 28 / 72 / 2, 86 / 73 / 3, 152 / 74 / 2, 157 / 75 / 3, 106 / 76 / 2, 234 / 77 / 3, 108 / 78 / 2, 58 / 79 / 2, 170 / 80 / 2, 19 / 81 / 4, 118 / 82 / 2, 2 / 83 / 2, 127 / 84 / 2, 93 / 85 / 3, 44 / 86 / 2, 16 / 87 / 2, 167 / 88 / 2, 46 / 89 / 3, 35 / 90 / 2, 97 / 91 / 2, 77 / 92 / 3, 231 / 93 / 2, 79 / 94 / 2, 192 / 95 / 3, 4 / 96 / 2, 216 / 97 / 2, 185 / 98 / 3, 160 / 99 / 2, 165 / 100 / 3, 104 / 101 / 2, 172 / 102 / 3, 240 / 103 / 2, 76 / 104 / 4, 14 / 105 / 2, 82 / 106 / 2, 221 / 107 / 3, 71 / 108 / 2, 119 / 109 / 4, 52 / 110 / 2, 173 / 111 / 2, 74 / 112 / 2, 154 / 113 / 2, 131 / 114 / 2, 141 / 115 / 2, 17 / 116 / 2, 59 / 117 / 2, 57 / 118 / 3, 212 / 119 / 2, 222 / 120 / 3, 15 / 121 / 2, 32 / 122 / 2, 120 / 123 / 4, 111 / 124 / 2, 142 / 125 / 2, 199 / 126 / 2, 90 / 127 / 2, 123 / 128 / 4, 229 / 129 / 2, 162 / 130 / 2, 39 / 131 / 2, 101 / 132 / 2, 175 / 133 / 4, 188 / 134 / 2, 184 / 135 / 2, 107 / 136 / 2, 180 / 137 / 2, 164 / 138 / 4, 1 / 139 / 2, 99 / 140 / 2, 83 / 141 / 2, 55 / 142 / 3, 205 / 143 / 2, 102 / 144 / 3, 195 / 145 / 2, 133 / 146 / 2, 103 / 147 / 4, 189 / 148 / 2, 171 / 149 / 2, 178 / 150 / 2, 109 / 151 / 3, 114 / 152 / 2, 60 / 153 / 3, 34 / 154 / 2, 65 / 155 / 2, 191 / 156 / 3, 80 / 157 / 2, 243 / 158 / 3, 183 / 159 / 2, 22 / 160 / 2, 168 / 161 / 2, 219 / 162 / 2, 242 / 163 / 4, 140 / 164 / 2, 130 / 165 / 2, 179 / 166 / 4, 158 / 167 / 2, 112 / 168 / 2, 200 / 169 / 2, 95 / 170 / 2, 125 / 171 / 2, 3 / 172 / 2, 94 / 173 / 4, 122 / 174 / 2, 121 / 175 / 2, 61 / 176 / 3, 207 / 177 / 2, 213 / 178 / 3, 217 / 179 / 2, 156 / 180 / 2, 72 / 181 / 2, 153 / 182 / 8, 27 / 183 / 2, 105 / 184 / 2, 126 / 185 / 3, 201 / 186 / 2, 70 / 187 / 2, 66 / 188 / 2, 139 / 189 / 3, 215 / 190 / 2, 129 / 191 / 3, 29 / 192 / 2, 98 / 193 / 2, 25 / 194 / 3, 50 / 195 / 2, 45 / 196 / 2, 150 / 197 / 2, 128 / 198 / 3, 64 / 199 / 2, 89 / 200 / 2, 132 / 201 / 2, 9 / 202 / 3, 198 / 203 / 2, 84 / 204 / 2, 203 / 205 / 3, 134 / 206 / 2, 62 / 207 / 3, 21 / 208 / 2, 63 / 209 / 2, 6 / 210 / 2, 124 / 211 / 3, 47 / 212 / 2, 211 / 213 / 2, 210 / 214 / 2, 249 / 215 / 3, 56 / 216 / 2, 208 / 217 / 3, 135 / 218 / 2, 174 / 219 / 2, 187 / 220 / 3, 235 / 221 / 2, 87 / 222 / 2, 48 / 223 / 5, 159 / 224 / 2, 220 / 225 / 2, 138 / 226 / 2, 38 / 227 / 2, 30 / 228 / 2, 40 / 229 / 2, 230 / 230 / 3, 163 / 231 / 2, 227 / 232 / 2, 248 / 233 / 4, 194 / 234 / 2, 149 / 235 / 2, 237 / 236 / 3, 151 / 237 / 2, 5 / 238 / 2, 115 / 239 / 2, 23 / 240 / 4, 68 / 241 / 2, 182 / 242 / 3, 244 / 243 / 2, 81 / 244 / 2, 247 / 245 / 2, 197 / 246 / 2, 12 / 247 / 7, 214 / 248 / 2, 136 / 249 / 3
singlecenter-alpha_1-4-n375.txt, 1, 1, 375, 2898.08, 3059, 2684, 8, 374,18 / 1 / 3, 165 / 2 / 2, 243 / 3 / 2, 122 / 4 / 3, 193 / 5 / 2, 55 / 6 / 2, 326 / 7 / 3, 367 / 8 / 2, 219 / 9 / 4, 34 / 10 / 2, 262 / 11 / 3, 306 / 12 / 2, 8 / 13 / 2, 321 / 14 / 3, 181 / 15 / 2, 273 / 16 / 2, 319 / 17 / 3, 278 / 18 / 2, 269 / 19 / 3, 311 / 20 / 2, 48 / 21 / 2, 107 / 22 / 4, 190 / 23 / 2, 227 / 24 / 2, 157 / 25 / 2, 260 / 26 / 2, 236 / 27 / 4, 46 / 28 / 2, 72 / 29 / 2, 374 / 30 / 4, 30 / 31 / 2, 14 / 32 / 2, 282 / 33 / 2, 252 / 34 / 3, 244 / 35 / 2, 304 / 36 / 3, 197 / 37 / 2, 104 / 38 / 2, 27 / 39 / 3, 114 / 40 / 2, 323 / 41 / 2, 188 / 42 / 2, 369 / 43 / 3, 116 / 44 / 2, 167 / 45 / 7, 253 / 46 / 2, 208 / 47 / 2, 11 / 48 / 3, 263 / 49 / 2, 13 / 50 / 2, 125 / 51 / 2, 63 / 52 / 3, 347 / 53 / 2, 58 / 54 / 2, 289 / 55 / 2, 32 / 56 / 4, 341 / 57 / 2, 241 / 58 / 2, 67 / 59 / 3, 222 / 60 / 2, 98 / 61 / 3, 155 / 62 / 2, 171 / 63 / 2, 148 / 64 / 2, 351 / 65 / 2, 235 / 66 / 2, 87 / 67 / 3, 19 / 68 / 2, 139 / 69 / 2, 364 / 70 / 3, 47 / 71 / 2, 303 / 72 / 2, 353 / 73 / 4, 295 / 74 / 2, 287 / 75 / 2, 274 / 76 / 2, 284 / 77 / 3, 146 / 78 / 2, 250 / 79 / 3, 194 / 80 / 2, 177 / 81 / 3, 371 / 82 / 2, 96 / 83 / 2, 237 / 84 / 2, 248 / 85 / 4, 333 / 86 / 2, 170 / 87 / 2, 137 / 88 / 3, 281 / 89 / 2, 3 / 90 / 3, 6 / 91 / 2, 159 / 92 / 3, 70 / 93 / 2, 150 / 94 / 2, 202 / 95 / 3, 127 / 96 / 2, 169 / 97 / 5, 123 / 98 / 2, 92 / 99 / 2, 110 / 100 / 2, 372 / 101 / 2, 349 / 102 / 2, 166 / 103 / 4, 215 / 104 / 2, 207 / 105 / 2, 300 / 106 / 4, 95 / 107 / 2, 216 / 108 / 3, 77 / 109 / 2, 261 / 110 / 2, 325 / 111 / 2, 361 / 112 / 5, 21 / 113 / 2, 257 / 114 / 2, 302 / 115 / 2, 233 / 116 / 5, 275 / 117 / 2, 312 / 118 / 2, 97 / 119 / 2, 152 / 120 / 3, 279 / 121 / 2, 131 / 122 / 3, 213 / 123 / 2, 128 / 124 / 3, 187 / 125 / 2, 111 / 126 / 2, 101 / 127 / 3, 314 / 128 / 2, 225 / 129 / 3, 196 / 130 / 2, 339 / 131 / 2, 178 / 132 / 4, 90 / 133 / 2, 45 / 134 / 2, 292 / 135 / 2, 88 / 136 / 3, 147 / 137 / 2, 29 / 138 / 4, 185 / 139 / 2, 162 / 140 / 2, 240 / 141 / 4, 271 / 142 / 2, 342 / 143 / 2, 318 / 144 / 2, 344 / 145 / 2, 343 / 146 / 2, 221 / 147 / 2, 297 / 148 / 2, 298 / 149 / 4, 37 / 150 / 2, 5 / 151 / 3, 36 / 152 / 2, 182 / 153 / 2, 365 / 154 / 2, 52 / 155 / 2, 82 / 156 / 2, 158 / 157 / 4, 255 / 158 / 2, 138 / 159 / 2, 26 / 160 / 5, 73 / 161 / 2, 84 / 162 / 2, 65 / 163 / 2, 9 / 164 / 2, 12 / 165 / 2, 149 / 166 / 4, 120 / 167 / 2, 38 / 168 / 3, 211 / 169 / 2, 136 / 170 / 2, 277 / 171 / 2, 141 / 172 / 2, 174 / 173 / 3, 357 / 174 / 2, 329 / 175 / 3, 119 / 176 / 2, 40 / 177 / 2, 337 / 178 / 2, 267 / 179 / 3, 59 / 180 / 2, 201 / 181 / 3, 345 / 182 / 2, 358 / 183 / 2, 68 / 184 / 2, 93 / 185 / 5, 57 / 186 / 2, 293 / 187 / 3, 160 / 188 / 2, 230 / 189 / 2, 154 / 190 / 2, 316 / 191 / 2, 218 / 192 / 2, 346 / 193 / 3, 113 / 194 / 2, 363 / 195 / 2, 327 / 196 / 3, 124 / 197 / 2, 1 / 198 / 2, 191 / 199 / 2, 76 / 200 / 2, 151 / 201 / 3, 370 / 202 / 2, 206 / 203 / 3, 204 / 204 / 2, 228 / 205 / 3, 200 / 206 / 2, 74 / 207 / 4, 130 / 208 / 2, 203 / 209 / 2, 310 / 210 / 2, 102 / 211 / 4, 313 / 212 / 2, 79 / 213 / 2, 224 / 214 / 3, 309 / 215 / 2, 64 / 216 / 2, 315 / 217 / 2, 258 / 218 / 3, 283 / 219 / 2, 212 / 220 / 3, 42 / 221 / 2, 133 / 222 / 2, 245 / 223 / 2, 71 / 224 / 3, 4 / 225 / 2, 53 / 226 / 2, 33 / 227 / 3, 270 / 228 / 2, 126 / 229 / 3, 61 / 230 / 2, 15 / 231 / 3, 280 / 232 / 2, 25 / 233 / 2, 359 / 234 / 3, 83 / 235 / 2, 334 / 236 / 3, 192 / 237 / 2, 144 / 238 / 2, 172 / 239 / 3, 356 / 240 / 2, 259 / 241 / 2, 103 / 242 / 4, 350 / 243 / 2, 189 / 244 / 2, 232 / 245 / 2, 251 / 246 / 3, 91 / 247 / 2, 229 / 248 / 3, 35 / 249 / 2, 373 / 250 / 3, 135 / 251 / 2, 161 / 252 / 3, 238 / 253 / 2, 320 / 254 / 2, 85 / 255 / 2, 106 / 256 / 5, 50 / 257 / 2, 66 / 258 / 2, 276 / 259 / 2, 10 / 260 / 4, 7 / 261 / 2, 366 / 262 / 3, 217 / 263 / 2, 69 / 264 / 2, 60 / 265 / 3, 362 / 266 / 2, 153 / 267 / 3, 16 / 268 / 2, 173 / 269 / 4, 226 / 270 / 2, 22 / 271 / 2, 247 / 272 / 3, 105 / 273 / 2, 223 / 274 / 3, 54 / 275 / 2, 20 / 276 / 2, 246 / 277 / 2, 62 / 278 / 2, 264 / 279 / 3, 368 / 280 / 2, 86 / 281 / 4, 168 / 282 / 2, 175 / 283 / 2, 354 / 284 / 3, 338 / 285 / 2, 75 / 286 / 3, 249 / 287 / 2, 49 / 288 / 2, 231 / 289 / 2, 81 / 290 / 2, 234 / 291 / 2, 44 / 292 / 3, 242 / 293 / 2, 109 / 294 / 2, 164 / 295 / 3, 28 / 296 / 2, 268 / 297 / 2, 254 / 298 / 2, 94 / 299 / 2, 142 / 300 / 2, 51 / 301 / 2, 195 / 302 / 3, 317 / 303 / 2, 24 / 304 / 2, 305 / 305 / 2, 296 / 306 / 2, 2 / 307 / 4, 134 / 308 / 2, 186 / 309 / 2, 99 / 310 / 3, 324 / 311 / 2, 336 / 312 / 4, 331 / 313 / 2, 176 / 314 / 2, 272 / 315 / 2, 143 / 316 / 2, 332 / 317 / 2, 355 / 318 / 5, 179 / 319 / 2, 118 / 320 / 2, 294 / 321 / 3, 89 / 322 / 2, 31 / 323 / 3, 112 / 324 / 2, 140 / 325 / 3, 322 / 326 / 2, 286 / 327 / 8, 145 / 328 / 2, 129 / 329 / 3, 132 / 330 / 2, 80 / 331 / 2, 163 / 332 / 2, 214 / 333 / 2, 39 / 334 / 2, 180 / 335 / 2, 348 / 336 / 2, 220 / 337 / 3, 78 / 338 / 2, 335 / 339 / 5, 330 / 340 / 2, 360 / 341 / 2, 23 / 342 / 2, 266 / 343 / 5, 265 / 344 / 2, 117 / 345 / 3, 308 / 346 / 2, 198 / 347 / 2, 108 / 348 / 2, 285 / 349 / 4, 210 / 350 / 2, 352 / 351 / 2, 43 / 352 / 5, 100 / 353 / 2, 288 / 354 / 2, 17 / 355 / 2, 199 / 356 / 4, 299 / 357 / 2, 205 / 358 / 2, 340 / 359 / 3, 301 / 360 / 2, 256 / 361 / 3, 290 / 362 / 2, 115 / 363 / 2, 41 / 364 / 4, 307 / 365 / 2, 291 / 366 / 2, 184 / 367 / 3, 156 / 368 / 2, 121 / 369 / 3, 209 / 370 / 2, 239 / 371 / 3, 56 / 372 / 2, 183 / 373 / 2, 328 / 374 / 3
singlecenter-alpha_1-4-n5.txt, 1, 1, 5, 247.616, 20, 15, 5, 4,2 / 1 / 5, 3 / 2 / 2, 4 / 3 / 2, 1 / 4 / 4
singlecenter-alpha_1-40-n8.txt, 1, 1, 8, 407.249, 45, 37, 6, 7,7 / 1 / 3, 2 / 2 / 2, 1 / 3 / 5, 4 / 4 / 2, 5 / 5 / 2, 6 / 6 / 2, 3 / 7 / 6
singlecenter-alpha_1-41-n9.txt, 1, 1, 9, 255.054, 50, 41, 5, 8,1 / 1 / 2, 8 / 2 / 5, 6 / 3 / 2, 3 / 4 / 2, 7 / 5 / 2, 5 / 6 / 5, 2 / 7 / 2, 4 / 8 / 2
singlecenter-alpha_1-42-n9.txt, 1, 1, 9, 581.108, 53, 44, 9, 8,7 / 1 / 3, 5 / 2 / 2, 3 / 3 / 2, 1 / 4 / 9, 6 / 5 / 2, 4 / 6 / 2, 8 / 7 / 2, 2 / 8 / 2
singlecenter-alpha_1-43-n9.txt, 1, 1, 9, 355.437, 47, 38, 4, 8,4 / 1 / 4, 8 / 2 / 2, 1 / 3 / 2, 3 / 4 / 4, 7 / 5 / 2, 2 / 6 / 2, 5 / 7 / 3, 6 / 8 / 2
singlecenter-alpha_1-44-n9.txt, 1, 1, 9, 368.246, 41, 32, 3, 8,6 / 1 / 3, 3 / 2 / 2, 1 / 3 / 3, 4 / 4 / 2, 8 / 5 / 3, 5 / 6 / 2, 7 / 7 / 2, 2 / 8 / 2
singlecenter-alpha_1-45-n9.txt, 1, 1, 9, 410.12, 45, 36, 5, 8,4 / 1 / 5, 2 / 2 / 2, 5 / 3 / 2, 8 / 4 / 3, 7 / 5 / 2, 3 / 6 / 2, 1 / 7 / 2, 6 / 8 / 2
singlecenter-alpha_1-46-n9.txt, 1, 1, 9, 384.391, 51, 42, 5, 8,8 / 1 / 3, 2 / 2 / 2, 5 / 3 / 2, 1 / 4 / 2, 4 / 5 / 5, 6 / 6 / 2, 3 / 7 / 2, 7 / 8 / 3
singlecenter-alpha_1-47-n9.txt, 1, 1, 9, 522.804, 44, 35, 3, 8,6 / 1 / 3, 3 / 2 / 2, 5 / 3 / 3, 4 / 4 / 2, 7 / 5 / 2, 8 / 6 / 2, 1 / 7 / 2, 2 / 8 / 3
singlecenter-alpha_1-48-n9.txt, 1, 1, 9, 365.626, 44, 35, 3, 8,8 / 1 / 3, 6 / 2 / 2, 4 / 3 / 3, 5 / 4 / 2, 1 / 5 / 3, 3 / 6 / 2, 7 / 7 / 2, 2 / 8 / 3
singlecenter-alpha_1-49-n9.txt, 1, 1, 9, 506.407, 45, 36, 3, 8,8 / 1 / 2, 7 / 2 / 2, 6 / 3 / 3, 5 / 4 / 2, 3 / 5 / 3, 4 / 6 / 2, 1 / 7 / 3, 2 / 8 / 2
singlecenter-alpha_1-5-n250.txt, 1, 1, 250, 2442.44, 1984, 1734, 10, 249,205 / 1 / 4, 26 / 2 / 2, 155 / 3 / 2, 124 / 4 / 4, 199 / 5 / 2, 126 / 6 / 2, 102 / 7 / 3, 72 / 8 / 2, 120 / 9 / 3, 83 / 10 / 2, 179 / 11 / 2, 113 / 12 / 3, 51 / 13 / 2, 163 / 14 / 3, 84 / 15 / 2, 218 / 16 / 2, 60 / 17 / 2, 151 / 18 / 2, 176 / 19 / 2, 148 / 20 / 2, 43 / 21 / 3, 37 / 22 / 2, 188 / 23 / 3, 189 / 24 / 2, 217 / 25 / 3, 159 / 26 / 2, 185 / 27 / 3, 170 / 28 / 2, 248 / 29 / 2, 49 / 30 / 3, 242 / 31 / 2, 201 / 32 / 2, 100 / 33 / 2, 215 / 34 / 2, 98 / 35 / 2, 115 / 36 / 2, 162 / 37 / 3, 117 / 38 / 2, 67 / 39 / 2, 227 / 40 / 3, 174 / 41 / 2, 4 / 42 / 2, 66 / 43 / 2, 81 / 44 / 2, 17 / 45 / 3, 111 / 46 / 2, 168 / 47 / 3, 237 / 48 / 2, 68 / 49 / 2, 63 / 50 / 2, 232 / 51 / 2, 169 / 52 / 2, 167 / 53 / 2, 243 / 54 / 2, 226 / 55 / 3, 57 / 56 / 2, 74 / 57 / 2, 106 / 58 / 3, 86 / 59 / 2, 118 / 60 / 3, 156 / 61 / 2, 172 / 62 / 2, 119 / 63 / 2, 136 / 64 / 2, 135 / 65 / 2, 193 / 66 / 6, 203 / 67 / 2, 38 / 68 / 2, 216 / 69 / 3, 145 / 70 / 2, 89 / 71 / 2, 198 / 72 / 4, 7 / 73 / 2, 149 / 74 / 2, 69 / 75 / 2, 204 / 76 / 2, 75 / 77 / 2, 62 / 78 / 4, 206 / 79 / 2, 241 / 80 / 2, 214 / 81 / 3, 39 / 82 / 2, 45 / 83 / 3, 190 / 84 / 2, 97 / 85 / 2, 220 / 86 / 2, 103 / 87 / 3, 144 / 88 / 2, 64 / 89 / 2, 22 / 90 / 3, 114 / 91 / 2, 125 / 92 / 4, 40 / 93 / 2, 11 / 94 / 2, 88 / 95 / 2, 192 / 96 / 2, 182 / 97 / 2, 20 / 98 / 2, 55 / 99 / 2, 224 / 100 / 2, 3 / 101 / 3, 150 / 102 / 2, 211 / 103 / 2, 33 / 104 / 2, 104 / 105 / 3, 231 / 106 / 2, 5 / 107 / 3, 160 / 108 / 2, 128 / 109 / 2, 12 / 110 / 2, 127 / 111 / 4, 222 / 112 / 2, 246 / 113 / 2, 158 / 114 / 3, 178 / 115 / 2, 32 / 116 / 3, 175 / 117 / 2, 202 / 118 / 3, 234 / 119 / 2, 152 / 120 / 2, 180 / 121 / 2, 138 / 122 / 2, 50 / 123 / 2, 91 / 124 / 2, 46 / 125 / 3, 154 / 126 / 2, 19 / 127 / 3, 58 / 128 / 2, 177 / 129 / 2, 197 / 130 / 4, 225 / 131 / 2, 52 / 132 / 2, 105 / 133 / 2, 76 / 134 / 3, 48 / 135 / 2, 236 / 136 / 4, 213 / 137 / 2, 77 / 138 / 2, 54 / 139 / 3, 173 / 140 / 2, 164 / 141 / 2, 80 / 142 / 2, 219 / 143 / 4, 14 / 144 / 2, 6 / 145 / 2, 131 / 146 / 2, 9 / 147 / 10, 23 / 148 / 2, 141 / 149 / 2, 73 / 150 / 2, 166 / 151 / 2, 240 / 152 / 3, 239 / 153 / 2, 207 / 154 / 2, 132 / 155 / 2, 165 / 156 / 2, 94 / 157 / 2, 53 / 158 / 2, 112 / 159 / 3, 95 / 160 / 2, 137 / 161 / 3, 228 / 162 / 2, 247 / 163 / 2, 8 / 164 / 2, 41 / 165 / 2, 27 / 166 / 2, 134 / 167 / 3, 196 / 168 / 2, 183 / 169 / 2, 122 / 170 / 2, 65 / 171 / 3, 79 / 172 / 2, 244 / 173 / 3, 121 / 174 / 2, 30 / 175 / 2, 233 / 176 / 2, 36 / 177 / 2, 129 / 178 / 2, 18 / 179 / 2, 209 / 180 / 2, 194 / 181 / 2, 139 / 182 / 3, 245 / 183 / 2, 56 / 184 / 2, 133 / 185 / 3, 35 / 186 / 2, 238 / 187 / 2, 153 / 188 / 2, 90 / 189 / 3, 140 / 190 / 2, 107 / 191 / 3, 87 / 192 / 2, 31 / 193 / 3, 24 / 194 / 2, 101 / 195 / 2, 147 / 196 / 2, 249 / 197 / 3, 108 / 198 / 2, 93 / 199 / 3, 212 / 200 / 2, 25 / 201 / 2, 181 / 202 / 2, 70 / 203 / 2, 210 / 204 / 2, 142 / 205 / 4, 230 / 206 / 2, 187 / 207 / 2, 191 / 208 / 3, 10 / 209 / 2, 123 / 210 / 2, 171 / 211 / 3, 157 / 212 / 2, 99 / 213 / 3, 21 / 214 / 2, 186 / 215 / 2, 28 / 216 / 3, 85 / 217 / 2, 1 / 218 / 3, 44 / 219 / 2, 29 / 220 / 2, 42 / 221 / 2, 34 / 222 / 2, 200 / 223 / 2, 208 / 224 / 5, 82 / 225 / 2, 47 / 226 / 2, 61 / 227 / 2, 229 / 228 / 2, 110 / 229 / 2, 13 / 230 / 2, 184 / 231 / 2, 109 / 232 / 3, 59 / 233 / 2, 2 / 234 / 3, 146 / 235 / 2, 143 / 236 / 2, 195 / 237 / 2, 78 / 238 / 2, 161 / 239 / 2, 92 / 240 / 2, 235 / 241 / 2, 223 / 242 / 2, 15 / 243 / 2, 116 / 244 / 2, 16 / 245 / 2, 221 / 246 / 2, 130 / 247 / 3, 71 / 248 / 2, 96 / 249 / 3
singlecenter-alpha_1-5-n5.txt, 1, 1, 5, 248.933, 20, 15, 5, 4,4 / 1 / 4, 3 / 2 / 2, 2 / 3 / 2, 1 / 4 / 5
singlecenter-alpha_1-5-n500.txt, 1, 1, 500, 3170.44, 3980, 3480, 8, 499,419 / 1 / 2, 404 / 2 / 2, 130 / 3 / 2, 284 / 4 / 2, 497 / 5 / 2, 426 / 6 / 8, 380 / 7 / 2, 379 / 8 / 2, 260 / 9 / 2, 259 / 10 / 3, 286 / 11 / 2, 245 / 12 / 2, 313 / 13 / 7, 186 / 14 / 2, 329 / 15 / 3, 154 / 16 / 2, 372 / 17 / 3, 320 / 18 / 2, 125 / 19 / 3, 198 / 20 / 2, 114 / 21 / 5, 311 / 22 / 2, 213 / 23 / 2, 87 / 24 / 2, 27 / 25 / 5, 98 / 26 / 2, 267 / 27 / 2, 390 / 28 / 3, 339 / 29 / 2, 53 / 30 / 2, 459 / 31 / 3, 391 / 32 / 2, 366 / 33 / 2, 285 / 34 / 4, 32 / 35 / 2, 192 / 36 / 3, 49 / 37 / 2, 345 / 38 / 2, 133 / 39 / 3, 343 / 40 / 2, 269 / 41 / 2, 234 / 42 / 4, 103 / 43 / 2, 238 / 44 / 2, 208 / 45 / 2, 367 / 46 / 2, 180 / 47 / 5, 223 / 48 / 2, 41 / 49 / 3, 443 / 50 / 2, 403 / 51 / 2, 359 / 52 / 2, 387 / 53 / 2, 46 / 54 / 2, 298 / 55 / 2, 237 / 56 / 3, 292 / 57 / 2, 56 / 58 / 3, 20 / 59 / 2, 127 / 60 / 2, 243 / 61 / 2, 327 / 62 / 2, 160 / 63 / 2, 475 / 64 / 2, 117 / 65 / 2, 131 / 66 / 2, 378 / 67 / 4, 140 / 68 / 2, 314 / 69 / 2, 11 / 70 / 2, 195 / 71 / 4, 413 / 72 / 2, 315 / 73 / 3, 233 / 74 / 2, 441 / 75 / 2, 113 / 76 / 3, 490 / 77 / 2, 241 / 78 / 3, 197 / 79 / 2, 229 / 80 / 2, 218 / 81 / 4, 406 / 82 / 2, 72 / 83 / 2, 162 / 84 / 3, 8 / 85 / 2, 309 / 86 / 2, 408 / 87 / 2, 170 / 88 / 2, 360 / 89 / 2, 82 / 90 / 2, 349 / 91 / 2, 496 / 92 / 2, 342 / 93 / 3, 91 / 94 / 2, 143 / 95 / 2, 128 / 96 / 2, 263 / 97 / 4, 191 / 98 / 2, 147 / 99 / 2, 156 / 100 / 3, 365 / 101 / 2, 478 / 102 / 2, 216 / 103 / 2, 291 / 104 / 2, 15 / 105 / 2, 450 / 106 / 2, 457 / 107 / 2, 67 / 108 / 4, 78 / 109 / 2, 200 / 110 / 2, 442 / 111 / 2, 181 / 112 / 2, 18 / 113 / 2, 253 / 114 / 3, 13 / 115 / 2, 467 / 116 / 6, 74 / 117 / 2, 65 / 118 / 2, 34 / 119 / 2, 275 / 120 / 2, 488 / 121 / 3, 374 / 122 / 2, 375 / 123 / 2, 319 / 124 / 2, 453 / 125 / 2, 418 / 126 / 3, 445 / 127 / 2, 142 / 128 / 2, 73 / 129 / 3, 52 / 130 / 2, 336 / 131 / 2, 145 / 132 / 2, 306 / 133 / 2, 495 / 134 / 2, 104 / 135 / 2, 301 / 136 / 2, 250 / 137 / 2, 432 / 138 / 2, 51 / 139 / 5, 37 / 140 / 2, 25 / 141 / 2, 486 / 142 / 3, 256 / 143 / 2, 63 / 144 / 3, 429 / 145 / 2, 169 / 146 / 2, 244 / 147 / 2, 283 / 148 / 5, 126 / 149 / 2, 480 / 150 / 2, 194 / 151 / 2, 398 / 152 / 2, 97 / 153 / 2, 35 / 154 / 2, 305 / 155 / 2, 373 / 156 / 2, 189 / 157 / 2, 307 / 158 / 2, 84 / 159 / 3, 362 / 160 / 2, 261 / 161 / 2, 330 / 162 / 2, 235 / 163 / 4, 410 / 164 / 2, 151 / 165 / 2, 397 / 166 / 2, 331 / 167 / 2, 499 / 168 / 4, 289 / 169 / 2, 202 / 170 / 2, 158 / 171 / 6, 458 / 172 / 2, 122 / 173 / 2, 70 / 174 / 2, 431 / 175 / 4, 239 / 176 / 2, 38 / 177 / 2, 148 / 178 / 2, 123 / 179 / 4, 447 / 180 / 2, 321 / 181 / 2, 340 / 182 / 3, 102 / 183 / 2, 399 / 184 / 4, 392 / 185 / 2, 421 / 186 / 2, 184 / 187 / 2, 185 / 188 / 3, 212 / 189 / 2, 411 / 190 / 2, 90 / 191 / 2, 323 / 192 / 3, 178 / 193 / 2, 308 / 194 / 2, 348 / 195 / 4, 173 / 196 / 2, 405 / 197 / 2, 454 / 198 / 5, 4 / 199 / 2, 221 / 200 / 3, 227 / 201 / 2, 280 / 202 / 3, 107 / 203 / 2, 31 / 204 / 2, 384 / 205 / 2, 33 / 206 / 2, 326 / 207 / 3, 377 / 208 / 2, 119 / 209 / 2, 452 / 210 / 3, 134 / 211 / 2, 302 / 212 / 2, 296 / 213 / 3, 89 / 214 / 2, 177 / 215 / 2, 310 / 216 / 2, 188 / 217 / 2, 219 / 218 / 3, 444 / 219 / 2, 294 / 220 / 3, 23 / 221 / 2, 325 / 222 / 2, 137 / 223 / 3, 338 / 224 / 2, 240 / 225 / 2, 36 / 226 / 4, 423 / 227 / 2, 434 / 228 / 2, 1 / 229 / 2, 252 / 230 / 2, 425 / 231 / 2, 415 / 232 / 3, 139 / 233 / 2, 322 / 234 / 2, 161 / 235 / 2, 470 / 236 / 2, 157 / 237 / 3, 92 / 238 / 2, 479 / 239 / 2, 420 / 240 / 2, 394 / 241 / 3, 462 / 242 / 2, 6 / 243 / 2, 19 / 244 / 4, 149 / 245 / 2, 254 / 246 / 2, 449 / 247 / 2, 290 / 248 / 3, 115 / 249 / 2, 388 / 250 / 2, 278 / 251 / 3, 220 / 252 / 2, 209 / 253 / 3, 150 / 254 / 2, 352 / 255 / 2, 355 / 256 / 4, 80 / 257 / 2, 332 / 258 / 2, 48 / 259 / 2, 14 / 260 / 2, 317 / 261 / 2, 303 / 262 / 2, 199 / 263 / 3, 146 / 264 / 2, 393 / 265 / 2, 207 / 266 / 2, 66 / 267 / 3, 382 / 268 / 2, 463 / 269 / 2, 356 / 270 / 2, 433 / 271 / 2, 417 / 272 / 6, 24 / 273 / 2, 416 / 274 / 2, 55 / 275 / 2, 47 / 276 / 3, 412 / 277 / 2, 386 / 278 / 6, 437 / 279 / 2, 334 / 280 / 3, 29 / 281 / 2, 43 / 282 / 2, 363 / 283 / 2, 357 / 284 / 3, 247 / 285 / 2, 167 / 286 / 2, 347 / 287 / 3, 101 / 288 / 2, 205 / 289 / 2, 409 / 290 / 2, 274 / 291 / 2, 282 / 292 / 2, 440 / 293 / 3, 428 / 294 / 2, 335 / 295 / 2, 328 / 296 / 2, 461 / 297 / 3, 465 / 298 / 2, 120 / 299 / 2, 112 / 300 / 3, 299 / 301 / 2, 10 / 302 / 3, 248 / 303 / 2, 264 / 304 / 2, 9 / 305 / 2, 204 / 306 / 4, 206 / 307 / 2, 368 / 308 / 2, 271 / 309 / 5, 76 / 310 / 2, 346 / 311 / 2, 481 / 312 / 2, 176 / 313 / 3, 277 / 314 / 2, 62 / 315 / 2, 477 / 316 / 3, 228 / 317 / 2, 460 / 318 / 3, 108 / 319 / 2, 166 / 320 / 2, 493 / 321 / 2, 414 / 322 / 3, 214 / 323 / 2, 251 / 324 / 4, 132 / 325 / 2, 438 / 326 / 2, 71 / 327 / 2, 383 / 328 / 2, 64 / 329 / 2, 40 / 330 / 2, 230 / 331 / 2, 272 / 332 / 2, 472 / 333 / 2, 183 / 334 / 2, 231 / 335 / 2, 435 / 336 / 3, 401 / 337 / 2, 257 / 338 / 2, 381 / 339 / 2, 26 / 340 / 2, 211 / 341 / 3, 110 / 342 / 2, 2 / 343 / 3, 364 / 344 / 2, 439 / 345 / 4, 422 / 346 / 2, 436 / 347 / 2, 370 / 348 / 2, 354 / 349 / 2, 297 / 350 / 4, 85 / 351 / 2, 201 / 352 / 3, 136 / 353 / 2, 164 / 354 / 2, 246 / 355 / 2, 427 / 356 / 2, 58 / 357 / 2, 95 / 358 / 4, 118 / 359 / 2, 255 / 360 / 3, 484 / 361 / 2, 39 / 362 / 2, 265 / 363 / 3, 28 / 364 / 2, 396 / 365 / 2, 395 / 366 / 3, 225 / 367 / 2, 226 / 368 / 2, 45 / 369 / 2, 165 / 370 / 2, 121 / 371 / 4, 203 / 372 / 2, 42 / 373 / 2, 171 / 374 / 2, 266 / 375 / 2, 469 / 376 / 2, 111 / 377 / 2, 175 / 378 / 3, 273 / 379 / 2, 430 / 380 / 3, 57 / 381 / 2, 232 / 382 / 2, 174 / 383 / 2, 215 / 384 / 2, 351 / 385 / 2, 69 / 386 / 3, 163 / 387 / 2, 54 / 388 / 2, 262 / 389 / 6, 376 / 390 / 2, 333 / 391 / 2, 12 / 392 / 3, 492 / 393 / 2, 258 / 394 / 3, 217 / 395 / 2, 451 / 396 / 2, 116 / 397 / 3, 485 / 398 / 2, 456 / 399 / 3, 182 / 400 / 2, 138 / 401 / 2, 16 / 402 / 2, 483 / 403 / 2, 79 / 404 / 2, 196 / 405 / 2, 295 / 406 / 3, 88 / 407 / 2, 187 / 408 / 3, 153 / 409 / 2, 155 / 410 / 2, 487 / 411 / 4, 190 / 412 / 2, 491 / 413 / 2, 466 / 414 / 3, 464 / 415 / 2, 279 / 416 / 3, 316 / 417 / 2, 68 / 418 / 3, 222 / 419 / 2, 172 / 420 / 3, 489 / 421 / 2, 402 / 422 / 2, 407 / 423 / 3, 141 / 424 / 2, 75 / 425 / 3, 129 / 426 / 2, 3 / 427 / 3, 474 / 428 / 2, 249 / 429 / 2, 100 / 430 / 2, 353 / 431 / 3, 270 / 432 / 2, 59 / 433 / 2, 159 / 434 / 4, 473 / 435 / 2, 44 / 436 / 3, 293 / 437 / 2, 476 / 438 / 2, 389 / 439 / 3, 446 / 440 / 2, 17 / 441 / 2, 7 / 442 / 6, 21 / 443 / 2, 193 / 444 / 3, 50 / 445 / 2, 312 / 446 / 2, 371 / 447 / 3, 94 / 448 / 2, 455 / 449 / 3, 77 / 450 / 2, 106 / 451 / 2, 471 / 452 / 2, 304 / 453 / 2, 179 / 454 / 3, 468 / 455 / 2, 242 / 456 / 3, 61 / 457 / 2, 135 / 458 / 3, 268 / 459 / 2, 5 / 460 / 2, 482 / 461 / 2, 86 / 462 / 3, 124 / 463 / 2, 361 / 464 / 3, 276 / 465 / 2, 344 / 466 / 3, 324 / 467 / 2, 168 / 468 / 2, 30 / 469 / 2, 22 / 470 / 2, 99 / 471 / 2, 385 / 472 / 3, 105 / 473 / 2, 152 / 474 / 2, 337 / 475 / 2, 287 / 476 / 3, 300 / 477 / 2, 288 / 478 / 3, 96 / 479 / 2, 81 / 480 / 3, 424 / 481 / 2, 83 / 482 / 3, 236 / 483 / 2, 498 / 484 / 2, 210 / 485 / 2, 358 / 486 / 2, 93 / 487 / 3, 400 / 488 / 2, 448 / 489 / 2, 350 / 490 / 2, 224 / 491 / 2, 109 / 492 / 2, 281 / 493 / 2, 318 / 494 / 2, 369 / 495 / 3, 144 / 496 / 2, 341 / 497 / 2, 494 / 498 / 2, 60 / 499 / 2
singlecenter-alpha_1-50-n9.txt, 1, 1, 9, 367.104, 43, 34, 3, 8,4 / 1 / 2, 7 / 2 / 3, 5 / 3 / 2, 6 / 4 / 3, 1 / 5 / 2, 2 / 6 / 3, 8 / 7 / 2, 3 / 8 / 2
singlecenter-alpha_1-51-n10.txt, 1, 1, 10, 445.377, 66, 56, 5, 9,3 / 1 / 2, 9 / 2 / 4, 1 / 3 / 2, 8 / 4 / 2, 5 / 5 / 5, 4 / 6 / 2, 7 / 7 / 2, 6 / 8 / 2, 2 / 9 / 3
singlecenter-alpha_1-52-n10.txt, 1, 1, 10, 389.494, 64, 54, 6, 9,9 / 1 / 6, 1 / 2 / 2, 2 / 3 / 2, 8 / 4 / 3, 6 / 5 / 2, 4 / 6 / 6, 3 / 7 / 2, 7 / 8 / 2, 5 / 9 / 4
singlecenter-alpha_1-53-n10.txt, 1, 1, 10, 517.621, 66, 56, 7, 9,7 / 1 / 7, 3 / 2 / 2, 5 / 3 / 3, 8 / 4 / 2, 4 / 5 / 2, 1 / 6 / 6, 2 / 7 / 2, 9 / 8 / 2, 6 / 9 / 3
singlecenter-alpha_1-54-n10.txt, 1, 1, 10, 532.214, 56, 46, 6, 9,3 / 1 / 2, 9 / 2 / 6, 5 / 3 / 2, 8 / 4 / 2, 4 / 5 / 2, 7 / 6 / 2, 2 / 7 / 3, 1 / 8 / 2, 6 / 9 / 2
singlecenter-alpha_1-55-n10.txt, 1, 1, 10, 411.404, 53, 43, 3, 9,9 / 1 / 2, 5 / 2 / 3, 3 / 3 / 2, 7 / 4 / 2, 8 / 5 / 3, 4 / 6 / 2, 1 / 7 / 3, 6 / 8 / 2, 2 / 9 / 3
singlecenter-alpha_1-56-n10.txt, 1, 1, 10, 533.079, 52, 42, 3, 9,4 / 1 / 2, 2 / 2 / 3, 5 / 3 / 2, 9 / 4 / 2, 6 / 5 / 3, 1 / 6 / 2, 7 / 7 / 3, 3 / 8 / 2, 8 / 9 / 2
singlecenter-alpha_1-57-n10.txt, 1, 1, 10, 392.738, 62, 52, 5, 9,2 / 1 / 2, 3 / 2 / 2, 4 / 3 / 2, 1 / 4 / 2, 8 / 5 / 5, 5 / 6 / 2, 7 / 7 / 2, 6 / 8 / 2, 9 / 9 / 4
singlecenter-alpha_1-58-n10.txt, 1, 1, 10, 365.014, 64, 54, 5, 9,5 / 1 / 5, 1 / 2 / 2, 3 / 3 / 2, 8 / 4 / 2, 9 / 5 / 5, 2 / 6 / 2, 4 / 7 / 2, 6 / 8 / 4, 7 / 9 / 2
singlecenter-alpha_1-59-n10.txt, 1, 1, 10, 541.87, 51, 41, 5, 9,6 / 1 / 5, 4 / 2 / 2, 3 / 3 / 3, 5 / 4 / 2, 7 / 5 / 3, 1 / 6 / 2, 8 / 7 / 2, 2 / 8 / 2, 9 / 9 / 4
singlecenter-alpha_1-6-n250.txt, 1, 1, 250, 2114.95, 1960, 1710, 7, 249,201 / 1 / 2, 106 / 2 / 3, 119 / 3 / 2, 26 / 4 / 3, 79 / 5 / 2, 155 / 6 / 2, 98 / 7 / 3, 175 / 8 / 2, 15 / 9 / 2, 88 / 10 / 3, 152 / 11 / 2, 39 / 12 / 2, 68 / 13 / 2, 25 / 14 / 2, 48 / 15 / 6, 234 / 16 / 2, 168 / 17 / 2, 216 / 18 / 2, 187 / 19 / 4, 105 / 20 / 2, 184 / 21 / 2, 23 / 22 / 3, 99 / 23 / 2, 54 / 24 / 2, 221 / 25 / 3, 246 / 26 / 2, 27 / 27 / 2, 84 / 28 / 2, 124 / 29 / 2, 126 / 30 / 3, 63 / 31 / 2, 183 / 32 / 2, 73 / 33 / 2, 101 / 34 / 4, 76 / 35 / 2, 52 / 36 / 2, 194 / 37 / 3, 239 / 38 / 2, 45 / 39 / 2, 233 / 40 / 2, 60 / 41 / 3, 224 / 42 / 2, 150 / 43 / 2, 10 / 44 / 7, 19 / 45 / 2, 41 / 46 / 2, 198 / 47 / 2, 46 / 48 / 2, 85 / 49 / 2, 238 / 50 / 5, 199 / 51 / 2, 82 / 52 / 3, 157 / 53 / 2, 172 / 54 / 3, 215 / 55 / 2, 89 / 56 / 3, 180 / 57 / 2, 226 / 58 / 2, 107 / 59 / 2, 91 / 60 / 2, 118 / 61 / 3, 17 / 62 / 2, 44 / 63 / 2, 197 / 64 / 2, 131 / 65 / 3, 227 / 66 / 2, 8 / 67 / 2, 182 / 68 / 2, 78 / 69 / 2, 236 / 70 / 3, 170 / 71 / 2, 65 / 72 / 3, 81 / 73 / 2, 245 / 74 / 2, 140 / 75 / 2, 192 / 76 / 2, 146 / 77 / 2, 80 / 78 / 4, 6 / 79 / 2, 243 / 80 / 2, 64 / 81 / 2, 205 / 82 / 2, 195 / 83 / 3, 142 / 84 / 2, 104 / 85 / 4, 34 / 86 / 2, 154 / 87 / 2, 133 / 88 / 5, 4 / 89 / 2, 191 / 90 / 2, 70 / 91 / 4, 69 / 92 / 2, 95 / 93 / 2, 49 / 94 / 2, 56 / 95 / 4, 92 / 96 / 2, 190 / 97 / 2, 9 / 98 / 2, 203 / 99 / 3, 212 / 100 / 2, 87 / 101 / 2, 11 / 102 / 2, 144 / 103 / 2, 225 / 104 / 2, 148 / 105 / 2, 33 / 106 / 2, 164 / 107 / 2, 136 / 108 / 2, 90 / 109 / 2, 12 / 110 / 2, 121 / 111 / 2, 151 / 112 / 2, 237 / 113 / 3, 61 / 114 / 2, 179 / 115 / 2, 145 / 116 / 4, 135 / 117 / 2, 202 / 118 / 2, 43 / 119 / 6, 188 / 120 / 2, 123 / 121 / 3, 214 / 122 / 2, 138 / 123 / 2, 247 / 124 / 2, 22 / 125 / 4, 96 / 126 / 2, 139 / 127 / 2, 117 / 128 / 2, 32 / 129 / 2, 162 / 130 / 3, 200 / 131 / 2, 213 / 132 / 3, 71 / 133 / 2, 161 / 134 / 2, 51 / 135 / 2, 5 / 136 / 2, 244 / 137 / 2, 147 / 138 / 2, 35 / 139 / 2, 171 / 140 / 2, 21 / 141 / 2, 169 / 142 / 3, 109 / 143 / 2, 111 / 144 / 3, 30 / 145 / 2, 193 / 146 / 3, 93 / 147 / 2, 50 / 148 / 2, 57 / 149 / 3, 163 / 150 / 2, 128 / 151 / 2, 165 / 152 / 2, 108 / 153 / 2, 241 / 154 / 2, 55 / 155 / 2, 217 / 156 / 2, 240 / 157 / 3, 220 / 158 / 2, 18 / 159 / 3, 47 / 160 / 2, 129 / 161 / 2, 29 / 162 / 3, 177 / 163 / 2, 134 / 164 / 3, 38 / 165 / 2, 223 / 166 / 2, 77 / 167 / 2, 100 / 168 / 3, 160 / 169 / 2, 16 / 170 / 3, 31 / 171 / 2, 222 / 172 / 2, 158 / 173 / 5, 166 / 174 / 2, 232 / 175 / 2, 149 / 176 / 2, 130 / 177 / 3, 97 / 178 / 2, 112 / 179 / 3, 37 / 180 / 2, 181 / 181 / 2, 122 / 182 / 2, 204 / 183 / 2, 127 / 184 / 2, 218 / 185 / 3, 159 / 186 / 2, 209 / 187 / 3, 62 / 188 / 2, 66 / 189 / 2, 53 / 190 / 2, 110 / 191 / 3, 229 / 192 / 2, 207 / 193 / 2, 206 / 194 / 2, 1 / 195 / 2, 103 / 196 / 2, 83 / 197 / 2, 58 / 198 / 4, 185 / 199 / 2, 75 / 200 / 2, 167 / 201 / 3, 143 / 202 / 2, 156 / 203 / 2, 231 / 204 / 2, 219 / 205 / 2, 94 / 206 / 2, 28 / 207 / 2, 36 / 208 / 2, 196 / 209 / 4, 137 / 210 / 2, 186 / 211 / 3, 102 / 212 / 2, 42 / 213 / 3, 59 / 214 / 2, 174 / 215 / 2, 114 / 216 / 4, 120 / 217 / 2, 24 / 218 / 3, 178 / 219 / 2, 141 / 220 / 2, 248 / 221 / 2, 14 / 222 / 2, 74 / 223 / 2, 20 / 224 / 6, 176 / 225 / 2, 72 / 226 / 2, 13 / 227 / 2, 208 / 228 / 5, 7 / 229 / 2, 173 / 230 / 2, 67 / 231 / 2, 189 / 232 / 3, 153 / 233 / 2, 235 / 234 / 3, 249 / 235 / 2, 125 / 236 / 2, 115 / 237 / 2, 116 / 238 / 4, 242 / 239 / 2, 86 / 240 / 2, 230 / 241 / 4, 3 / 242 / 2, 2 / 243 / 2, 113 / 244 / 3, 210 / 245 / 2, 40 / 246 / 2, 228 / 247 / 3, 211 / 248 / 2, 132 / 249 / 2
singlecenter-alpha_1-6-n5.txt, 1, 1, 5, 354.468, 19, 14, 4, 4,4 / 1 / 4, 2 / 2 / 2, 1 / 3 / 3, 3 / 4 / 2
singlecenter-alpha_1-6-n500.txt, 1, 1, 500, 3107.7, 4032, 3532, 11, 499,54 / 1 / 2, 267 / 2 / 2, 311 / 3 / 3, 429 / 4 / 2, 475 / 5 / 8, 382 / 6 / 2, 218 / 7 / 2, 59 / 8 / 2, 392 / 9 / 2, 46 / 10 / 4, 283 / 11 / 2, 348 / 12 / 3, 86 / 13 / 2, 399 / 14 / 3, 166 / 15 / 2, 287 / 16 / 2, 109 / 17 / 4, 245 / 18 / 2, 410 / 19 / 2, 61 / 20 / 3, 244 / 21 / 2, 233 / 22 / 2, 436 / 23 / 3, 99 / 24 / 2, 381 / 25 / 4, 433 / 26 / 2, 8 / 27 / 2, 169 / 28 / 4, 327 / 29 / 2, 209 / 30 / 2, 453 / 31 / 4, 422 / 32 / 2, 365 / 33 / 3, 386 / 34 / 2, 146 / 35 / 3, 425 / 36 / 2, 338 / 37 / 2, 437 / 38 / 4, 404 / 39 / 2, 212 / 40 / 2, 178 / 41 / 2, 368 / 42 / 2, 248 / 43 / 2, 88 / 44 / 5, 271 / 45 / 2, 111 / 46 / 2, 494 / 47 / 2, 499 / 48 / 3, 90 / 49 / 2, 247 / 50 / 6, 162 / 51 / 2, 458 / 52 / 2, 273 / 53 / 2, 268 / 54 / 3, 4 / 55 / 2, 147 / 56 / 3, 165 / 57 / 2, 53 / 58 / 2, 180 / 59 / 3, 91 / 60 / 2, 388 / 61 / 3, 207 / 62 / 2, 486 / 63 / 3, 112 / 64 / 2, 279 / 65 / 5, 292 / 66 / 2, 479 / 67 / 3, 431 / 68 / 2, 294 / 69 / 3, 485 / 70 / 2, 39 / 71 / 2, 74 / 72 / 4, 312 / 73 / 2, 337 / 74 / 2, 439 / 75 / 6, 239 / 76 / 2, 457 / 77 / 2, 55 / 78 / 2, 389 / 79 / 3, 236 / 80 / 2, 281 / 81 / 2, 343 / 82 / 3, 116 / 83 / 2, 21 / 84 / 2, 354 / 85 / 5, 167 / 86 / 2, 104 / 87 / 2, 340 / 88 / 2, 377 / 89 / 2, 60 / 90 / 2, 224 / 91 / 5, 318 / 92 / 2, 291 / 93 / 2, 276 / 94 / 2, 232 / 95 / 2, 150 / 96 / 3, 45 / 97 / 2, 133 / 98 / 2, 220 / 99 / 2, 19 / 100 / 2, 249 / 101 / 3, 380 / 102 / 2, 229 / 103 / 2, 3 / 104 / 3, 373 / 105 / 2, 282 / 106 / 2, 305 / 107 / 2, 251 / 108 / 3, 463 / 109 / 2, 38 / 110 / 2, 18 / 111 / 6, 110 / 112 / 2, 275 / 113 / 2, 339 / 114 / 2, 154 / 115 / 2, 51 / 116 / 5, 186 / 117 / 2, 23 / 118 / 3, 49 / 119 / 2, 314 / 120 / 3, 235 / 121 / 2, 407 / 122 / 2, 460 / 123 / 2, 246 / 124 / 3, 477 / 125 / 2, 412 / 126 / 2, 411 / 127 / 4, 215 / 128 / 2, 459 / 129 / 2, 161 / 130 / 3, 70 / 131 / 2, 126 / 132 / 4, 78 / 133 / 2, 170 / 134 / 2, 185 / 135 / 3, 204 / 136 / 2, 118 / 137 / 5, 221 / 138 / 2, 159 / 139 / 2, 79 / 140 / 3, 370 / 141 / 2, 489 / 142 / 2, 418 / 143 / 2, 467 / 144 / 2, 428 / 145 / 3, 353 / 146 / 2, 80 / 147 / 3, 344 / 148 / 2, 158 / 149 / 2, 77 / 150 / 3, 345 / 151 / 2, 322 / 152 / 4, 349 / 153 / 2, 210 / 154 / 2, 145 / 155 / 3, 101 / 156 / 2, 427 / 157 / 3, 269 / 158 / 2, 226 / 159 / 2, 33 / 160 / 3, 293 / 161 / 2, 194 / 162 / 2, 152 / 163 / 3, 40 / 164 / 2, 187 / 165 / 2, 263 / 166 / 2, 47 / 167 / 5, 135 / 168 / 2, 434 / 169 / 2, 326 / 170 / 2, 448 / 171 / 3, 299 / 172 / 2, 266 / 173 / 2, 83 / 174 / 2, 449 / 175 / 4, 234 / 176 / 2, 200 / 177 / 2, 68 / 178 / 2, 414 / 179 / 3, 367 / 180 / 2, 123 / 181 / 2, 114 / 182 / 2, 155 / 183 / 3, 461 / 184 / 2, 403 / 185 / 2, 67 / 186 / 2, 374 / 187 / 3, 430 / 188 / 2, 103 / 189 / 2, 151 / 190 / 2, 379 / 191 / 3, 375 / 192 / 2, 455 / 193 / 2, 342 / 194 / 2, 498 / 195 / 3, 426 / 196 / 2, 435 / 197 / 3, 391 / 198 / 2, 119 / 199 / 2, 157 / 200 / 2, 208 / 201 / 2, 495 / 202 / 4, 452 / 203 / 2, 182 / 204 / 2, 42 / 205 / 2, 25 / 206 / 5, 471 / 207 / 2, 241 / 208 / 2, 32 / 209 / 4, 383 / 210 / 2, 352 / 211 / 2, 357 / 212 / 2, 57 / 213 / 4, 36 / 214 / 2, 156 / 215 / 3, 238 / 216 / 2, 13 / 217 / 3, 105 / 218 / 2, 75 / 219 / 3, 350 / 220 / 2, 450 / 221 / 3, 310 / 222 / 2, 384 / 223 / 3, 334 / 224 / 2, 12 / 225 / 2, 421 / 226 / 2, 107 / 227 / 2, 138 / 228 / 4, 5 / 229 / 2, 69 / 230 / 2, 497 / 231 / 2, 176 / 232 / 2, 163 / 233 / 2, 139 / 234 / 3, 43 / 235 / 2, 15 / 236 / 3, 62 / 237 / 2, 472 / 238 / 3, 94 / 239 / 2, 277 / 240 / 2, 102 / 241 / 4, 309 / 242 / 2, 113 / 243 / 3, 290 / 244 / 2, 98 / 245 / 3, 14 / 246 / 2, 423 / 247 / 2, 401 / 248 / 2, 37 / 249 / 3, 447 / 250 / 2, 492 / 251 / 2, 358 / 252 / 2, 137 / 253 / 2, 174 / 254 / 2, 317 / 255 / 3, 141 / 256 / 2, 136 / 257 / 2, 272 / 258 / 2, 22 / 259 / 2, 143 / 260 / 2, 270 / 261 / 5, 24 / 262 / 2, 332 / 263 / 3, 84 / 264 / 2, 9 / 265 / 2, 323 / 266 / 4, 278 / 267 / 2, 258 / 268 / 2, 405 / 269 / 2, 172 / 270 / 3, 117 / 271 / 2, 376 / 272 / 3, 341 / 273 / 2, 173 / 274 / 3, 96 / 275 / 2, 199 / 276 / 3, 440 / 277 / 2, 225 / 278 / 3, 92 / 279 / 2, 177 / 280 / 2, 128 / 281 / 3, 192 / 282 / 2, 355 / 283 / 3, 347 / 284 / 2, 6 / 285 / 2, 319 / 286 / 2, 73 / 287 / 3, 289 / 288 / 2, 240 / 289 / 2, 390 / 290 / 2, 30 / 291 / 2, 205 / 292 / 2, 274 / 293 / 3, 175 / 294 / 2, 206 / 295 / 2, 72 / 296 / 2, 17 / 297 / 2, 243 / 298 / 3, 222 / 299 / 2, 196 / 300 / 3, 362 / 301 / 2, 214 / 302 / 2, 211 / 303 / 2, 313 / 304 / 3, 160 / 305 / 2, 127 / 306 / 3, 336 / 307 / 2, 254 / 308 / 2, 397 / 309 / 2, 424 / 310 / 2, 16 / 311 / 4, 366 / 312 / 2, 115 / 313 / 2, 325 / 314 / 2, 302 / 315 / 3, 394 / 316 / 2, 20 / 317 / 3, 97 / 318 / 2, 346 / 319 / 3, 262 / 320 / 2, 76 / 321 / 2, 85 / 322 / 3, 183 / 323 / 2, 29 / 324 / 2, 330 / 325 / 2, 300 / 326 / 4, 372 / 327 / 2, 190 / 328 / 2, 364 / 329 / 2, 333 / 330 / 11, 462 / 331 / 2, 316 / 332 / 2, 478 / 333 / 2, 28 / 334 / 2, 416 / 335 / 3, 488 / 336 / 2, 219 / 337 / 2, 442 / 338 / 2, 259 / 339 / 2, 130 / 340 / 4, 260 / 341 / 2, 41 / 342 / 2, 264 / 343 / 3, 402 / 344 / 2, 34 / 345 / 2, 26 / 346 / 2, 124 / 347 / 2, 223 / 348 / 2, 490 / 349 / 3, 301 / 350 / 2, 89 / 351 / 3, 320 / 352 / 2, 360 / 353 / 3, 371 / 354 / 2, 469 / 355 / 4, 446 / 356 / 2, 63 / 357 / 2, 242 / 358 / 4, 432 / 359 / 2, 250 / 360 / 2, 228 / 361 / 2, 202 / 362 / 2, 296 / 363 / 2, 351 / 364 / 3, 284 / 365 / 2, 213 / 366 / 2, 191 / 367 / 2, 456 / 368 / 3, 445 / 369 / 2, 474 / 370 / 3, 11 / 371 / 2, 227 / 372 / 5, 217 / 373 / 2, 438 / 374 / 2, 252 / 375 / 2, 179 / 376 / 4, 470 / 377 / 2, 328 / 378 / 2, 121 / 379 / 2, 7 / 380 / 4, 307 / 381 / 2, 491 / 382 / 2, 441 / 383 / 4, 216 / 384 / 2, 201 / 385 / 3, 361 / 386 / 2, 369 / 387 / 3, 108 / 388 / 2, 288 / 389 / 2, 306 / 390 / 2, 265 / 391 / 2, 188 / 392 / 3, 231 / 393 / 2, 189 / 394 / 2, 149 / 395 / 4, 420 / 396 / 2, 443 / 397 / 2, 335 / 398 / 2, 308 / 399 / 4, 144 / 400 / 2, 329 / 401 / 2, 35 / 402 / 3, 483 / 403 / 2, 129 / 404 / 3, 197 / 405 / 2, 464 / 406 / 5, 496 / 407 / 2, 444 / 408 / 2, 10 / 409 / 2, 295 / 410 / 5, 393 / 411 / 2, 181 / 412 / 2, 331 / 413 / 2, 468 / 414 / 3, 100 / 415 / 2, 65 / 416 / 2, 71 / 417 / 4, 451 / 418 / 2, 58 / 419 / 3, 419 / 420 / 2, 237 / 421 / 2, 493 / 422 / 2, 256 / 423 / 3, 81 / 424 / 2, 417 / 425 / 2, 363 / 426 / 4, 142 / 427 / 2, 198 / 428 / 3, 408 / 429 / 2, 125 / 430 / 2, 132 / 431 / 2, 398 / 432 / 2, 406 / 433 / 2, 481 / 434 / 2, 387 / 435 / 2, 385 / 436 / 4, 303 / 437 / 2, 48 / 438 / 2, 230 / 439 / 3, 50 / 440 / 2, 168 / 441 / 3, 400 / 442 / 2, 476 / 443 / 5, 286 / 444 / 2, 395 / 445 / 3, 44 / 446 / 2, 321 / 447 / 4, 1 / 448 / 2, 171 / 449 / 2, 31 / 450 / 2, 64 / 451 / 3, 148 / 452 / 2, 473 / 453 / 2, 465 / 454 / 3, 324 / 455 / 2, 484 / 456 / 2, 82 / 457 / 3, 95 / 458 / 2, 255 / 459 / 2, 164 / 460 / 3, 466 / 461 / 2, 480 / 462 / 3, 87 / 463 / 2, 253 / 464 / 3, 415 / 465 / 2, 482 / 466 / 2, 315 / 467 / 2, 27 / 468 / 2, 153 / 469 / 3, 134 / 470 / 2, 203 / 471 / 2, 66 / 472 / 2, 195 / 473 / 2, 93 / 474 / 5, 131 / 475 / 2, 304 / 476 / 2, 297 / 477 / 2, 409 / 478 / 3, 56 / 479 / 2, 413 / 480 / 2, 396 / 481 / 3, 120 / 482 / 2, 52 / 483 / 2, 378 / 484 / 2, 298 / 485 / 6, 454 / 486 / 2, 356 / 487 / 2, 285 / 488 / 3, 193 / 489 / 2, 261 / 490 / 3, 487 / 491 / 2, 106 / 492 / 2, 2 / 493 / 2, 122 / 494 / 2, 184 / 495 / 3, 280 / 496 / 2, 359 / 497 / 2, 140 / 498 / 4, 257 / 499 / 2
singlecenter-alpha_1-60-n10.txt, 1, 1, 10, 416.422, 57, 47, 9, 9,3 / 1 / 5, 2 / 2 / 2, 8 / 3 / 2, 5 / 4 / 3, 6 / 5 / 2, 1 / 6 / 2, 7 / 7 / 3, 4 / 8 / 2, 9 / 9 / 9
singlecenter-alpha_1-61-n20.txt, 1, 1, 20, 644.011, 167, 147, 6, 19,1 / 1 / 6, 16 / 2 / 2, 2 / 3 / 3, 13 / 4 / 2, 5 / 5 / 2, 6 / 6 / 2, 8 / 7 / 2, 19 / 8 / 3, 7 / 9 / 2, 3 / 10 / 6, 9 / 11 / 2, 14 / 12 / 2, 11 / 13 / 3, 18 / 14 / 2, 10 / 15 / 2, 4 / 16 / 2, 17 / 17 / 5, 15 / 18 / 2, 12 / 19 / 3
singlecenter-alpha_1-62-n20.txt, 1, 1, 20, 549.79, 153, 133, 7, 19,6 / 1 / 2, 19 / 2 / 2, 13 / 3 / 7, 8 / 4 / 2, 16 / 5 / 2, 10 / 6 / 2, 3 / 7 / 4, 5 / 8 / 2, 12 / 9 / 2, 7 / 10 / 4, 2 / 11 / 2, 4 / 12 / 2, 18 / 13 / 3, 14 / 14 / 2, 17 / 15 / 2, 9 / 16 / 7, 11 / 17 / 2, 1 / 18 / 3, 15 / 19 / 2
singlecenter-alpha_1-63-n20.txt, 1, 1, 20, 763.787, 120, 100, 3, 19,17 / 1 / 2, 18 / 2 / 3, 16 / 3 / 2, 12 / 4 / 2, 15 / 5 / 3, 8 / 6 / 2, 6 / 7 / 3, 1 / 8 / 2, 2 / 9 / 3, 13 / 10 / 2, 19 / 11 / 3, 7 / 12 / 2, 3 / 13 / 2, 11 / 14 / 3, 5 / 15 / 2, 9 / 16 / 3, 14 / 17 / 2, 10 / 18 / 2, 4 / 19 / 2
singlecenter-alpha_1-64-n20.txt, 1, 1, 20, 671.28, 127, 107, 10, 19,5 / 1 / 3, 1 / 2 / 2, 14 / 3 / 3, 18 / 4 / 2, 15 / 5 / 2, 10 / 6 / 4, 19 / 7 / 2, 9 / 8 / 2, 17 / 9 / 2, 11 / 10 / 2, 6 / 11 / 2, 4 / 12 / 2, 2 / 13 / 3, 13 / 14 / 2, 16 / 15 / 3, 3 / 16 / 2, 7 / 17 / 2, 8 / 18 / 10, 12 / 19 / 2
singlecenter-alpha_1-65-n20.txt, 1, 1, 20, 727.004, 168, 148, 7, 19,7 / 1 / 3, 17 / 2 / 2, 15 / 3 / 2, 14 / 4 / 7, 4 / 5 / 2, 2 / 6 / 3, 13 / 7 / 2, 5 / 8 / 2, 6 / 9 / 2, 3 / 10 / 2, 19 / 11 / 6, 16 / 12 / 2, 1 / 13 / 2, 12 / 14 / 2, 10 / 15 / 2, 8 / 16 / 2, 18 / 17 / 2, 11 / 18 / 2, 9 / 19 / 3
singlecenter-alpha_1-66-n20.txt, 1, 1, 20, 494.764, 151, 131, 8, 19,3 / 1 / 2, 12 / 2 / 5, 13 / 3 / 2, 17 / 4 / 2, 9 / 5 / 2, 16 / 6 / 2, 19 / 7 / 3, 14 / 8 / 2, 1 / 9 / 2, 6 / 10 / 4, 10 / 11 / 2, 15 / 12 / 2, 5 / 13 / 4, 8 / 14 / 2, 4 / 15 / 3, 2 / 16 / 2, 18 / 17 / 8, 7 / 18 / 2, 11 / 19 / 3
singlecenter-alpha_1-67-n20.txt, 1, 1, 20, 568.78, 170, 150, 12, 19,13 / 1 / 2, 14 / 2 / 4, 6 / 3 / 2, 9 / 4 / 2, 12 / 5 / 2, 7 / 6 / 4, 10 / 7 / 2, 1 / 8 / 3, 8 / 9 / 2, 4 / 10 / 3, 3 / 11 / 2, 16 / 12 / 3, 2 / 13 / 2, 19 / 14 / 2, 18 / 15 / 2, 11 / 16 / 2, 17 / 17 / 12, 5 / 18 / 2, 15 / 19 / 2
singlecenter-alpha_1-68-n20.txt, 1, 1, 20, 627.794, 142, 122, 6, 19,16 / 1 / 2, 14 / 2 / 6, 9 / 3 / 2, 18 / 4 / 2, 13 / 5 / 3, 17 / 6 / 2, 8 / 7 / 3, 11 / 8 / 2, 2 / 9 / 2, 10 / 10 / 3, 3 / 11 / 2, 6 / 12 / 5, 12 / 13 / 2, 4 / 14 / 2, 1 / 15 / 2, 7 / 16 / 2, 15 / 17 / 6, 5 / 18 / 2, 19 / 19 / 2
singlecenter-alpha_1-69-n20.txt, 1, 1, 20, 721.786, 175, 155, 11, 19,12 / 1 / 3, 1 / 2 / 2, 2 / 3 / 3, 16 / 4 / 2, 4 / 5 / 2, 6 / 6 / 2, 13 / 7 / 8, 11 / 8 / 2, 5 / 9 / 2, 9 / 10 / 2, 17 / 11 / 3, 10 / 12 / 2, 19 / 13 / 2, 14 / 14 / 2, 7 / 15 / 2, 3 / 16 / 3, 15 / 17 / 2, 18 / 18 / 2, 8 / 19 / 11
singlecenter-alpha_1-7-n250.txt, 1, 1, 250, 2137.06, 1938, 1688, 10, 249,226 / 1 / 2, 113 / 2 / 6, 168 / 3 / 2, 80 / 4 / 2, 191 / 5 / 2, 161 / 6 / 2, 57 / 7 / 3, 19 / 8 / 2, 23 / 9 / 2, 6 / 10 / 3, 58 / 11 / 2, 98 / 12 / 3, 74 / 13 / 2, 156 / 14 / 2, 206 / 15 / 2, 249 / 16 / 2, 142 / 17 / 2, 234 / 18 / 10, 14 / 19 / 2, 92 / 20 / 2, 195 / 21 / 4, 50 / 22 / 2, 127 / 23 / 2, 150 / 24 / 2, 137 / 25 / 3, 87 / 26 / 2, 83 / 27 / 4, 197 / 28 / 2, 245 / 29 / 2, 200 / 30 / 2, 178 / 31 / 3, 225 / 32 / 2, 47 / 33 / 3, 69 / 34 / 2, 147 / 35 / 4, 78 / 36 / 2, 41 / 37 / 2, 231 / 38 / 4, 91 / 39 / 2, 188 / 40 / 2, 81 / 41 / 2, 21 / 42 / 2, 100 / 43 / 2, 93 / 44 / 2, 24 / 45 / 2, 227 / 46 / 3, 243 / 47 / 2, 112 / 48 / 2, 75 / 49 / 3, 190 / 50 / 2, 95 / 51 / 2, 187 / 52 / 3, 135 / 53 / 2, 196 / 54 / 4, 114 / 55 / 2, 216 / 56 / 3, 207 / 57 / 2, 121 / 58 / 2, 175 / 59 / 2, 126 / 60 / 6, 88 / 61 / 2, 238 / 62 / 2, 27 / 63 / 2, 99 / 64 / 2, 218 / 65 / 5, 160 / 66 / 2, 33 / 67 / 2, 230 / 68 / 3, 138 / 69 / 2, 172 / 70 / 3, 70 / 71 / 2, 59 / 72 / 2, 232 / 73 / 3, 26 / 74 / 2, 106 / 75 / 2, 246 / 76 / 2, 148 / 77 / 2, 116 / 78 / 2, 199 / 79 / 2, 96 / 80 / 2, 7 / 81 / 3, 145 / 82 / 2, 204 / 83 / 3, 214 / 84 / 2, 85 / 85 / 2, 205 / 86 / 3, 146 / 87 / 2, 144 / 88 / 3, 102 / 89 / 2, 132 / 90 / 2, 38 / 91 / 2, 193 / 92 / 2, 42 / 93 / 2, 210 / 94 / 3, 68 / 95 / 2, 29 / 96 / 5, 48 / 97 / 2, 122 / 98 / 2, 34 / 99 / 4, 217 / 100 / 2, 31 / 101 / 2, 143 / 102 / 3, 152 / 103 / 2, 208 / 104 / 3, 45 / 105 / 2, 212 / 106 / 2, 140 / 107 / 3, 211 / 108 / 2, 3 / 109 / 2, 16 / 110 / 2, 141 / 111 / 3, 11 / 112 / 2, 119 / 113 / 3, 73 / 114 / 2, 185 / 115 / 3, 108 / 116 / 2, 242 / 117 / 3, 215 / 118 / 2, 174 / 119 / 3, 44 / 120 / 2, 97 / 121 / 5, 228 / 122 / 2, 221 / 123 / 2, 111 / 124 / 3, 237 / 125 / 2, 179 / 126 / 2, 55 / 127 / 2, 155 / 128 / 2, 203 / 129 / 2, 236 / 130 / 2, 52 / 131 / 2, 94 / 132 / 5, 39 / 133 / 2, 198 / 134 / 2, 220 / 135 / 2, 131 / 136 / 3, 184 / 137 / 2, 49 / 138 / 2, 28 / 139 / 3, 63 / 140 / 2, 183 / 141 / 3, 158 / 142 / 2, 201 / 143 / 2, 101 / 144 / 2, 107 / 145 / 2, 67 / 146 / 3, 4 / 147 / 2, 213 / 148 / 2, 79 / 149 / 3, 229 / 150 / 2, 84 / 151 / 3, 139 / 152 / 2, 124 / 153 / 2, 128 / 154 / 2, 182 / 155 / 2, 165 / 156 / 3, 22 / 157 / 2, 53 / 158 / 2, 56 / 159 / 2, 239 / 160 / 3, 9 / 161 / 2, 115 / 162 / 2, 25 / 163 / 3, 164 / 164 / 2, 181 / 165 / 3, 123 / 166 / 2, 118 / 167 / 2, 8 / 168 / 2, 223 / 169 / 2, 15 / 170 / 2, 46 / 171 / 2, 170 / 172 / 2, 64 / 173 / 3, 189 / 174 / 2, 104 / 175 / 2, 163 / 176 / 3, 51 / 177 / 2, 1 / 178 / 2, 177 / 179 / 3, 109 / 180 / 2, 20 / 181 / 3, 105 / 182 / 2, 37 / 183 / 3, 202 / 184 / 2, 244 / 185 / 2, 157 / 186 / 3, 171 / 187 / 2, 153 / 188 / 2, 71 / 189 / 3, 159 / 190 / 2, 129 / 191 / 3, 134 / 192 / 2, 149 / 193 / 2, 154 / 194 / 3, 65 / 195 / 2, 162 / 196 / 3, 120 / 197 / 2, 43 / 198 / 3, 166 / 199 / 2, 66 / 200 / 2, 77 / 201 / 2, 222 / 202 / 2, 62 / 203 / 3, 167 / 204 / 2, 89 / 205 / 3, 30 / 206 / 2, 17 / 207 / 2, 125 / 208 / 3, 35 / 209 / 2, 76 / 210 / 3, 192 / 211 / 2, 117 / 212 / 3, 103 / 213 / 2, 173 / 214 / 2, 5 / 215 / 3, 151 / 216 / 2, 72 / 217 / 2, 54 / 218 / 4, 60 / 219 / 2, 82 / 220 / 2, 194 / 221 / 2, 90 / 222 / 2, 219 / 223 / 2, 248 / 224 / 3, 18 / 225 / 2, 247 / 226 / 2, 32 / 227 / 3, 13 / 228 / 2, 110 / 229 / 2, 224 / 230 / 2, 136 / 231 / 3, 176 / 232 / 2, 180 / 233 / 3, 209 / 234 / 2, 86 / 235 / 2, 12 / 236 / 4, 241 / 237 / 2, 235 / 238 / 2, 61 / 239 / 3, 2 / 240 / 2, 169 / 241 / 3, 233 / 242 / 2, 240 / 243 / 2, 130 / 244 / 3, 36 / 245 / 2, 186 / 246 / 2, 133 / 247 / 7, 40 / 248 / 2, 10 / 249 / 2
singlecenter-alpha_1-7-n5.txt, 1, 1, 5, 227.209, 18, 13, 3, 4,3 / 1 / 3, 2 / 2 / 2, 1 / 3 / 2, 4 / 4 / 3
singlecenter-alpha_1-7-n500.txt, 1, 1, 500, 3084.02, 3976, 3476, 11, 499,355 / 1 / 2, 68 / 2 / 6, 365 / 3 / 2, 281 / 4 / 2, 185 / 5 / 2, 322 / 6 / 2, 130 / 7 / 4, 471 / 8 / 2, 267 / 9 / 2, 416 / 10 / 2, 431 / 11 / 2, 33 / 12 / 2, 398 / 13 / 2, 288 / 14 / 2, 441 / 15 / 2, 205 / 16 / 2, 318 / 17 / 2, 69 / 18 / 5, 323 / 19 / 2, 422 / 20 / 3, 458 / 21 / 2, 89 / 22 / 2, 39 / 23 / 4, 86 / 24 / 2, 325 / 25 / 2, 208 / 26 / 2, 395 / 27 / 2, 393 / 28 / 6, 123 / 29 / 2, 161 / 30 / 2, 115 / 31 / 3, 454 / 32 / 2, 289 / 33 / 2, 215 / 34 / 4, 23 / 35 / 2, 306 / 36 / 2, 30 / 37 / 2, 342 / 38 / 3, 232 / 39 / 2, 245 / 40 / 2, 485 / 41 / 2, 450 / 42 / 2, 339 / 43 / 8, 16 / 44 / 2, 159 / 45 / 2, 36 / 46 / 3, 295 / 47 / 2, 390 / 48 / 2, 154 / 49 / 2, 226 / 50 / 2, 43 / 51 / 4, 164 / 52 / 2, 361 / 53 / 2, 125 / 54 / 2, 67 / 55 / 2, 108 / 56 / 2, 203 / 57 / 2, 37 / 58 / 4, 126 / 59 / 2, 384 / 60 / 2, 47 / 61 / 2, 7 / 62 / 3, 219 / 63 / 2, 29 / 64 / 5, 379 / 65 / 2, 1 / 66 / 2, 54 / 67 / 2, 25 / 68 / 2, 138 / 69 / 4, 340 / 70 / 2, 278 / 71 / 3, 188 / 72 / 2, 321 / 73 / 2, 349 / 74 / 2, 373 / 75 / 2, 374 / 76 / 3, 258 / 77 / 2, 183 / 78 / 2, 421 / 79 / 3, 348 / 80 / 2, 165 / 81 / 2, 157 / 82 / 2, 59 / 83 / 2, 214 / 84 / 2, 119 / 85 / 2, 409 / 86 / 3, 434 / 87 / 2, 139 / 88 / 3, 438 / 89 / 2, 141 / 90 / 2, 49 / 91 / 2, 435 / 92 / 2, 292 / 93 / 2, 476 / 94 / 2, 336 / 95 / 2, 363 / 96 / 2, 467 / 97 / 2, 317 / 98 / 4, 152 / 99 / 2, 268 / 100 / 2, 42 / 101 / 2, 481 / 102 / 2, 334 / 103 / 2, 364 / 104 / 3, 51 / 105 / 2, 77 / 106 / 3, 15 / 107 / 2, 110 / 108 / 2, 199 / 109 / 2, 180 / 110 / 2, 461 / 111 / 2, 272 / 112 / 2, 150 / 113 / 4, 385 / 114 / 2, 457 / 115 / 2, 279 / 116 / 2, 9 / 117 / 3, 425 / 118 / 2, 239 / 119 / 3, 266 / 120 / 2, 255 / 121 / 3, 433 / 122 / 2, 137 / 123 / 2, 140 / 124 / 2, 480 / 125 / 2, 177 / 126 / 6, 45 / 127 / 2, 406 / 128 / 2, 353 / 129 / 3, 246 / 130 / 2, 347 / 131 / 2, 212 / 132 / 3, 88 / 133 / 2, 179 / 134 / 3, 254 / 135 / 2, 244 / 136 / 2, 169 / 137 / 4, 460 / 138 / 2, 35 / 139 / 2, 330 / 140 / 4, 189 / 141 / 2, 186 / 142 / 2, 202 / 143 / 3, 61 / 144 / 2, 383 / 145 / 3, 439 / 146 / 2, 426 / 147 / 2, 470 / 148 / 4, 360 / 149 / 2, 131 / 150 / 2, 168 / 151 / 2, 111 / 152 / 4, 155 / 153 / 2, 223 / 154 / 2, 404 / 155 / 2, 294 / 156 / 2, 490 / 157 / 2, 106 / 158 / 2, 174 / 159 / 2, 449 / 160 / 2, 331 / 161 / 2, 71 / 162 / 2, 260 / 163 / 2, 153 / 164 / 2, 310 / 165 / 2, 324 / 166 / 2, 486 / 167 / 5, 298 / 168 / 2, 74 / 169 / 3, 427 / 170 / 2, 378 / 171 / 2, 184 / 172 / 3, 301 / 173 / 2, 196 / 174 / 3, 96 / 175 / 2, 445 / 176 / 3, 192 / 177 / 2, 462 / 178 / 3, 233 / 179 / 2, 148 / 180 / 3, 464 / 181 / 2, 478 / 182 / 3, 314 / 183 / 2, 136 / 184 / 2, 491 / 185 / 3, 320 / 186 / 2, 307 / 187 / 3, 327 / 188 / 2, 397 / 189 / 2, 291 / 190 / 4, 20 / 191 / 2, 116 / 192 / 2, 299 / 193 / 4, 176 / 194 / 2, 444 / 195 / 2, 135 / 196 / 3, 451 / 197 / 2, 8 / 198 / 5, 402 / 199 / 2, 41 / 200 / 2, 256 / 201 / 2, 407 / 202 / 3, 432 / 203 / 2, 489 / 204 / 3, 271 / 205 / 2, 17 / 206 / 2, 465 / 207 / 4, 240 / 208 / 2, 418 / 209 / 2, 343 / 210 / 3, 145 / 211 / 2, 352 / 212 / 2, 243 / 213 / 2, 93 / 214 / 3, 401 / 215 / 2, 90 / 216 / 2, 197 / 217 / 4, 229 / 218 / 2, 231 / 219 / 2, 428 / 220 / 2, 257 / 221 / 3, 241 / 222 / 2, 261 / 223 / 3, 479 / 224 / 2, 277 / 225 / 2, 297 / 226 / 2, 370 / 227 / 2, 275 / 228 / 2, 488 / 229 / 2, 114 / 230 / 2, 58 / 231 / 2, 104 / 232 / 2, 468 / 233 / 3, 469 / 234 / 2, 259 / 235 / 2, 263 / 236 / 2, 391 / 237 / 3, 156 / 238 / 2, 193 / 239 / 3, 333 / 240 / 2, 144 / 241 / 3, 247 / 242 / 2, 415 / 243 / 8, 387 / 244 / 2, 178 / 245 / 2, 300 / 246 / 4, 83 / 247 / 2, 147 / 248 / 3, 38 / 249 / 2, 452 / 250 / 3, 210 / 251 / 2, 389 / 252 / 2, 337 / 253 / 6, 79 / 254 / 2, 227 / 255 / 3, 251 / 256 / 2, 497 / 257 / 2, 92 / 258 / 2, 375 / 259 / 2, 46 / 260 / 2, 304 / 261 / 2, 149 / 262 / 2, 410 / 263 / 2, 120 / 264 / 2, 100 / 265 / 2, 269 / 266 / 4, 102 / 267 / 2, 216 / 268 / 2, 209 / 269 / 3, 194 / 270 / 2, 335 / 271 / 2, 319 / 272 / 3, 62 / 273 / 2, 446 / 274 / 2, 376 / 275 / 2, 56 / 276 / 3, 296 / 277 / 2, 172 / 278 / 2, 170 / 279 / 4, 87 / 280 / 2, 34 / 281 / 2, 52 / 282 / 2, 11 / 283 / 2, 220 / 284 / 3, 459 / 285 / 2, 200 / 286 / 3, 206 / 287 / 2, 250 / 288 / 2, 282 / 289 / 2, 463 / 290 / 2, 204 / 291 / 2, 175 / 292 / 3, 160 / 293 / 2, 73 / 294 / 3, 6 / 295 / 2, 32 / 296 / 2, 19 / 297 / 5, 146 / 298 / 2, 143 / 299 / 3, 362 / 300 / 2, 423 / 301 / 2, 315 / 302 / 2, 492 / 303 / 4, 273 / 304 / 2, 211 / 305 / 2, 173 / 306 / 3, 399 / 307 / 2, 417 / 308 / 2, 112 / 309 / 2, 222 / 310 / 3, 443 / 311 / 2, 95 / 312 / 3, 162 / 313 / 2, 98 / 314 / 2, 201 / 315 / 2, 396 / 316 / 2, 224 / 317 / 3, 483 / 318 / 2, 76 / 319 / 3, 309 / 320 / 2, 221 / 321 / 2, 31 / 322 / 4, 18 / 323 / 2, 412 / 324 / 2, 207 / 325 / 3, 122 / 326 / 2, 121 / 327 / 2, 101 / 328 / 2, 394 / 329 / 4, 286 / 330 / 2, 367 / 331 / 2, 477 / 332 / 2, 372 / 333 / 3, 344 / 334 / 2, 117 / 335 / 2, 290 / 336 / 3, 195 / 337 / 2, 338 / 338 / 2, 358 / 339 / 2, 84 / 340 / 2, 308 / 341 / 2, 494 / 342 / 3, 305 / 343 / 2, 274 / 344 / 2, 80 / 345 / 4, 368 / 346 / 2, 414 / 347 / 2, 453 / 348 / 3, 482 / 349 / 2, 128 / 350 / 6, 64 / 351 / 2, 386 / 352 / 2, 13 / 353 / 3, 377 / 354 / 2, 238 / 355 / 2, 24 / 356 / 2, 2 / 357 / 3, 70 / 358 / 2, 345 / 359 / 2, 369 / 360 / 2, 63 / 361 / 2, 442 / 362 / 3, 419 / 363 / 2, 44 / 364 / 2, 498 / 365 / 2, 228 / 366 / 3, 285 / 367 / 2, 400 / 368 / 2, 420 / 369 / 2, 265 / 370 / 3, 302 / 371 / 2, 4 / 372 / 3, 65 / 373 / 2, 198 / 374 / 2, 57 / 375 / 2, 230 / 376 / 2, 60 / 377 / 4, 356 / 378 / 2, 472 / 379 / 2, 151 / 380 / 3, 103 / 381 / 2, 27 / 382 / 4, 496 / 383 / 2, 328 / 384 / 2, 429 / 385 / 2, 248 / 386 / 2, 466 / 387 / 2, 351 / 388 / 2, 53 / 389 / 2, 107 / 390 / 2, 234 / 391 / 2, 249 / 392 / 2, 78 / 393 / 2, 287 / 394 / 2, 270 / 395 / 2, 354 / 396 / 2, 236 / 397 / 3, 424 / 398 / 2, 166 / 399 / 2, 474 / 400 / 2, 284 / 401 / 4, 313 / 402 / 2, 252 / 403 / 2, 225 / 404 / 2, 303 / 405 / 2, 22 / 406 / 3, 392 / 407 / 2, 382 / 408 / 2, 312 / 409 / 2, 91 / 410 / 3, 217 / 411 / 2, 413 / 412 / 2, 182 / 413 / 3, 105 / 414 / 2, 26 / 415 / 3, 437 / 416 / 2, 484 / 417 / 11, 359 / 418 / 2, 341 / 419 / 2, 456 / 420 / 2, 12 / 421 / 2, 124 / 422 / 2, 21 / 423 / 2, 5 / 424 / 2, 113 / 425 / 2, 191 / 426 / 4, 163 / 427 / 2, 237 / 428 / 2, 10 / 429 / 2, 28 / 430 / 2, 311 / 431 / 3, 94 / 432 / 2, 118 / 433 / 3, 50 / 434 / 2, 242 / 435 / 3, 405 / 436 / 2, 213 / 437 / 3, 75 / 438 / 2, 447 / 439 / 4, 133 / 440 / 2, 82 / 441 / 2, 346 / 442 / 4, 430 / 443 / 2, 66 / 444 / 2, 366 / 445 / 4, 132 / 446 / 2, 97 / 447 / 2, 253 / 448 / 3, 493 / 449 / 2, 127 / 450 / 2, 14 / 451 / 3, 381 / 452 / 2, 218 / 453 / 2, 171 / 454 / 2, 436 / 455 / 2, 129 / 456 / 2, 40 / 457 / 4, 134 / 458 / 2, 350 / 459 / 2, 380 / 460 / 2, 3 / 461 / 2, 235 / 462 / 3, 187 / 463 / 2, 72 / 464 / 3, 109 / 465 / 2, 448 / 466 / 2, 55 / 467 / 3, 81 / 468 / 2, 293 / 469 / 3, 316 / 470 / 2, 475 / 471 / 2, 85 / 472 / 2, 142 / 473 / 2, 487 / 474 / 2, 440 / 475 / 2, 329 / 476 / 2, 99 / 477 / 2, 357 / 478 / 2, 276 / 479 / 3, 158 / 480 / 2, 495 / 481 / 3, 455 / 482 / 2, 48 / 483 / 3, 473 / 484 / 2, 262 / 485 / 2, 280 / 486 / 2, 283 / 487 / 2, 411 / 488 / 3, 332 / 489 / 2, 403 / 490 / 3, 264 / 491 / 2, 388 / 492 / 2, 371 / 493 / 2, 167 / 494 / 2, 326 / 495 / 2, 181 / 496 / 3, 499 / 497 / 2, 190 / 498 / 4, 408 / 499 / 2
singlecenter-alpha_1-70-n20.txt, 1, 1, 20, 543.014, 120, 100, 3, 19,16 / 1 / 2, 12 / 2 / 2, 14 / 3 / 2, 10 / 4 / 3, 8 / 5 / 2, 6 / 6 / 3, 4 / 7 / 2, 1 / 8 / 2, 2 / 9 / 3, 15 / 10 / 2, 9 / 11 / 2, 3 / 12 / 2, 17 / 13 / 2, 11 / 14 / 3, 7 / 15 / 2, 13 / 16 / 2, 18 / 17 / 2, 19 / 18 / 2, 5 / 19 / 3
singlecenter-alpha_1-71-n50.txt, 1, 1, 50, 748.615, 396, 346, 7, 49,27 / 1 / 3, 44 / 2 / 2, 3 / 3 / 3, 35 / 4 / 2, 42 / 5 / 2, 48 / 6 / 2, 2 / 7 / 5, 45 / 8 / 2, 20 / 9 / 3, 33 / 10 / 2, 18 / 11 / 2, 15 / 12 / 2, 46 / 13 / 5, 1 / 14 / 2, 32 / 15 / 2, 4 / 16 / 2, 25 / 17 / 2, 24 / 18 / 3, 26 / 19 / 2, 31 / 20 / 3, 37 / 21 / 2, 13 / 22 / 3, 7 / 23 / 2, 23 / 24 / 2, 8 / 25 / 2, 49 / 26 / 2, 34 / 27 / 7, 14 / 28 / 2, 30 / 29 / 2, 22 / 30 / 3, 43 / 31 / 2, 16 / 32 / 2, 36 / 33 / 4, 41 / 34 / 2, 9 / 35 / 2, 21 / 36 / 3, 39 / 37 / 2, 19 / 38 / 4, 5 / 39 / 2, 17 / 40 / 2, 47 / 41 / 3, 10 / 42 / 2, 11 / 43 / 3, 40 / 44 / 2, 29 / 45 / 2, 12 / 46 / 2, 38 / 47 / 3, 6 / 48 / 2, 28 / 49 / 4
singlecenter-alpha_1-72-n50.txt, 1, 1, 50, 828.599, 395, 345, 6, 49,18 / 1 / 2, 9 / 2 / 2, 22 / 3 / 2, 16 / 4 / 2, 35 / 5 / 3, 3 / 6 / 2, 36 / 7 / 3, 2 / 8 / 2, 5 / 9 / 2, 42 / 10 / 2, 13 / 11 / 2, 20 / 12 / 3, 24 / 13 / 2, 25 / 14 / 2, 43 / 15 / 2, 15 / 16 / 4, 44 / 17 / 2, 17 / 18 / 2, 1 / 19 / 6, 38 / 20 / 2, 47 / 21 / 3, 7 / 22 / 2, 26 / 23 / 2, 40 / 24 / 2, 48 / 25 / 5, 19 / 26 / 2, 29 / 27 / 2, 4 / 28 / 3, 27 / 29 / 2, 31 / 30 / 2, 41 / 31 / 2, 34 / 32 / 4, 39 / 33 / 2, 30 / 34 / 2, 23 / 35 / 3, 46 / 36 / 2, 6 / 37 / 2, 12 / 38 / 2, 37 / 39 / 2, 8 / 40 / 2, 33 / 41 / 4, 49 / 42 / 2, 45 / 43 / 2, 32 / 44 / 4, 21 / 45 / 2, 14 / 46 / 3, 10 / 47 / 2, 11 / 48 / 2, 28 / 49 / 2
singlecenter-alpha_1-73-n50.txt, 1, 1, 50, 710.043, 309, 259, 4, 49,18 / 1 / 2, 11 / 2 / 2, 41 / 3 / 2, 21 / 4 / 2, 45 / 5 / 2, 44 / 6 / 4, 8 / 7 / 2, 22 / 8 / 3, 47 / 9 / 2, 35 / 10 / 2, 23 / 11 / 3, 15 / 12 / 2, 46 / 13 / 2, 9 / 14 / 4, 3 / 15 / 2, 19 / 16 / 2, 29 / 17 / 3, 33 / 18 / 2, 13 / 19 / 3, 26 / 20 / 2, 36 / 21 / 2, 49 / 22 / 2, 32 / 23 / 2, 1 / 24 / 3, 48 / 25 / 2, 12 / 26 / 2, 31 / 27 / 2, 27 / 28 / 3, 30 / 29 / 2, 37 / 30 / 2, 34 / 31 / 3, 38 / 32 / 2, 20 / 33 / 2, 42 / 34 / 2, 2 / 35 / 2, 5 / 36 / 2, 7 / 37 / 2, 16 / 38 / 2, 14 / 39 / 2, 40 / 40 / 2, 17 / 41 / 2, 24 / 42 / 2, 28 / 43 / 3, 25 / 44 / 2, 43 / 45 / 2, 4 / 46 / 2, 10 / 47 / 3, 39 / 48 / 2, 6 / 49 / 4
singlecenter-alpha_1-74-n50.txt, 1, 1, 50, 962.79, 350, 300, 8, 49,21 / 1 / 2, 41 / 2 / 2, 5 / 3 / 2, 8 / 4 / 2, 34 / 5 / 3, 47 / 6 / 2, 16 / 7 / 3, 45 / 8 / 2, 39 / 9 / 2, 44 / 10 / 6, 38 / 11 / 2, 4 / 12 / 2, 46 / 13 / 2, 24 / 14 / 2, 22 / 15 / 2, 49 / 16 / 4, 6 / 17 / 2, 35 / 18 / 2, 32 / 19 / 3, 33 / 20 / 2, 15 / 21 / 3, 11 / 22 / 2, 23 / 23 / 2, 37 / 24 / 2, 31 / 25 / 4, 20 / 26 / 2, 42 / 27 / 2, 19 / 28 / 2, 12 / 29 / 2, 36 / 30 / 3, 17 / 31 / 2, 2 / 32 / 3, 48 / 33 / 2, 13 / 34 / 2, 18 / 35 / 2, 30 / 36 / 2, 10 / 37 / 2, 14 / 38 / 2, 29 / 39 / 2, 3 / 40 / 2, 26 / 41 / 2, 7 / 42 / 2, 1 / 43 / 2, 9 / 44 / 2, 25 / 45 / 2, 43 / 46 / 2, 40 / 47 / 3, 28 / 48 / 2, 27 / 49 / 8
singlecenter-alpha_1-75-n50.txt, 1, 1, 50, 1049.06, 383, 333, 5, 49,46 / 1 / 3, 4 / 2 / 2, 41 / 3 / 3, 40 / 4 / 2, 11 / 5 / 2, 31 / 6 / 2, 26 / 7 / 3, 15 / 8 / 2, 18 / 9 / 5, 23 / 10 / 2, 8 / 11 / 2, 14 / 12 / 2, 30 / 13 / 2, 44 / 14 / 5, 36 / 15 / 2, 42 / 16 / 3, 3 / 17 / 2, 24 / 18 / 2, 19 / 19 / 2, 28 / 20 / 3, 35 / 21 / 2, 45 / 22 / 2, 49 / 23 / 2, 47 / 24 / 3, 1 / 25 / 2, 20 / 26 / 2, 32 / 27 / 2, 5 / 28 / 2, 38 / 29 / 2, 2 / 30 / 3, 9 / 31 / 2, 43 / 32 / 2, 25 / 33 / 2, 13 / 34 / 2, 6 / 35 / 3, 39 / 36 / 2, 7 / 37 / 2, 22 / 38 / 2, 33 / 39 / 5, 37 / 40 / 2, 34 / 41 / 2, 16 / 42 / 2, 17 / 43 / 3, 29 / 44 / 2, 12 / 45 / 2, 10 / 46 / 2, 48 / 47 / 3, 27 / 48 / 2, 21 / 49 / 3
singlecenter-alpha_1-76-n50.txt, 1, 1, 50, 962.246, 488, 438, 8, 49,2 / 1 / 2, 29 / 2 / 2, 20 / 3 / 3, 12 / 4 / 2, 46 / 5 / 4, 42 / 6 / 2, 31 / 7 / 2, 28 / 8 / 2, 7 / 9 / 3, 49 / 10 / 2, 32 / 11 / 2, 33 / 12 / 2, 39 / 13 / 3, 36 / 14 / 2, 23 / 15 / 2, 25 / 16 / 3, 38 / 17 / 2, 41 / 18 / 5, 40 / 19 / 2, 5 / 20 / 2, 11 / 21 / 2, 26 / 22 / 4, 45 / 23 / 2, 34 / 24 / 2, 19 / 25 / 4, 4 / 26 / 2, 35 / 27 / 2, 8 / 28 / 4, 24 / 29 / 2, 3 / 30 / 2, 10 / 31 / 3, 22 / 32 / 2, 48 / 33 / 2, 17 / 34 / 2, 44 / 35 / 8, 16 / 36 / 2, 18 / 37 / 3, 30 / 38 / 2, 37 / 39 / 2, 27 / 40 / 3, 1 / 41 / 2, 9 / 42 / 4, 13 / 43 / 2, 43 / 44 / 2, 15 / 45 / 3, 21 / 46 / 2, 47 / 47 / 2, 14 / 48 / 6, 6 / 49 / 2
singlecenter-alpha_1-77-n50.txt, 1, 1, 50, 831.259, 394, 344, 5, 49,3 / 1 / 2, 41 / 2 / 2, 13 / 3 / 3, 10 / 4 / 2, 2 / 5 / 3, 29 / 6 / 2, 1 / 7 / 3, 44 / 8 / 2, 48 / 9 / 2, 37 / 10 / 2, 4 / 11 / 3, 40 / 12 / 2, 24 / 13 / 2, 21 / 14 / 2, 33 / 15 / 3, 6 / 16 / 2, 31 / 17 / 5, 7 / 18 / 2, 15 / 19 / 2, 22 / 20 / 3, 12 / 21 / 2, 25 / 22 / 2, 28 / 23 / 4, 8 / 24 / 2, 18 / 25 / 2, 43 / 26 / 4, 38 / 27 / 2, 30 / 28 / 2, 39 / 29 / 2, 27 / 30 / 5, 17 / 31 / 2, 16 / 32 / 2, 42 / 33 / 2, 23 / 34 / 3, 5 / 35 / 2, 36 / 36 / 2, 46 / 37 / 3, 34 / 38 / 2, 47 / 39 / 3, 9 / 40 / 2, 26 / 41 / 4, 49 / 42 / 2, 45 / 43 / 2, 35 / 44 / 2, 14 / 45 / 2, 11 / 46 / 5, 32 / 47 / 2, 20 / 48 / 2, 19 / 49 / 4
singlecenter-alpha_1-78-n50.txt, 1, 1, 50, 936.784, 394, 344, 6, 49,23 / 1 / 3, 10 / 2 / 2, 2 / 3 / 2, 6 / 4 / 3, 46 / 5 / 2, 7 / 6 / 3, 28 / 7 / 2, 37 / 8 / 2, 21 / 9 / 2, 13 / 10 / 3, 27 / 11 / 2, 39 / 12 / 2, 15 / 13 / 2, 3 / 14 / 4, 19 / 15 / 2, 29 / 16 / 2, 49 / 17 / 4, 41 / 18 / 2, 40 / 19 / 3, 12 / 20 / 2, 43 / 21 / 2, 18 / 22 / 3, 14 / 23 / 2, 48 / 24 / 2, 17 / 25 / 4, 42 / 26 / 2, 33 / 27 / 2, 1 / 28 / 5, 22 / 29 / 2, 16 / 30 / 2, 36 / 31 / 2, 30 / 32 / 4, 5 / 33 / 2, 47 / 34 / 2, 8 / 35 / 2, 24 / 36 / 3, 44 / 37 / 2, 20 / 38 / 2, 38 / 39 / 2, 32 / 40 / 2, 25 / 41 / 3, 34 / 42 / 2, 9 / 43 / 2, 4 / 44 / 2, 35 / 45 / 2, 45 / 46 / 3, 26 / 47 / 2, 31 / 48 / 6, 11 / 49 / 2
singlecenter-alpha_1-79-n50.txt, 1, 1, 50, 833.234, 527, 477, 10, 49,1 / 1 / 2, 4 / 2 / 2, 36 / 3 / 3, 14 / 4 / 2, 16 / 5 / 2, 31 / 6 / 3, 30 / 7 / 2, 17 / 8 / 3, 38 / 9 / 2, 27 / 10 / 2, 47 / 11 / 10, 20 / 12 / 2, 39 / 13 / 2, 7 / 14 / 2, 42 / 15 / 2, 13 / 16 / 2, 26 / 17 / 4, 43 / 18 / 2, 23 / 19 / 2, 22 / 20 / 3, 46 / 21 / 2, 34 / 22 / 2, 48 / 23 / 2, 41 / 24 / 2, 37 / 25 / 3, 8 / 26 / 2, 45 / 27 / 2, 35 / 28 / 8, 2 / 29 / 2, 11 / 30 / 2, 44 / 31 / 3, 40 / 32 / 2, 33 / 33 / 3, 9 / 34 / 2, 28 / 35 / 2, 3 / 36 / 3, 5 / 37 / 2, 21 / 38 / 3, 10 / 39 / 2, 29 / 40 / 2, 6 / 41 / 2, 24 / 42 / 2, 19 / 43 / 2, 32 / 44 / 3, 15 / 45 / 2, 25 / 46 / 2, 12 / 47 / 3, 18 / 48 / 2, 49 / 49 / 3
singlecenter-alpha_1-8-n250.txt, 1, 1, 250, 2264.72, 2405, 2155, 15, 249,39 / 1 / 3, 21 / 2 / 2, 131 / 3 / 2, 246 / 4 / 2, 174 / 5 / 2, 37 / 6 / 2, 74 / 7 / 2, 180 / 8 / 2, 208 / 9 / 3, 82 / 10 / 2, 93 / 11 / 2, 177 / 12 / 2, 154 / 13 / 2, 161 / 14 / 15, 213 / 15 / 2, 53 / 16 / 3, 133 / 17 / 2, 45 / 18 / 2, 48 / 19 / 2, 114 / 20 / 2, 163 / 21 / 6, 30 / 22 / 2, 111 / 23 / 2, 56 / 24 / 2, 123 / 25 / 3, 26 / 26 / 2, 135 / 27 / 3, 248 / 28 / 2, 232 / 29 / 3, 160 / 30 / 2, 226 / 31 / 2, 78 / 32 / 2, 62 / 33 / 5, 242 / 34 / 2, 147 / 35 / 3, 67 / 36 / 2, 203 / 37 / 2, 6 / 38 / 2, 173 / 39 / 3, 143 / 40 / 2, 95 / 41 / 4, 166 / 42 / 2, 215 / 43 / 3, 185 / 44 / 2, 150 / 45 / 2, 31 / 46 / 2, 239 / 47 / 3, 194 / 48 / 2, 36 / 49 / 4, 79 / 50 / 2, 121 / 51 / 2, 218 / 52 / 2, 96 / 53 / 5, 240 / 54 / 2, 23 / 55 / 2, 85 / 56 / 2, 20 / 57 / 2, 124 / 58 / 6, 71 / 59 / 2, 149 / 60 / 3, 195 / 61 / 2, 233 / 62 / 2, 38 / 63 / 3, 217 / 64 / 2, 141 / 65 / 2, 175 / 66 / 2, 140 / 67 / 2, 109 / 68 / 3, 244 / 69 / 2, 1 / 70 / 3, 148 / 71 / 2, 88 / 72 / 2, 245 / 73 / 2, 224 / 74 / 3, 92 / 75 / 2, 153 / 76 / 5, 184 / 77 / 2, 113 / 78 / 2, 230 / 79 / 2, 57 / 80 / 2, 41 / 81 / 4, 227 / 82 / 2, 105 / 83 / 2, 28 / 84 / 5, 212 / 85 / 2, 199 / 86 / 2, 101 / 87 / 2, 27 / 88 / 4, 35 / 89 / 2, 182 / 90 / 2, 192 / 91 / 4, 16 / 92 / 2, 18 / 93 / 2, 162 / 94 / 3, 167 / 95 / 2, 24 / 96 / 3, 205 / 97 / 2, 66 / 98 / 3, 69 / 99 / 2, 86 / 100 / 2, 134 / 101 / 4, 209 / 102 / 2, 4 / 103 / 2, 142 / 104 / 3, 22 / 105 / 2, 84 / 106 / 3, 50 / 107 / 2, 237 / 108 / 3, 196 / 109 / 2, 172 / 110 / 2, 49 / 111 / 3, 8 / 112 / 2, 52 / 113 / 3, 107 / 114 / 2, 63 / 115 / 2, 118 / 116 / 2, 223 / 117 / 3, 198 / 118 / 2, 247 / 119 / 2, 225 / 120 / 2, 243 / 121 / 2, 99 / 122 / 2, 64 / 123 / 2, 132 / 124 / 3, 228 / 125 / 2, 190 / 126 / 2, 33 / 127 / 3, 14 / 128 / 2, 234 / 129 / 3, 108 / 130 / 2, 75 / 131 / 2, 32 / 132 / 2, 179 / 133 / 2, 100 / 134 / 3, 130 / 135 / 2, 94 / 136 / 3, 188 / 137 / 2, 129 / 138 / 2, 5 / 139 / 2, 13 / 140 / 2, 159 / 141 / 3, 29 / 142 / 2, 191 / 143 / 3, 144 / 144 / 2, 202 / 145 / 2, 145 / 146 / 4, 241 / 147 / 2, 83 / 148 / 2, 25 / 149 / 3, 128 / 150 / 2, 207 / 151 / 2, 126 / 152 / 3, 58 / 153 / 2, 170 / 154 / 2, 231 / 155 / 6, 55 / 156 / 2, 146 / 157 / 3, 235 / 158 / 2, 17 / 159 / 2, 157 / 160 / 3, 81 / 161 / 2, 112 / 162 / 3, 117 / 163 / 2, 197 / 164 / 2, 2 / 165 / 2, 206 / 166 / 2, 216 / 167 / 5, 65 / 168 / 2, 210 / 169 / 3, 151 / 170 / 2, 54 / 171 / 3, 106 / 172 / 2, 136 / 173 / 2, 19 / 174 / 2, 187 / 175 / 3, 127 / 176 / 2, 103 / 177 / 2, 165 / 178 / 2, 155 / 179 / 3, 181 / 180 / 2, 10 / 181 / 2, 34 / 182 / 2, 214 / 183 / 3, 59 / 184 / 2, 238 / 185 / 2, 42 / 186 / 2, 229 / 187 / 2, 178 / 188 / 3, 219 / 189 / 2, 125 / 190 / 2, 168 / 191 / 3, 11 / 192 / 2, 169 / 193 / 3, 98 / 194 / 2, 40 / 195 / 5, 211 / 196 / 2, 7 / 197 / 3, 3 / 198 / 2, 44 / 199 / 2, 139 / 200 / 2, 201 / 201 / 4, 164 / 202 / 2, 46 / 203 / 2, 73 / 204 / 4, 193 / 205 / 2, 77 / 206 / 2, 12 / 207 / 3, 102 / 208 / 2, 47 / 209 / 2, 222 / 210 / 3, 183 / 211 / 2, 189 / 212 / 2, 110 / 213 / 2, 116 / 214 / 2, 51 / 215 / 5, 220 / 216 / 2, 138 / 217 / 2, 80 / 218 / 2, 200 / 219 / 3, 70 / 220 / 2, 76 / 221 / 3, 249 / 222 / 2, 221 / 223 / 2, 176 / 224 / 2, 60 / 225 / 3, 204 / 226 / 2, 104 / 227 / 3, 236 / 228 / 2, 43 / 229 / 2, 9 / 230 / 2, 119 / 231 / 4, 152 / 232 / 2, 115 / 233 / 2, 120 / 234 / 3, 156 / 235 / 2, 68 / 236 / 5, 87 / 237 / 2, 72 / 238 / 2, 186 / 239 / 2, 97 / 240 / 4, 89 / 241 / 2, 171 / 242 / 2, 61 / 243 / 3, 15 / 244 / 2, 91 / 245 / 3, 158 / 246 / 2, 137 / 247 / 2, 90 / 248 / 3, 122 / 249 / 2
singlecenter-alpha_1-8-n5.txt, 1, 1, 5, 152.815, 19, 14, 5, 4,4 / 1 / 5, 3 / 2 / 2, 1 / 3 / 3, 2 / 4 / 2
singlecenter-alpha_1-8-n500.txt, 1, 1, 500, 2928.36, 3640, 3140, 5, 499,419 / 1 / 2, 297 / 2 / 2, 380 / 3 / 3, 473 / 4 / 2, 197 / 5 / 2, 113 / 6 / 2, 488 / 7 / 3, 82 / 8 / 2, 37 / 9 / 2, 269 / 10 / 3, 466 / 11 / 2, 186 / 12 / 2, 460 / 13 / 4, 147 / 14 / 2, 428 / 15 / 2, 179 / 16 / 2, 420 / 17 / 2, 478 / 18 / 2, 345 / 19 / 2, 266 / 20 / 2, 306 / 21 / 2, 255 / 22 / 5, 210 / 23 / 2, 317 / 24 / 2, 104 / 25 / 2, 480 / 26 / 3, 91 / 27 / 2, 117 / 28 / 2, 71 / 29 / 3, 393 / 30 / 2, 418 / 31 / 2, 54 / 32 / 2, 5 / 33 / 2, 121 / 34 / 2, 79 / 35 / 2, 406 / 36 / 2, 235 / 37 / 3, 307 / 38 / 2, 222 / 39 / 2, 435 / 40 / 2, 399 / 41 / 4, 204 / 42 / 2, 352 / 43 / 3, 47 / 44 / 2, 298 / 45 / 2, 311 / 46 / 2, 272 / 47 / 2, 324 / 48 / 3, 290 / 49 / 2, 301 / 50 / 3, 194 / 51 / 2, 73 / 52 / 3, 48 / 53 / 2, 157 / 54 / 2, 495 / 55 / 2, 244 / 56 / 2, 11 / 57 / 5, 103 / 58 / 2, 94 / 59 / 3, 422 / 60 / 2, 425 / 61 / 2, 214 / 62 / 4, 303 / 63 / 2, 423 / 64 / 2, 12 / 65 / 2, 27 / 66 / 2, 496 / 67 / 2, 25 / 68 / 2, 346 / 69 / 2, 366 / 70 / 3, 100 / 71 / 2, 189 / 72 / 4, 449 / 73 / 2, 447 / 74 / 2, 403 / 75 / 3, 17 / 76 / 2, 433 / 77 / 2, 454 / 78 / 2, 438 / 79 / 2, 188 / 80 / 3, 10 / 81 / 2, 160 / 82 / 3, 45 / 83 / 2, 135 / 84 / 2, 68 / 85 / 2, 126 / 86 / 2, 9 / 87 / 2, 351 / 88 / 5, 404 / 89 / 2, 309 / 90 / 3, 292 / 91 / 2, 240 / 92 / 5, 470 / 93 / 2, 315 / 94 / 2, 70 / 95 / 3, 388 / 96 / 2, 59 / 97 / 2, 279 / 98 / 2, 52 / 99 / 3, 13 / 100 / 2, 149 / 101 / 2, 173 / 102 / 2, 330 / 103 / 4, 172 / 104 / 2, 390 / 105 / 2, 299 / 106 / 2, 169 / 107 / 2, 302 / 108 / 2, 338 / 109 / 3, 332 / 110 / 2, 400 / 111 / 2, 360 / 112 / 3, 370 / 113 / 2, 139 / 114 / 2, 136 / 115 / 2, 319 / 116 / 3, 164 / 117 / 2, 414 / 118 / 2, 426 / 119 / 3, 337 / 120 / 2, 99 / 121 / 3, 308 / 122 / 2, 92 / 123 / 3, 207 / 124 / 2, 55 / 125 / 3, 53 / 126 / 2, 375 / 127 / 3, 327 / 128 / 2, 193 / 129 / 5, 176 / 130 / 2, 174 / 131 / 2, 175 / 132 / 2, 162 / 133 / 2, 3 / 134 / 3, 122 / 135 / 2, 182 / 136 / 2, 107 / 137 / 2, 296 / 138 / 2, 206 / 139 / 3, 35 / 140 / 2, 487 / 141 / 4, 178 / 142 / 2, 118 / 143 / 2, 323 / 144 / 4, 359 / 145 / 2, 458 / 146 / 2, 185 / 147 / 2, 365 / 148 / 2, 42 / 149 / 3, 124 / 150 / 2, 283 / 151 / 2, 49 / 152 / 3, 410 / 153 / 2, 41 / 154 / 2, 295 / 155 / 2, 389 / 156 / 5, 340 / 157 / 2, 78 / 158 / 3, 44 / 159 / 2, 353 / 160 / 2, 102 / 161 / 3, 358 / 162 / 2, 329 / 163 / 2, 267 / 164 / 3, 312 / 165 / 2, 398 / 166 / 3, 452 / 167 / 2, 184 / 168 / 3, 219 / 169 / 2, 325 / 170 / 2, 115 / 171 / 4, 465 / 172 / 2, 260 / 173 / 3, 497 / 174 / 2, 331 / 175 / 2, 281 / 176 / 2, 33 / 177 / 2, 294 / 178 / 3, 57 / 179 / 2, 223 / 180 / 2, 171 / 181 / 2, 494 / 182 / 3, 457 / 183 / 2, 440 / 184 / 4, 7 / 185 / 2, 205 / 186 / 3, 74 / 187 / 2, 361 / 188 / 3, 60 / 189 / 2, 238 / 190 / 4, 187 / 191 / 2, 409 / 192 / 2, 341 / 193 / 3, 128 / 194 / 2, 349 / 195 / 2, 101 / 196 / 3, 56 / 197 / 2, 131 / 198 / 3, 85 / 199 / 2, 321 / 200 / 3, 259 / 201 / 2, 199 / 202 / 2, 378 / 203 / 3, 142 / 204 / 2, 476 / 205 / 3, 344 / 206 / 2, 192 / 207 / 2, 261 / 208 / 3, 158 / 209 / 2, 89 / 210 / 2, 383 / 211 / 2, 23 / 212 / 2, 203 / 213 / 2, 343 / 214 / 2, 22 / 215 / 2, 482 / 216 / 3, 355 / 217 / 2, 116 / 218 / 3, 109 / 219 / 2, 363 / 220 / 2, 253 / 221 / 2, 1 / 222 / 2, 220 / 223 / 2, 34 / 224 / 4, 195 / 225 / 2, 250 / 226 / 2, 407 / 227 / 2, 98 / 228 / 2, 289 / 229 / 2, 474 / 230 / 2, 211 / 231 / 4, 88 / 232 / 2, 459 / 233 / 2, 262 / 234 / 2, 134 / 235 / 2, 392 / 236 / 2, 464 / 237 / 2, 300 / 238 / 2, 148 / 239 / 2, 241 / 240 / 2, 159 / 241 / 3, 293 / 242 / 2, 320 / 243 / 2, 379 / 244 / 3, 264 / 245 / 2, 430 / 246 / 2, 40 / 247 / 2, 196 / 248 / 2, 485 / 249 / 2, 314 / 250 / 2, 69 / 251 / 4, 80 / 252 / 2, 446 / 253 / 2, 93 / 254 / 2, 475 / 255 / 3, 216 / 256 / 2, 318 / 257 / 3, 467 / 258 / 2, 32 / 259 / 2, 381 / 260 / 2, 377 / 261 / 2, 51 / 262 / 3, 405 / 263 / 2, 416 / 264 / 3, 265 / 265 / 2, 130 / 266 / 2, 120 / 267 / 3, 236 / 268 / 2, 6 / 269 / 2, 450 / 270 / 2, 313 / 271 / 4, 30 / 272 / 2, 43 / 273 / 2, 354 / 274 / 3, 15 / 275 / 2, 156 / 276 / 2, 233 / 277 / 2, 291 / 278 / 5, 463 / 279 / 2, 371 / 280 / 2, 429 / 281 / 2, 246 / 282 / 3, 472 / 283 / 2, 439 / 284 / 2, 150 / 285 / 2, 243 / 286 / 2, 316 / 287 / 2, 226 / 288 / 2, 83 / 289 / 2, 141 / 290 / 3, 367 / 291 / 2, 288 / 292 / 3, 413 / 293 / 2, 127 / 294 / 3, 76 / 295 / 2, 39 / 296 / 4, 368 / 297 / 2, 285 / 298 / 2, 14 / 299 / 2, 19 / 300 / 2, 282 / 301 / 2, 132 / 302 / 3, 202 / 303 / 2, 61 / 304 / 3, 84 / 305 / 2, 256 / 306 / 2, 152 / 307 / 2, 2 / 308 / 4, 234 / 309 / 2, 468 / 310 / 2, 347 / 311 / 2, 64 / 312 / 2, 231 / 313 / 2, 280 / 314 / 2, 268 / 315 / 2, 77 / 316 / 5, 384 / 317 / 2, 442 / 318 / 2, 443 / 319 / 2, 489 / 320 / 2, 180 / 321 / 4, 373 / 322 / 2, 213 / 323 / 2, 200 / 324 / 3, 484 / 325 / 2, 87 / 326 / 3, 86 / 327 / 2, 391 / 328 / 3, 456 / 329 / 2, 145 / 330 / 2, 137 / 331 / 2, 133 / 332 / 2, 50 / 333 / 2, 326 / 334 / 2, 305 / 335 / 2, 181 / 336 / 2, 451 / 337 / 2, 257 / 338 / 2, 191 / 339 / 3, 258 / 340 / 2, 8 / 341 / 2, 356 / 342 / 4, 183 / 343 / 2, 146 / 344 / 2, 106 / 345 / 2, 270 / 346 / 3, 212 / 347 / 2, 72 / 348 / 2, 20 / 349 / 3, 81 / 350 / 2, 209 / 351 / 2, 198 / 352 / 2, 208 / 353 / 2, 75 / 354 / 2, 401 / 355 / 3, 362 / 356 / 2, 225 / 357 / 2, 471 / 358 / 2, 278 / 359 / 2, 108 / 360 / 2, 232 / 361 / 2, 65 / 362 / 5, 397 / 363 / 2, 408 / 364 / 2, 95 / 365 / 2, 230 / 366 / 3, 490 / 367 / 2, 154 / 368 / 3, 263 / 369 / 2, 63 / 370 / 2, 335 / 371 / 2, 110 / 372 / 5, 382 / 373 / 2, 493 / 374 / 2, 385 / 375 / 3, 168 / 376 / 2, 4 / 377 / 3, 170 / 378 / 2, 163 / 379 / 2, 386 / 380 / 4, 304 / 381 / 2, 224 / 382 / 3, 114 / 383 / 2, 96 / 384 / 5, 247 / 385 / 2, 415 / 386 / 2, 248 / 387 / 3, 396 / 388 / 2, 395 / 389 / 3, 140 / 390 / 2, 421 / 391 / 4, 322 / 392 / 2, 28 / 393 / 2, 62 / 394 / 2, 328 / 395 / 3, 252 / 396 / 2, 254 / 397 / 2, 217 / 398 / 2, 221 / 399 / 3, 364 / 400 / 2, 273 / 401 / 3, 165 / 402 / 2, 462 / 403 / 3, 284 / 404 / 2, 287 / 405 / 3, 276 / 406 / 2, 412 / 407 / 2, 67 / 408 / 3, 271 / 409 / 2, 239 / 410 / 2, 143 / 411 / 2, 105 / 412 / 3, 499 / 413 / 2, 286 / 414 / 3, 125 / 415 / 2, 432 / 416 / 2, 333 / 417 / 3, 16 / 418 / 2, 411 / 419 / 2, 249 / 420 / 2, 469 / 421 / 2, 481 / 422 / 4, 242 / 423 / 2, 372 / 424 / 2, 387 / 425 / 2, 350 / 426 / 2, 477 / 427 / 2, 336 / 428 / 3, 38 / 429 / 2, 237 / 430 / 2, 441 / 431 / 4, 119 / 432 / 2, 138 / 433 / 3, 251 / 434 / 2, 339 / 435 / 2, 455 / 436 / 2, 97 / 437 / 2, 498 / 438 / 2, 29 / 439 / 4, 177 / 440 / 2, 153 / 441 / 2, 483 / 442 / 2, 492 / 443 / 2, 453 / 444 / 4, 342 / 445 / 2, 245 / 446 / 2, 46 / 447 / 2, 376 / 448 / 3, 227 / 449 / 2, 201 / 450 / 3, 274 / 451 / 2, 357 / 452 / 2, 26 / 453 / 2, 334 / 454 / 4, 144 / 455 / 2, 448 / 456 / 2, 369 / 457 / 3, 24 / 458 / 2, 229 / 459 / 3, 427 / 460 / 2, 167 / 461 / 3, 66 / 462 / 2, 461 / 463 / 2, 491 / 464 / 2, 166 / 465 / 4, 58 / 466 / 2, 424 / 467 / 2, 437 / 468 / 3, 21 / 469 / 2, 215 / 470 / 2, 155 / 471 / 5, 111 / 472 / 2, 402 / 473 / 2, 479 / 474 / 2, 434 / 475 / 2, 112 / 476 / 4, 190 / 477 / 2, 151 / 478 / 2, 348 / 479 / 2, 444 / 480 / 2, 394 / 481 / 3, 161 / 482 / 2, 486 / 483 / 3, 275 / 484 / 2, 90 / 485 / 2, 36 / 486 / 4, 31 / 487 / 2, 129 / 488 / 2, 277 / 489 / 2, 445 / 490 / 2, 417 / 491 / 2, 123 / 492 / 3, 18 / 493 / 2, 310 / 494 / 4, 218 / 495 / 2, 228 / 496 / 2, 431 / 497 / 3, 436 / 498 / 2, 374 / 499 / 5
singlecenter-alpha_1-80-n50.txt, 1, 1, 50, 1036.53, 397, 347, 11, 49,7 / 1 / 2, 44 / 2 / 2, 26 / 3 / 7, 23 / 4 / 2, 4 / 5 / 3, 13 / 6 / 2, 46 / 7 / 2, 29 / 8 / 4, 42 / 9 / 2, 20 / 10 / 2, 8 / 11 / 2, 30 / 12 / 2, 5 / 13 / 3, 2 / 14 / 2, 22 / 15 / 2, 6 / 16 / 2, 45 / 17 / 2, 17 / 18 / 2, 21 / 19 / 3, 14 / 20 / 2, 35 / 21 / 2, 37 / 22 / 2, 39 / 23 / 2, 33 / 24 / 3, 3 / 25 / 2, 47 / 26 / 2, 1 / 27 / 2, 15 / 28 / 2, 16 / 29 / 6, 11 / 30 / 2, 28 / 31 / 2, 40 / 32 / 3, 34 / 33 / 2, 12 / 34 / 3, 36 / 35 / 2, 9 / 36 / 2, 25 / 37 / 2, 49 / 38 / 3, 27 / 39 / 2, 10 / 40 / 2, 32 / 41 / 3, 48 / 42 / 2, 38 / 43 / 3, 18 / 44 / 2, 31 / 45 / 2, 43 / 46 / 3, 19 / 47 / 2, 24 / 48 / 11, 41 / 49 / 2
singlecenter-alpha_1-81-n75.txt, 1, 1, 75, 1295.14, 625, 550, 6, 74,16 / 1 / 5, 17 / 2 / 2, 56 / 3 / 2, 31 / 4 / 2, 39 / 5 / 5, 37 / 6 / 2, 36 / 7 / 2, 62 / 8 / 2, 72 / 9 / 2, 1 / 10 / 6, 46 / 11 / 2, 63 / 12 / 2, 70 / 13 / 4, 41 / 14 / 2, 13 / 15 / 2, 44 / 16 / 3, 10 / 17 / 2, 59 / 18 / 3, 2 / 19 / 2, 67 / 20 / 2, 20 / 21 / 2, 28 / 22 / 2, 38 / 23 / 2, 50 / 24 / 3, 35 / 25 / 2, 60 / 26 / 2, 49 / 27 / 3, 64 / 28 / 2, 48 / 29 / 2, 15 / 30 / 3, 53 / 31 / 2, 5 / 32 / 2, 34 / 33 / 5, 66 / 34 / 2, 47 / 35 / 2, 26 / 36 / 2, 45 / 37 / 3, 3 / 38 / 2, 33 / 39 / 2, 51 / 40 / 2, 58 / 41 / 2, 27 / 42 / 2, 9 / 43 / 3, 71 / 44 / 2, 61 / 45 / 3, 42 / 46 / 2, 24 / 47 / 3, 65 / 48 / 2, 52 / 49 / 2, 73 / 50 / 3, 14 / 51 / 2, 22 / 52 / 2, 57 / 53 / 2, 21 / 54 / 3, 55 / 55 / 2, 40 / 56 / 3, 68 / 57 / 2, 43 / 58 / 2, 11 / 59 / 2, 12 / 60 / 2, 25 / 61 / 2, 23 / 62 / 2, 32 / 63 / 2, 19 / 64 / 6, 54 / 65 / 2, 29 / 66 / 2, 30 / 67 / 2, 7 / 68 / 4, 74 / 69 / 2, 18 / 70 / 2, 8 / 71 / 2, 4 / 72 / 4, 69 / 73 / 2, 6 / 74 / 2
singlecenter-alpha_1-82-n75.txt, 1, 1, 75, 1069.25, 729, 654, 8, 74,70 / 1 / 3, 51 / 2 / 2, 41 / 3 / 5, 24 / 4 / 2, 22 / 5 / 2, 64 / 6 / 2, 34 / 7 / 2, 45 / 8 / 8, 69 / 9 / 2, 44 / 10 / 2, 43 / 11 / 2, 68 / 12 / 2, 27 / 13 / 4, 71 / 14 / 2, 49 / 15 / 2, 7 / 16 / 2, 1 / 17 / 2, 32 / 18 / 3, 62 / 19 / 2, 37 / 20 / 3, 54 / 21 / 2, 67 / 22 / 3, 57 / 23 / 2, 72 / 24 / 3, 31 / 25 / 2, 40 / 26 / 2, 18 / 27 / 2, 52 / 28 / 2, 10 / 29 / 2, 56 / 30 / 3, 47 / 31 / 2, 29 / 32 / 2, 61 / 33 / 2, 48 / 34 / 3, 2 / 35 / 2, 11 / 36 / 2, 14 / 37 / 3, 12 / 38 / 2, 9 / 39 / 3, 36 / 40 / 2, 28 / 41 / 2, 4 / 42 / 5, 58 / 43 / 2, 46 / 44 / 2, 38 / 45 / 2, 50 / 46 / 2, 5 / 47 / 2, 73 / 48 / 2, 74 / 49 / 4, 63 / 50 / 2, 8 / 51 / 2, 39 / 52 / 3, 25 / 53 / 2, 20 / 54 / 3, 26 / 55 / 2, 30 / 56 / 3, 23 / 57 / 2, 6 / 58 / 2, 3 / 59 / 2, 17 / 60 / 2, 15 / 61 / 7, 59 / 62 / 2, 42 / 63 / 3, 21 / 64 / 2, 33 / 65 / 3, 53 / 66 / 2, 35 / 67 / 2, 55 / 68 / 3, 65 / 69 / 2, 16 / 70 / 3, 60 / 71 / 2, 13 / 72 / 2, 66 / 73 / 2, 19 / 74 / 3
singlecenter-alpha_1-83-n75.txt, 1, 1, 75, 1127.96, 629, 554, 6, 74,62 / 1 / 2, 3 / 2 / 2, 16 / 3 / 2, 8 / 4 / 3, 7 / 5 / 2, 64 / 6 / 3, 36 / 7 / 2, 25 / 8 / 2, 42 / 9 / 2, 17 / 10 / 2, 56 / 11 / 4, 26 / 12 / 2, 38 / 13 / 2, 49 / 14 / 2, 18 / 15 / 3, 67 / 16 / 2, 41 / 17 / 4, 44 / 18 / 2, 19 / 19 / 2, 4 / 20 / 2, 29 / 21 / 2, 70 / 22 / 6, 69 / 23 / 2, 9 / 24 / 2, 24 / 25 / 3, 28 / 26 / 2, 73 / 27 / 2, 1 / 28 / 3, 61 / 29 / 2, 31 / 30 / 2, 46 / 31 / 2, 50 / 32 / 2, 30 / 33 / 3, 68 / 34 / 2, 34 / 35 / 2, 22 / 36 / 2, 58 / 37 / 2, 39 / 38 / 2, 59 / 39 / 2, 11 / 40 / 2, 2 / 41 / 2, 20 / 42 / 2, 12 / 43 / 3, 13 / 44 / 2, 32 / 45 / 3, 66 / 46 / 2, 71 / 47 / 3, 72 / 48 / 2, 48 / 49 / 5, 57 / 50 / 2, 15 / 51 / 3, 37 / 52 / 2, 40 / 53 / 2, 27 / 54 / 2, 54 / 55 / 2, 10 / 56 / 6, 47 / 57 / 2, 51 / 58 / 2, 65 / 59 / 2, 55 / 60 / 2, 43 / 61 / 2, 5 / 62 / 2, 14 / 63 / 2, 52 / 64 / 2, 53 / 65 / 2, 21 / 66 / 3, 45 / 67 / 2, 33 / 68 / 2, 35 / 69 / 3, 74 / 70 / 2, 6 / 71 / 3, 60 / 72 / 2, 63 / 73 / 2, 23 / 74 / 2
singlecenter-alpha_1-84-n75.txt, 1, 1, 75, 1122.66, 505, 430, 5, 74,29 / 1 / 3, 7 / 2 / 2, 42 / 3 / 3, 12 / 4 / 2, 24 / 5 / 3, 6 / 6 / 2, 70 / 7 / 2, 35 / 8 / 3, 60 / 9 / 2, 5 / 10 / 2, 3 / 11 / 2, 57 / 12 / 3, 54 / 13 / 2, 11 / 14 / 2, 53 / 15 / 2, 28 / 16 / 3, 21 / 17 / 2, 51 / 18 / 3, 64 / 19 / 2, 8 / 20 / 2, 32 / 21 / 4, 37 / 22 / 2, 46 / 23 / 2, 13 / 24 / 2, 58 / 25 / 3, 43 / 26 / 2, 4 / 27 / 2, 20 / 28 / 2, 27 / 29 / 3, 55 / 30 / 2, 2 / 31 / 3, 45 / 32 / 2, 72 / 33 / 2, 17 / 34 / 2, 9 / 35 / 5, 30 / 36 / 2, 18 / 37 / 2, 66 / 38 / 2, 74 / 39 / 2, 15 / 40 / 2, 34 / 41 / 2, 40 / 42 / 3, 71 / 43 / 2, 59 / 44 / 2, 69 / 45 / 3, 62 / 46 / 2, 41 / 47 / 3, 23 / 48 / 2, 65 / 49 / 2, 52 / 50 / 2, 39 / 51 / 2, 14 / 52 / 2, 61 / 53 / 4, 25 / 54 / 2, 22 / 55 / 2, 26 / 56 / 4, 63 / 57 / 2, 33 / 58 / 2, 31 / 59 / 2, 19 / 60 / 3, 16 / 61 / 2, 36 / 62 / 3, 38 / 63 / 2, 44 / 64 / 2, 73 / 65 / 3, 67 / 66 / 2, 1 / 67 / 3, 10 / 68 / 2, 47 / 69 / 2, 50 / 70 / 2, 68 / 71 / 4, 48 / 72 / 2, 56 / 73 / 2, 49 / 74 / 2
singlecenter-alpha_1-85-n75.txt, 1, 1, 75, 1055.54, 891, 816, 17, 74,12 / 1 / 2, 69 / 2 / 2, 31 / 3 / 2, 16 / 4 / 3, 58 / 5 / 2, 1 / 6 / 2, 42 / 7 / 3, 32 / 8 / 2, 13 / 9 / 2, 68 / 10 / 2, 18 / 11 / 2, 2 / 12 / 2, 17 / 13 / 2, 44 / 14 / 2, 21 / 15 / 4, 19 / 16 / 2, 49 / 17 / 3, 15 / 18 / 2, 30 / 19 / 3, 28 / 20 / 2, 57 / 21 / 17, 43 / 22 / 2, 22 / 23 / 3, 64 / 24 / 2, 24 / 25 / 2, 60 / 26 / 2, 27 / 27 / 4, 37 / 28 / 2, 25 / 29 / 2, 48 / 30 / 2, 35 / 31 / 2, 73 / 32 / 2, 39 / 33 / 3, 47 / 34 / 2, 53 / 35 / 2, 5 / 36 / 2, 71 / 37 / 3, 7 / 38 / 2, 38 / 39 / 3, 8 / 40 / 2, 65 / 41 / 4, 34 / 42 / 2, 36 / 43 / 2, 23 / 44 / 4, 63 / 45 / 2, 14 / 46 / 2, 26 / 47 / 2, 70 / 48 / 4, 9 / 49 / 2, 61 / 50 / 2, 29 / 51 / 4, 41 / 52 / 2, 55 / 53 / 3, 54 / 54 / 2, 56 / 55 / 3, 67 / 56 / 2, 72 / 57 / 2, 40 / 58 / 3, 10 / 59 / 2, 3 / 60 / 2, 46 / 61 / 2, 52 / 62 / 5, 20 / 63 / 2, 74 / 64 / 3, 11 / 65 / 2, 59 / 66 / 2, 50 / 67 / 2, 33 / 68 / 3, 51 / 69 / 2, 66 / 70 / 3, 4 / 71 / 2, 62 / 72 / 2, 45 / 73 / 2, 6 / 74 / 4
singlecenter-alpha_1-86-n75.txt, 1, 1, 75, 1245.95, 607, 532, 8, 74,50 / 1 / 3, 69 / 2 / 2, 6 / 3 / 3, 70 / 4 / 2, 10 / 5 / 3, 45 / 6 / 2, 21 / 7 / 3, 55 / 8 / 2, 30 / 9 / 3, 62 / 10 / 2, 32 / 11 / 2, 1 / 12 / 2, 22 / 13 / 2, 37 / 14 / 2, 58 / 15 / 2, 73 / 16 / 2, 52 / 17 / 2, 51 / 18 / 2, 20 / 19 / 2, 17 / 20 / 3, 16 / 21 / 2, 35 / 22 / 2, 65 / 23 / 4, 68 / 24 / 2, 12 / 25 / 3, 56 / 26 / 2, 64 / 27 / 3, 41 / 28 / 2, 40 / 29 / 2, 39 / 30 / 2, 48 / 31 / 5, 59 / 32 / 2, 3 / 33 / 3, 15 / 34 / 2, 5 / 35 / 4, 46 / 36 / 2, 9 / 37 / 2, 74 / 38 / 3, 8 / 39 / 2, 19 / 40 / 2, 61 / 41 / 2, 49 / 42 / 2, 47 / 43 / 2, 2 / 44 / 5, 26 / 45 / 2, 7 / 46 / 2, 23 / 47 / 3, 67 / 48 / 2, 42 / 49 / 5, 36 / 50 / 2, 18 / 51 / 2, 34 / 52 / 2, 33 / 53 / 2, 38 / 54 / 4, 4 / 55 / 2, 43 / 56 / 2, 13 / 57 / 2, 66 / 58 / 2, 72 / 59 / 2, 53 / 60 / 2, 71 / 61 / 2, 29 / 62 / 4, 24 / 63 / 2, 57 / 64 / 2, 44 / 65 / 2, 28 / 66 / 8, 60 / 67 / 2, 14 / 68 / 2, 27 / 69 / 2, 11 / 70 / 2, 54 / 71 / 3, 63 / 72 / 2, 25 / 73 / 2, 31 / 74 / 7
singlecenter-alpha_1-87-n75.txt, 1, 1, 75, 1149.61, 596, 521, 6, 74,30 / 1 / 5, 21 / 2 / 2, 17 / 3 / 2, 29 / 4 / 2, 69 / 5 / 2, 12 / 6 / 2, 51 / 7 / 2, 32 / 8 / 2, 11 / 9 / 2, 49 / 10 / 2, 60 / 11 / 3, 63 / 12 / 2, 54 / 13 / 2, 41 / 14 / 3, 15 / 15 / 2, 34 / 16 / 4, 43 / 17 / 2, 57 / 18 / 3, 6 / 19 / 2, 23 / 20 / 2, 50 / 21 / 3, 64 / 22 / 2, 74 / 23 / 2, 28 / 24 / 2, 2 / 25 / 2, 19 / 26 / 2, 13 / 27 / 3, 56 / 28 / 2, 14 / 29 / 2, 42 / 30 / 3, 20 / 31 / 2, 45 / 32 / 2, 1 / 33 / 3, 39 / 34 / 2, 16 / 35 / 2, 47 / 36 / 2, 65 / 37 / 2, 71 / 38 / 3, 31 / 39 / 2, 67 / 40 / 2, 27 / 41 / 2, 70 / 42 / 3, 40 / 43 / 2, 24 / 44 / 2, 72 / 45 / 3, 55 / 46 / 2, 44 / 47 / 3, 5 / 48 / 2, 61 / 49 / 3, 22 / 50 / 2, 7 / 51 / 2, 46 / 52 / 2, 68 / 53 / 2, 66 / 54 / 6, 53 / 55 / 2, 37 / 56 / 2, 52 / 57 / 2, 25 / 58 / 2, 3 / 59 / 6, 36 / 60 / 2, 35 / 61 / 2, 10 / 62 / 3, 33 / 63 / 2, 8 / 64 / 3, 59 / 65 / 2, 73 / 66 / 2, 4 / 67 / 2, 62 / 68 / 2, 38 / 69 / 3, 58 / 70 / 2, 18 / 71 / 5, 9 / 72 / 2, 48 / 73 / 2, 26 / 74 / 4
singlecenter-alpha_1-88-n75.txt, 1, 1, 75, 1282.18, 812, 737, 8, 74,28 / 1 / 3, 62 / 2 / 2, 25 / 3 / 2, 33 / 4 / 2, 56 / 5 / 4, 22 / 6 / 2, 27 / 7 / 3, 53 / 8 / 2, 18 / 9 / 2, 20 / 10 / 8, 36 / 11 / 2, 44 / 12 / 2, 29 / 13 / 2, 66 / 14 / 2, 38 / 15 / 2, 57 / 16 / 2, 35 / 17 / 2, 73 / 18 / 2, 16 / 19 / 2, 54 / 20 / 3, 34 / 21 / 2, 58 / 22 / 4, 6 / 23 / 2, 10 / 24 / 2, 51 / 25 / 3, 14 / 26 / 2, 71 / 27 / 3, 32 / 28 / 2, 13 / 29 / 2, 61 / 30 / 3, 41 / 31 / 2, 67 / 32 / 2, 48 / 33 / 2, 1 / 34 / 2, 43 / 35 / 2, 31 / 36 / 2, 23 / 37 / 3, 47 / 38 / 2, 30 / 39 / 2, 24 / 40 / 2, 9 / 41 / 4, 63 / 42 / 2, 3 / 43 / 2, 5 / 44 / 4, 72 / 45 / 2, 19 / 46 / 2, 50 / 47 / 4, 60 / 48 / 2, 37 / 49 / 3, 21 / 50 / 2, 70 / 51 / 3, 74 / 52 / 2, 69 / 53 / 7, 7 / 54 / 2, 55 / 55 / 3, 52 / 56 / 2, 59 / 57 / 2, 26 / 58 / 3, 46 / 59 / 2, 65 / 60 / 2, 64 / 61 / 3, 68 / 62 / 2, 39 / 63 / 3, 12 / 64 / 2, 42 / 65 / 2, 40 / 66 / 4, 11 / 67 / 2, 49 / 68 / 2, 45 / 69 / 2, 17 / 70 / 3, 8 / 71 / 2, 15 / 72 / 3, 4 / 73 / 2, 2 / 74 / 2
singlecenter-alpha_1-89-n75.txt, 1, 1, 75, 1099.94, 577, 502, 6, 74,73 / 1 / 3, 15 / 2 / 2, 31 / 3 / 2, 55 / 4 / 3, 30 / 5 / 2, 64 / 6 / 2, 37 / 7 / 2, 33 / 8 / 4, 20 / 9 / 2, 5 / 10 / 2, 56 / 11 / 2, 60 / 12 / 2, 53 / 13 / 2, 34 / 14 / 2, 17 / 15 / 2, 6 / 16 / 3, 2 / 17 / 2, 48 / 18 / 3, 59 / 19 / 2, 40 / 20 / 4, 16 / 21 / 2, 38 / 22 / 2, 9 / 23 / 2, 57 / 24 / 3, 62 / 25 / 2, 66 / 26 / 2, 27 / 27 / 2, 50 / 28 / 2, 36 / 29 / 3, 19 / 30 / 2, 13 / 31 / 3, 51 / 32 / 2, 45 / 33 / 2, 43 / 34 / 2, 14 / 35 / 3, 35 / 36 / 2, 52 / 37 / 2, 4 / 38 / 2, 61 / 39 / 6, 49 / 40 / 2, 7 / 41 / 2, 3 / 42 / 3, 58 / 43 / 2, 46 / 44 / 2, 70 / 45 / 2, 72 / 46 / 4, 10 / 47 / 2, 69 / 48 / 3, 47 / 49 / 2, 23 / 50 / 3, 63 / 51 / 2, 12 / 52 / 2, 11 / 53 / 3, 54 / 54 / 2, 41 / 55 / 2, 42 / 56 / 3, 8 / 57 / 2, 74 / 58 / 2, 39 / 59 / 2, 1 / 60 / 2, 25 / 61 / 2, 26 / 62 / 2, 65 / 63 / 3, 32 / 64 / 2, 24 / 65 / 2, 68 / 66 / 2, 71 / 67 / 2, 22 / 68 / 2, 28 / 69 / 4, 67 / 70 / 2, 29 / 71 / 2, 21 / 72 / 2, 18 / 73 / 2, 44 / 74 / 4
singlecenter-alpha_1-9-n250.txt, 1, 1, 250, 2181.65, 1849, 1599, 6, 249,151 / 1 / 2, 171 / 2 / 2, 183 / 3 / 3, 185 / 4 / 2, 109 / 5 / 2, 97 / 6 / 4, 82 / 7 / 2, 63 / 8 / 2, 17 / 9 / 2, 90 / 10 / 2, 15 / 11 / 4, 214 / 12 / 2, 89 / 13 / 3, 231 / 14 / 2, 111 / 15 / 3, 246 / 16 / 2, 3 / 17 / 3, 66 / 18 / 2, 234 / 19 / 3, 164 / 20 / 2, 133 / 21 / 3, 36 / 22 / 2, 233 / 23 / 3, 243 / 24 / 2, 9 / 25 / 2, 83 / 26 / 3, 124 / 27 / 2, 5 / 28 / 3, 47 / 29 / 2, 43 / 30 / 4, 64 / 31 / 2, 176 / 32 / 2, 93 / 33 / 2, 223 / 34 / 4, 215 / 35 / 2, 80 / 36 / 2, 148 / 37 / 4, 123 / 38 / 2, 46 / 39 / 2, 135 / 40 / 4, 143 / 41 / 2, 141 / 42 / 2, 67 / 43 / 4, 33 / 44 / 2, 240 / 45 / 2, 239 / 46 / 3, 14 / 47 / 2, 153 / 48 / 3, 189 / 49 / 2, 197 / 50 / 3, 139 / 51 / 2, 136 / 52 / 4, 178 / 53 / 2, 28 / 54 / 2, 103 / 55 / 2, 55 / 56 / 4, 29 / 57 / 2, 192 / 58 / 2, 168 / 59 / 2, 27 / 60 / 2, 194 / 61 / 6, 99 / 62 / 2, 32 / 63 / 2, 208 / 64 / 2, 116 / 65 / 2, 2 / 66 / 2, 76 / 67 / 2, 120 / 68 / 2, 85 / 69 / 2, 91 / 70 / 2, 235 / 71 / 3, 227 / 72 / 2, 73 / 73 / 2, 7 / 74 / 2, 20 / 75 / 2, 152 / 76 / 4, 207 / 77 / 2, 198 / 78 / 2, 60 / 79 / 2, 165 / 80 / 3, 174 / 81 / 2, 209 / 82 / 2, 34 / 83 / 2, 10 / 84 / 2, 45 / 85 / 3, 217 / 86 / 2, 166 / 87 / 2, 8 / 88 / 2, 21 / 89 / 4, 41 / 90 / 2, 118 / 91 / 2, 23 / 92 / 2, 147 / 93 / 2, 169 / 94 / 3, 201 / 95 / 2, 131 / 96 / 2, 108 / 97 / 2, 96 / 98 / 3, 203 / 99 / 2, 179 / 100 / 3, 70 / 101 / 2, 100 / 102 / 2, 130 / 103 / 3, 132 / 104 / 2, 48 / 105 / 2, 140 / 106 / 3, 61 / 107 / 2, 216 / 108 / 3, 222 / 109 / 2, 158 / 110 / 2, 114 / 111 / 2, 117 / 112 / 3, 95 / 113 / 2, 175 / 114 / 2, 16 / 115 / 2, 113 / 116 / 2, 228 / 117 / 2, 154 / 118 / 3, 244 / 119 / 2, 206 / 120 / 2, 22 / 121 / 2, 92 / 122 / 2, 236 / 123 / 2, 59 / 124 / 2, 68 / 125 / 3, 225 / 126 / 2, 51 / 127 / 2, 213 / 128 / 3, 202 / 129 / 2, 181 / 130 / 3, 195 / 131 / 2, 78 / 132 / 2, 94 / 133 / 3, 129 / 134 / 2, 172 / 135 / 4, 42 / 136 / 2, 247 / 137 / 2, 182 / 138 / 2, 196 / 139 / 3, 110 / 140 / 2, 11 / 141 / 2, 157 / 142 / 2, 40 / 143 / 2, 249 / 144 / 3, 1 / 145 / 2, 37 / 146 / 2, 52 / 147 / 2, 127 / 148 / 2, 241 / 149 / 3, 54 / 150 / 2, 137 / 151 / 2, 25 / 152 / 3, 190 / 153 / 2, 167 / 154 / 2, 212 / 155 / 2, 156 / 156 / 2, 191 / 157 / 3, 26 / 158 / 2, 163 / 159 / 3, 56 / 160 / 2, 105 / 161 / 3, 188 / 162 / 2, 49 / 163 / 2, 177 / 164 / 2, 12 / 165 / 4, 13 / 166 / 2, 75 / 167 / 2, 69 / 168 / 2, 186 / 169 / 2, 125 / 170 / 2, 229 / 171 / 2, 71 / 172 / 3, 122 / 173 / 2, 184 / 174 / 5, 62 / 175 / 2, 142 / 176 / 2, 31 / 177 / 2, 79 / 178 / 2, 199 / 179 / 3, 232 / 180 / 2, 19 / 181 / 3, 226 / 182 / 2, 210 / 183 / 3, 104 / 184 / 2, 102 / 185 / 2, 87 / 186 / 3, 230 / 187 / 2, 245 / 188 / 2, 146 / 189 / 5, 18 / 190 / 2, 160 / 191 / 2, 4 / 192 / 2, 204 / 193 / 5, 138 / 194 / 2, 30 / 195 / 3, 84 / 196 / 2, 107 / 197 / 2, 115 / 198 / 2, 162 / 199 / 2, 6 / 200 / 2, 238 / 201 / 2, 39 / 202 / 2, 72 / 203 / 2, 58 / 204 / 3, 121 / 205 / 2, 53 / 206 / 2, 98 / 207 / 3, 74 / 208 / 2, 77 / 209 / 3, 180 / 210 / 2, 38 / 211 / 2, 145 / 212 / 4, 224 / 213 / 2, 112 / 214 / 2, 144 / 215 / 2, 159 / 216 / 2, 150 / 217 / 5, 50 / 218 / 2, 237 / 219 / 2, 88 / 220 / 2, 101 / 221 / 2, 44 / 222 / 3, 248 / 223 / 2, 205 / 224 / 3, 242 / 225 / 2, 170 / 226 / 2, 57 / 227 / 2, 218 / 228 / 2, 155 / 229 / 2, 200 / 230 / 2, 134 / 231 / 3, 24 / 232 / 2, 221 / 233 / 2, 193 / 234 / 3, 219 / 235 / 2, 211 / 236 / 2, 149 / 237 / 3, 81 / 238 / 2, 119 / 239 / 2, 106 / 240 / 2, 187 / 241 / 2, 65 / 242 / 3, 173 / 243 / 2, 86 / 244 / 2, 35 / 245 / 2, 128 / 246 / 4, 220 / 247 / 2, 126 / 248 / 2, 161 / 249 / 3
singlecenter-alpha_1-9-n5.txt, 1, 1, 5, 286.675, 18, 13, 5, 4,2 / 1 / 2, 3 / 2 / 2, 4 / 3 / 2, 1 / 4 / 5
singlecenter-alpha_1-9-n500.txt, 1, 1, 500, 3110.57, 3801, 3301, 9, 499,69 / 1 / 2, 356 / 2 / 5, 207 / 3 / 2, 121 / 4 / 2, 402 / 5 / 3, 464 / 6 / 2, 30 / 7 / 2, 423 / 8 / 2, 234 / 9 / 3, 380 / 10 / 2, 211 / 11 / 2, 468 / 12 / 2, 136 / 13 / 2, 230 / 14 / 3, 163 / 15 / 2, 62 / 16 / 3, 98 / 17 / 2, 453 / 18 / 3, 359 / 19 / 2, 85 / 20 / 2, 441 / 21 / 3, 412 / 22 / 2, 487 / 23 / 2, 134 / 24 / 3, 228 / 25 / 2, 401 / 26 / 2, 105 / 27 / 5, 252 / 28 / 2, 227 / 29 / 2, 77 / 30 / 4, 270 / 31 / 2, 81 / 32 / 2, 16 / 33 / 3, 56 / 34 / 2, 291 / 35 / 2, 463 / 36 / 3, 495 / 37 / 2, 122 / 38 / 3, 87 / 39 / 2, 449 / 40 / 2, 319 / 41 / 2, 479 / 42 / 3, 278 / 43 / 2, 127 / 44 / 2, 410 / 45 / 2, 352 / 46 / 4, 75 / 47 / 2, 338 / 48 / 2, 111 / 49 / 4, 316 / 50 / 2, 446 / 51 / 2, 23 / 52 / 2, 249 / 53 / 2, 413 / 54 / 2, 246 / 55 / 3, 190 / 56 / 2, 79 / 57 / 2, 219 / 58 / 2, 251 / 59 / 2, 232 / 60 / 4, 443 / 61 / 2, 9 / 62 / 2, 439 / 63 / 4, 241 / 64 / 2, 104 / 65 / 2, 187 / 66 / 3, 418 / 67 / 2, 266 / 68 / 3, 327 / 69 / 2, 375 / 70 / 4, 476 / 71 / 2, 432 / 72 / 2, 334 / 73 / 3, 78 / 74 / 2, 36 / 75 / 2, 84 / 76 / 3, 101 / 77 / 2, 154 / 78 / 2, 143 / 79 / 2, 342 / 80 / 3, 74 / 81 / 2, 318 / 82 / 3, 371 / 83 / 2, 472 / 84 / 2, 73 / 85 / 3, 404 / 86 / 2, 46 / 87 / 4, 303 / 88 / 2, 123 / 89 / 2, 65 / 90 / 3, 466 / 91 / 2, 49 / 92 / 2, 233 / 93 / 2, 320 / 94 / 2, 417 / 95 / 2, 194 / 96 / 3, 13 / 97 / 2, 220 / 98 / 2, 262 / 99 / 2, 99 / 100 / 2, 242 / 101 / 2, 168 / 102 / 3, 156 / 103 / 2, 326 / 104 / 3, 7 / 105 / 2, 160 / 106 / 2, 188 / 107 / 3, 43 / 108 / 2, 351 / 109 / 3, 116 / 110 / 2, 461 / 111 / 2, 38 / 112 / 2, 279 / 113 / 2, 332 / 114 / 4, 400 / 115 / 2, 470 / 116 / 2, 238 / 117 / 2, 486 / 118 / 2, 170 / 119 / 2, 148 / 120 / 3, 349 / 121 / 2, 150 / 122 / 2, 198 / 123 / 4, 394 / 124 / 2, 367 / 125 / 2, 44 / 126 / 3, 498 / 127 / 2, 272 / 128 / 2, 276 / 129 / 2, 248 / 130 / 3, 250 / 131 / 2, 454 / 132 / 2, 223 / 133 / 2, 354 / 134 / 3, 490 / 135 / 2, 155 / 136 / 2, 202 / 137 / 2, 345 / 138 / 3, 12 / 139 / 2, 333 / 140 / 2, 254 / 141 / 3, 109 / 142 / 2, 153 / 143 / 3, 364 / 144 / 2, 172 / 145 / 2, 390 / 146 / 3, 383 / 147 / 2, 132 / 148 / 2, 396 / 149 / 4, 203 / 150 / 2, 8 / 151 / 2, 325 / 152 / 2, 433 / 153 / 2, 91 / 154 / 3, 491 / 155 / 2, 48 / 156 / 2, 469 / 157 / 4, 440 / 158 / 2, 1 / 159 / 2, 307 / 160 / 3, 210 / 161 / 2, 389 / 162 / 2, 482 / 163 / 2, 341 / 164 / 2, 492 / 165 / 2, 18 / 166 / 2, 226 / 167 / 2, 261 / 168 / 4, 271 / 169 / 2, 414 / 170 / 3, 314 / 171 / 2, 312 / 172 / 2, 201 / 173 / 2, 61 / 174 / 2, 471 / 175 / 2, 102 / 176 / 2, 208 / 177 / 2, 88 / 178 / 2, 274 / 179 / 3, 110 / 180 / 2, 366 / 181 / 3, 374 / 182 / 2, 391 / 183 / 3, 177 / 184 / 2, 465 / 185 / 3, 493 / 186 / 2, 120 / 187 / 2, 322 / 188 / 2, 139 / 189 / 2, 55 / 190 / 2, 293 / 191 / 2, 384 / 192 / 2, 358 / 193 / 4, 180 / 194 / 2, 323 / 195 / 2, 14 / 196 / 4, 184 / 197 / 2, 393 / 198 / 2, 182 / 199 / 3, 173 / 200 / 2, 83 / 201 / 3, 45 / 202 / 2, 256 / 203 / 3, 422 / 204 / 2, 50 / 205 / 2, 269 / 206 / 4, 76 / 207 / 2, 372 / 208 / 2, 191 / 209 / 2, 403 / 210 / 2, 89 / 211 / 2, 363 / 212 / 2, 434 / 213 / 4, 25 / 214 / 2, 119 / 215 / 3, 90 / 216 / 2, 377 / 217 / 2, 275 / 218 / 4, 93 / 219 / 2, 310 / 220 / 2, 205 / 221 / 2, 138 / 222 / 3, 224 / 223 / 2, 444 / 224 / 2, 178 / 225 / 4, 32 / 226 / 2, 346 / 227 / 2, 135 / 228 / 3, 496 / 229 / 2, 304 / 230 / 3, 457 / 231 / 2, 137 / 232 / 2, 161 / 233 / 5, 144 / 234 / 2, 313 / 235 / 2, 481 / 236 / 2, 462 / 237 / 5, 166 / 238 / 2, 97 / 239 / 2, 26 / 240 / 3, 94 / 241 / 2, 53 / 242 / 4, 370 / 243 / 2, 497 / 244 / 2, 398 / 245 / 3, 24 / 246 / 2, 33 / 247 / 2, 474 / 248 / 2, 369 / 249 / 2, 66 / 250 / 6, 128 / 251 / 2, 245 / 252 / 2, 64 / 253 / 2, 58 / 254 / 2, 283 / 255 / 2, 361 / 256 / 9, 277 / 257 / 2, 328 / 258 / 2, 195 / 259 / 2, 339 / 260 / 3, 68 / 261 / 2, 28 / 262 / 3, 407 / 263 / 2, 315 / 264 / 2, 485 / 265 / 3, 186 / 266 / 2, 218 / 267 / 2, 239 / 268 / 2, 392 / 269 / 3, 306 / 270 / 2, 475 / 271 / 3, 406 / 272 / 2, 426 / 273 / 2, 448 / 274 / 3, 329 / 275 / 2, 290 / 276 / 3, 60 / 277 / 2, 29 / 278 / 5, 146 / 279 / 2, 263 / 280 / 2, 125 / 281 / 2, 424 / 282 / 5, 302 / 283 / 2, 183 / 284 / 2, 489 / 285 / 2, 72 / 286 / 2, 427 / 287 / 3, 282 / 288 / 2, 106 / 289 / 2, 145 / 290 / 2, 235 / 291 / 2, 181 / 292 / 2, 236 / 293 / 2, 381 / 294 / 2, 115 / 295 / 3, 142 / 296 / 2, 27 / 297 / 2, 456 / 298 / 2, 96 / 299 / 2, 217 / 300 / 2, 114 / 301 / 2, 455 / 302 / 3, 197 / 303 / 2, 151 / 304 / 3, 192 / 305 / 2, 309 / 306 / 2, 31 / 307 / 3, 174 / 308 / 2, 289 / 309 / 3, 57 / 310 / 2, 311 / 311 / 3, 373 / 312 / 2, 365 / 313 / 2, 409 / 314 / 2, 34 / 315 / 2, 416 / 316 / 2, 343 / 317 / 3, 6 / 318 / 2, 280 / 319 / 3, 126 / 320 / 2, 268 / 321 / 2, 296 / 322 / 2, 129 / 323 / 2, 488 / 324 / 3, 300 / 325 / 2, 80 / 326 / 2, 353 / 327 / 2, 5 / 328 / 3, 71 / 329 / 2, 299 / 330 / 2, 395 / 331 / 2, 337 / 332 / 2, 437 / 333 / 2, 368 / 334 / 2, 70 / 335 / 2, 231 / 336 / 3, 308 / 337 / 2, 273 / 338 / 2, 247 / 339 / 2, 149 / 340 / 3, 147 / 341 / 2, 212 / 342 / 2, 67 / 343 / 3, 35 / 344 / 2, 348 / 345 / 2, 382 / 346 / 3, 193 / 347 / 2, 131 / 348 / 3, 452 / 349 / 2, 257 / 350 / 2, 477 / 351 / 2, 478 / 352 / 2, 189 / 353 / 2, 196 / 354 / 3, 237 / 355 / 2, 340 / 356 / 3, 447 / 357 / 2, 108 / 358 / 2, 450 / 359 / 3, 255 / 360 / 2, 100 / 361 / 2, 37 / 362 / 2, 460 / 363 / 2, 243 / 364 / 2, 436 / 365 / 2, 112 / 366 / 2, 330 / 367 / 2, 411 / 368 / 2, 63 / 369 / 2, 483 / 370 / 2, 344 / 371 / 2, 10 / 372 / 3, 3 / 373 / 2, 357 / 374 / 2, 397 / 375 / 2, 213 / 376 / 2, 294 / 377 / 2, 399 / 378 / 4, 442 / 379 / 2, 40 / 380 / 2, 215 / 381 / 2, 240 / 382 / 2, 259 / 383 / 4, 124 / 384 / 2, 20 / 385 / 2, 285 / 386 / 2, 298 / 387 / 3, 264 / 388 / 2, 130 / 389 / 2, 297 / 390 / 4, 386 / 391 / 2, 260 / 392 / 2, 415 / 393 / 2, 204 / 394 / 3, 42 / 395 / 2, 317 / 396 / 3, 467 / 397 / 2, 425 / 398 / 2, 288 / 399 / 2, 459 / 400 / 2, 206 / 401 / 2, 484 / 402 / 3, 419 / 403 / 2, 458 / 404 / 2, 86 / 405 / 2, 209 / 406 / 4, 222 / 407 / 2, 152 / 408 / 2, 158 / 409 / 2, 162 / 410 / 4, 54 / 411 / 2, 267 / 412 / 2, 165 / 413 / 4, 362 / 414 / 2, 221 / 415 / 2, 21 / 416 / 3, 331 / 417 / 2, 141 / 418 / 3, 420 / 419 / 2, 103 / 420 / 2, 225 / 421 / 2, 324 / 422 / 2, 15 / 423 / 2, 185 / 424 / 2, 157 / 425 / 2, 431 / 426 / 2, 169 / 427 / 3, 133 / 428 / 2, 286 / 429 / 2, 388 / 430 / 2, 244 / 431 / 3, 200 / 432 / 2, 421 / 433 / 5, 281 / 434 / 2, 435 / 435 / 2, 59 / 436 / 3, 51 / 437 / 2, 176 / 438 / 2, 216 / 439 / 4, 92 / 440 / 2, 347 / 441 / 2, 321 / 442 / 2, 118 / 443 / 2, 2 / 444 / 3, 355 / 445 / 2, 265 / 446 / 2, 473 / 447 / 2, 140 / 448 / 2, 335 / 449 / 2, 499 / 450 / 2, 113 / 451 / 2, 214 / 452 / 4, 258 / 453 / 2, 287 / 454 / 2, 494 / 455 / 4, 17 / 456 / 2, 480 / 457 / 3, 429 / 458 / 2, 376 / 459 / 2, 385 / 460 / 6, 47 / 461 / 2, 292 / 462 / 3, 82 / 463 / 2, 350 / 464 / 3, 379 / 465 / 2, 301 / 466 / 2, 408 / 467 / 2, 117 / 468 / 4, 164 / 469 / 2, 52 / 470 / 3, 405 / 471 / 2, 179 / 472 / 3, 378 / 473 / 2, 430 / 474 / 3, 438 / 475 / 2, 159 / 476 / 2, 199 / 477 / 4, 445 / 478 / 2, 428 / 479 / 2, 305 / 480 / 4, 229 / 481 / 2, 336 / 482 / 2, 387 / 483 / 2, 253 / 484 / 2, 19 / 485 / 2, 175 / 486 / 2, 284 / 487 / 2, 41 / 488 / 2, 167 / 489 / 3, 39 / 490 / 2, 451 / 491 / 2, 11 / 492 / 2, 22 / 493 / 6, 171 / 494 / 2, 360 / 495 / 2, 295 / 496 / 3, 107 / 497 / 2, 95 / 498 / 2, 4 / 499 / 7
singlecenter-alpha_1-90-n75.txt, 1, 1, 75, 1252.13, 522, 447, 9, 74,66 / 1 / 4, 68 / 2 / 2, 67 / 3 / 2, 22 / 4 / 2, 39 / 5 / 2, 11 / 6 / 2, 45 / 7 / 2, 27 / 8 / 2, 1 / 9 / 2, 62 / 10 / 2, 71 / 11 / 2, 50 / 12 / 3, 52 / 13 / 2, 48 / 14 / 3, 35 / 15 / 2, 12 / 16 / 2, 72 / 17 / 2, 38 / 18 / 2, 59 / 19 / 3, 34 / 20 / 2, 60 / 21 / 2, 29 / 22 / 3, 2 / 23 / 2, 53 / 24 / 3, 20 / 25 / 2, 49 / 26 / 2, 26 / 27 / 3, 36 / 28 / 2, 41 / 29 / 4, 40 / 30 / 2, 74 / 31 / 2, 13 / 32 / 2, 19 / 33 / 2, 30 / 34 / 2, 15 / 35 / 2, 42 / 36 / 2, 56 / 37 / 2, 10 / 38 / 3, 57 / 39 / 2, 61 / 40 / 3, 63 / 41 / 2, 28 / 42 / 3, 4 / 43 / 2, 23 / 44 / 3, 51 / 45 / 2, 25 / 46 / 3, 21 / 47 / 2, 33 / 48 / 2, 9 / 49 / 2, 17 / 50 / 3, 55 / 51 / 2, 8 / 52 / 3, 5 / 53 / 2, 46 / 54 / 2, 69 / 55 / 3, 64 / 56 / 2, 32 / 57 / 2, 44 / 58 / 3, 7 / 59 / 2, 18 / 60 / 3, 3 / 61 / 2, 31 / 62 / 2, 16 / 63 / 4, 73 / 64 / 2, 65 / 65 / 2, 24 / 66 / 2, 14 / 67 / 4, 70 / 68 / 2, 54 / 69 / 3, 6 / 70 / 2, 58 / 71 / 2, 37 / 72 / 3, 47 / 73 / 2, 43 / 74 / 9
singlecenter-alpha_1-91-n100.txt, 1, 1, 100, 1352.99, 838, 738, 6, 99,81 / 1 / 2, 2 / 2 / 3, 35 / 3 / 2, 66 / 4 / 2, 52 / 5 / 3, 72 / 6 / 2, 21 / 7 / 2, 40 / 8 / 3, 68 / 9 / 2, 88 / 10 / 2, 25 / 11 / 3, 54 / 12 / 2, 42 / 13 / 4, 1 / 14 / 2, 70 / 15 / 3, 28 / 16 / 2, 56 / 17 / 3, 9 / 18 / 2, 97 / 19 / 2, 36 / 20 / 2, 74 / 21 / 4, 16 / 22 / 2, 99 / 23 / 2, 77 / 24 / 2, 85 / 25 / 2, 26 / 26 / 3, 48 / 27 / 2, 51 / 28 / 2, 62 / 29 / 2, 61 / 30 / 2, 96 / 31 / 3, 22 / 32 / 2, 64 / 33 / 3, 11 / 34 / 2, 83 / 35 / 3, 29 / 36 / 2, 71 / 37 / 3, 18 / 38 / 2, 58 / 39 / 4, 75 / 40 / 2, 55 / 41 / 2, 34 / 42 / 3, 15 / 43 / 2, 3 / 44 / 2, 7 / 45 / 3, 65 / 46 / 2, 31 / 47 / 6, 44 / 48 / 2, 90 / 49 / 2, 13 / 50 / 2, 8 / 51 / 2, 93 / 52 / 4, 5 / 53 / 2, 45 / 54 / 2, 92 / 55 / 4, 10 / 56 / 2, 17 / 57 / 2, 38 / 58 / 4, 39 / 59 / 2, 23 / 60 / 2, 33 / 61 / 3, 84 / 62 / 2, 6 / 63 / 3, 95 / 64 / 2, 14 / 65 / 2, 59 / 66 / 4, 94 / 67 / 2, 78 / 68 / 3, 79 / 69 / 2, 60 / 70 / 3, 50 / 71 / 2, 80 / 72 / 2, 73 / 73 / 4, 57 / 74 / 2, 63 / 75 / 3, 37 / 76 / 2, 53 / 77 / 2, 67 / 78 / 2, 19 / 79 / 2, 30 / 80 / 3, 27 / 81 / 2, 69 / 82 / 5, 89 / 83 / 2, 87 / 84 / 2, 46 / 85 / 2, 20 / 86 / 5, 4 / 87 / 2, 12 / 88 / 2, 91 / 89 / 2, 98 / 90 / 2, 32 / 91 / 3, 76 / 92 / 2, 47 / 93 / 3, 41 / 94 / 2, 82 / 95 / 2, 24 / 96 / 3, 43 / 97 / 2, 49 / 98 / 2, 86 / 99 / 4
singlecenter-alpha_1-92-n100.txt, 1, 1, 100, 1518.94, 752, 652, 7, 99,42 / 1 / 5, 74 / 2 / 2, 22 / 3 / 2, 18 / 4 / 2, 83 / 5 / 2, 1 / 6 / 2, 9 / 7 / 2, 60 / 8 / 2, 36 / 9 / 2, 81 / 10 / 2, 59 / 11 / 2, 39 / 12 / 2, 79 / 13 / 2, 19 / 14 / 2, 52 / 15 / 2, 45 / 16 / 2, 34 / 17 / 3, 95 / 18 / 2, 7 / 19 / 2, 63 / 20 / 2, 89 / 21 / 2, 44 / 22 / 2, 88 / 23 / 6, 90 / 24 / 2, 70 / 25 / 2, 24 / 26 / 2, 20 / 27 / 2, 92 / 28 / 2, 66 / 29 / 2, 23 / 30 / 2, 5 / 31 / 3, 11 / 32 / 2, 99 / 33 / 3, 17 / 34 / 2, 76 / 35 / 3, 38 / 36 / 2, 58 / 37 / 2, 50 / 38 / 2, 69 / 39 / 4, 47 / 40 / 2, 64 / 41 / 2, 56 / 42 / 3, 93 / 43 / 2, 91 / 44 / 2, 15 / 45 / 3, 28 / 46 / 2, 77 / 47 / 2, 62 / 48 / 2, 8 / 49 / 3, 86 / 50 / 2, 67 / 51 / 2, 65 / 52 / 7, 40 / 53 / 2, 30 / 54 / 2, 98 / 55 / 2, 12 / 56 / 2, 31 / 57 / 4, 49 / 58 / 2, 41 / 59 / 2, 75 / 60 / 2, 55 / 61 / 2, 14 / 62 / 2, 57 / 63 / 2, 53 / 64 / 2, 16 / 65 / 4, 26 / 66 / 2, 72 / 67 / 2, 80 / 68 / 2, 43 / 69 / 5, 35 / 70 / 2, 13 / 71 / 2, 10 / 72 / 2, 6 / 73 / 3, 25 / 74 / 2, 78 / 75 / 2, 85 / 76 / 2, 48 / 77 / 2, 84 / 78 / 2, 46 / 79 / 2, 29 / 80 / 2, 71 / 81 / 2, 54 / 82 / 3, 68 / 83 / 2, 21 / 84 / 3, 4 / 85 / 2, 87 / 86 / 3, 94 / 87 / 2, 97 / 88 / 2, 37 / 89 / 2, 51 / 90 / 2, 73 / 91 / 4, 27 / 92 / 2, 32 / 93 / 2, 61 / 94 / 2, 33 / 95 / 2, 82 / 96 / 3, 96 / 97 / 2, 2 / 98 / 2, 3 / 99 / 3
singlecenter-alpha_1-93-n100.txt, 1, 1, 100, 1408.95, 835, 735, 8, 99,58 / 1 / 3, 67 / 2 / 2, 12 / 3 / 2, 47 / 4 / 3, 4 / 5 / 2, 79 / 6 / 2, 60 / 7 / 2, 37 / 8 / 2, 68 / 9 / 6, 56 / 10 / 2, 90 / 11 / 2, 2 / 12 / 4, 74 / 13 / 2, 22 / 14 / 2, 88 / 15 / 2, 97 / 16 / 2, 24 / 17 / 2, 81 / 18 / 2, 50 / 19 / 2, 19 / 20 / 2, 40 / 21 / 2, 84 / 22 / 2, 41 / 23 / 3, 65 / 24 / 2, 52 / 25 / 2, 99 / 26 / 4, 33 / 27 / 2, 83 / 28 / 2, 69 / 29 / 2, 66 / 30 / 2, 45 / 31 / 5, 72 / 32 / 2, 98 / 33 / 2, 9 / 34 / 2, 48 / 35 / 2, 39 / 36 / 2, 5 / 37 / 2, 21 / 38 / 2, 42 / 39 / 3, 14 / 40 / 2, 17 / 41 / 5, 27 / 42 / 2, 16 / 43 / 2, 32 / 44 / 3, 49 / 45 / 2, 59 / 46 / 2, 95 / 47 / 2, 15 / 48 / 3, 80 / 49 / 2, 77 / 50 / 3, 94 / 51 / 2, 35 / 52 / 2, 29 / 53 / 4, 54 / 54 / 2, 44 / 55 / 2, 11 / 56 / 3, 78 / 57 / 2, 57 / 58 / 3, 51 / 59 / 2, 7 / 60 / 2, 91 / 61 / 2, 1 / 62 / 3, 96 / 63 / 2, 76 / 64 / 3, 38 / 65 / 2, 87 / 66 / 2, 93 / 67 / 3, 23 / 68 / 2, 30 / 69 / 2, 36 / 70 / 8, 20 / 71 / 2, 86 / 72 / 2, 8 / 73 / 2, 73 / 74 / 4, 31 / 75 / 2, 43 / 76 / 2, 6 / 77 / 2, 64 / 78 / 3, 82 / 79 / 2, 63 / 80 / 5, 85 / 81 / 2, 89 / 82 / 2, 53 / 83 / 2, 92 / 84 / 2, 75 / 85 / 2, 61 / 86 / 3, 26 / 87 / 2, 34 / 88 / 2, 71 / 89 / 3, 3 / 90 / 2, 10 / 91 / 5, 18 / 92 / 2, 25 / 93 / 2, 28 / 94 / 4, 62 / 95 / 2, 70 / 96 / 2, 55 / 97 / 2, 13 / 98 / 3, 46 / 99 / 2
singlecenter-alpha_1-94-n100.txt, 1, 1, 100, 1559.95, 865, 765, 6, 99,13 / 1 / 2, 62 / 2 / 6, 70 / 3 / 2, 52 / 4 / 2, 18 / 5 / 2, 22 / 6 / 3, 5 / 7 / 2, 27 / 8 / 3, 40 / 9 / 2, 72 / 10 / 2, 68 / 11 / 3, 26 / 12 / 2, 21 / 13 / 3, 23 / 14 / 2, 46 / 15 / 2, 16 / 16 / 2, 69 / 17 / 3, 15 / 18 / 2, 45 / 19 / 2, 34 / 20 / 4, 35 / 21 / 2, 89 / 22 / 2, 55 / 23 / 2, 7 / 24 / 2, 4 / 25 / 3, 61 / 26 / 2, 17 / 27 / 2, 47 / 28 / 5, 28 / 29 / 2, 25 / 30 / 2, 19 / 31 / 3, 39 / 32 / 2, 1 / 33 / 2, 73 / 34 / 6, 71 / 35 / 2, 49 / 36 / 2, 6 / 37 / 2, 67 / 38 / 4, 82 / 39 / 2, 53 / 40 / 2, 36 / 41 / 6, 50 / 42 / 2, 14 / 43 / 2, 2 / 44 / 2, 43 / 45 / 2, 66 / 46 / 2, 94 / 47 / 3, 11 / 48 / 2, 60 / 49 / 2, 38 / 50 / 2, 58 / 51 / 3, 91 / 52 / 2, 64 / 53 / 2, 86 / 54 / 2, 74 / 55 / 2, 44 / 56 / 4, 54 / 57 / 2, 98 / 58 / 2, 83 / 59 / 5, 3 / 60 / 2, 8 / 61 / 2, 95 / 62 / 3, 75 / 63 / 2, 41 / 64 / 2, 90 / 65 / 5, 78 / 66 / 2, 88 / 67 / 2, 12 / 68 / 2, 87 / 69 / 2, 81 / 70 / 4, 92 / 71 / 2, 59 / 72 / 2, 97 / 73 / 3, 85 / 74 / 2, 32 / 75 / 2, 84 / 76 / 3, 9 / 77 / 2, 65 / 78 / 3, 51 / 79 / 2, 57 / 80 / 2, 79 / 81 / 4, 48 / 82 / 2, 30 / 83 / 2, 10 / 84 / 4, 31 / 85 / 2, 99 / 86 / 2, 80 / 87 / 2, 37 / 88 / 5, 20 / 89 / 2, 56 / 90 / 2, 33 / 91 / 2, 29 / 92 / 5, 93 / 93 / 2, 42 / 94 / 2, 96 / 95 / 2, 24 / 96 / 2, 76 / 97 / 3, 63 / 98 / 2, 77 / 99 / 2
singlecenter-alpha_1-95-n100.txt, 1, 1, 100, 1380.59, 761, 661, 7, 99,28 / 1 / 3, 80 / 2 / 2, 93 / 3 / 2, 7 / 4 / 4, 23 / 5 / 2, 31 / 6 / 2, 22 / 7 / 2, 13 / 8 / 2, 2 / 9 / 3, 21 / 10 / 2, 77 / 11 / 3, 50 / 12 / 2, 1 / 13 / 3, 32 / 14 / 2, 53 / 15 / 4, 96 / 16 / 2, 67 / 17 / 2, 14 / 18 / 2, 82 / 19 / 3, 65 / 20 / 2, 86 / 21 / 3, 40 / 22 / 2, 55 / 23 / 3, 25 / 24 / 2, 11 / 25 / 3, 47 / 26 / 2, 39 / 27 / 2, 70 / 28 / 2, 73 / 29 / 3, 38 / 30 / 2, 90 / 31 / 2, 87 / 32 / 2, 41 / 33 / 4, 49 / 34 / 2, 36 / 35 / 3, 64 / 36 / 2, 48 / 37 / 2, 69 / 38 / 2, 10 / 39 / 6, 33 / 40 / 2, 95 / 41 / 3, 42 / 42 / 2, 74 / 43 / 2, 19 / 44 / 2, 8 / 45 / 3, 98 / 46 / 2, 99 / 47 / 2, 85 / 48 / 4, 89 / 49 / 2, 29 / 50 / 2, 88 / 51 / 4, 54 / 52 / 2, 91 / 53 / 2, 59 / 54 / 4, 72 / 55 / 2, 68 / 56 / 2, 44 / 57 / 3, 30 / 58 / 2, 81 / 59 / 5, 71 / 60 / 2, 58 / 61 / 2, 76 / 62 / 3, 79 / 63 / 2, 83 / 64 / 3, 60 / 65 / 2, 27 / 66 / 3, 46 / 67 / 2, 84 / 68 / 2, 78 / 69 / 2, 12 / 70 / 3, 15 / 71 / 2, 66 / 72 / 2, 43 / 73 / 2, 26 / 74 / 2, 37 / 75 / 4, 57 / 76 / 2, 97 / 77 / 2, 17 / 78 / 2, 51 / 79 / 3, 9 / 80 / 2, 45 / 81 / 2, 6 / 82 / 2, 24 / 83 / 2, 18 / 84 / 2, 56 / 85 / 2, 20 / 86 / 4, 16 / 87 / 2, 75 / 88 / 3, 3 / 89 / 2, 34 / 90 / 3, 94 / 91 / 2, 63 / 92 / 3, 35 / 93 / 2, 4 / 94 / 2, 62 / 95 / 2, 5 / 96 / 7, 92 / 97 / 2, 52 / 98 / 3, 61 / 99 / 2
singlecenter-alpha_1-96-n100.txt, 1, 1, 100, 1411.83, 698, 598, 4, 99,80 / 1 / 2, 55 / 2 / 3, 39 / 3 / 2, 60 / 4 / 2, 95 / 5 / 4, 5 / 6 / 2, 53 / 7 / 3, 82 / 8 / 2, 88 / 9 / 2, 22 / 10 / 3, 51 / 11 / 2, 18 / 12 / 2, 58 / 13 / 3, 75 / 14 / 2, 79 / 15 / 2, 91 / 16 / 3, 13 / 17 / 2, 37 / 18 / 3, 86 / 19 / 2, 47 / 20 / 2, 52 / 21 / 3, 41 / 22 / 2, 19 / 23 / 3, 28 / 24 / 2, 26 / 25 / 4, 44 / 26 / 2, 54 / 27 / 2, 62 / 28 / 4, 74 / 29 / 2, 34 / 30 / 2, 25 / 31 / 4, 83 / 32 / 2, 70 / 33 / 2, 42 / 34 / 2, 49 / 35 / 2, 63 / 36 / 2, 65 / 37 / 4, 85 / 38 / 2, 40 / 39 / 2, 68 / 40 / 3, 21 / 41 / 2, 45 / 42 / 3, 84 / 43 / 2, 4 / 44 / 2, 78 / 45 / 2, 38 / 46 / 2, 93 / 47 / 2, 30 / 48 / 3, 8 / 49 / 2, 72 / 50 / 2, 77 / 51 / 2, 89 / 52 / 2, 2 / 53 / 4, 11 / 54 / 2, 35 / 55 / 2, 33 / 56 / 2, 17 / 57 / 3, 57 / 58 / 2, 94 / 59 / 2, 48 / 60 / 2, 99 / 61 / 2, 46 / 62 / 3, 43 / 63 / 2, 16 / 64 / 3, 92 / 65 / 2, 20 / 66 / 2, 87 / 67 / 3, 9 / 68 / 2, 32 / 69 / 2, 7 / 70 / 4, 90 / 71 / 2, 14 / 72 / 2, 23 / 73 / 2, 56 / 74 / 2, 10 / 75 / 3, 67 / 76 / 2, 31 / 77 / 4, 36 / 78 / 2, 64 / 79 / 2, 27 / 80 / 3, 97 / 81 / 2, 50 / 82 / 2, 98 / 83 / 3, 71 / 84 / 2, 61 / 85 / 2, 66 / 86 / 3, 81 / 87 / 2, 24 / 88 / 2, 3 / 89 / 2, 29 / 90 / 3, 73 / 91 / 2, 69 / 92 / 3, 6 / 93 / 2, 76 / 94 / 4, 12 / 95 / 2, 15 / 96 / 2, 1 / 97 / 3, 59 / 98 / 2, 96 / 99 / 3
singlecenter-alpha_1-97-n100.txt, 1, 1, 100, 1435.36, 846, 746, 20, 99,23 / 1 / 2, 59 / 2 / 2, 84 / 3 / 2, 44 / 4 / 2, 7 / 5 / 2, 90 / 6 / 2, 32 / 7 / 3, 17 / 8 / 2, 85 / 9 / 2, 37 / 10 / 3, 86 / 11 / 2, 19 / 12 / 2, 18 / 13 / 2, 1 / 14 / 3, 80 / 15 / 2, 3 / 16 / 3, 56 / 17 / 2, 68 / 18 / 3, 16 / 19 / 2, 61 / 20 / 2, 76 / 21 / 3, 72 / 22 / 2, 12 / 23 / 2, 35 / 24 / 4, 81 / 25 / 2, 14 / 26 / 3, 39 / 27 / 2, 78 / 28 / 2, 87 / 29 / 4, 30 / 30 / 2, 36 / 31 / 3, 40 / 32 / 2, 5 / 33 / 4, 98 / 34 / 2, 6 / 35 / 2, 33 / 36 / 3, 88 / 37 / 2, 71 / 38 / 4, 57 / 39 / 2, 41 / 40 / 2, 38 / 41 / 2, 65 / 42 / 2, 96 / 43 / 4, 45 / 44 / 2, 24 / 45 / 3, 9 / 46 / 2, 92 / 47 / 2, 74 / 48 / 3, 63 / 49 / 2, 26 / 50 / 4, 43 / 51 / 2, 77 / 52 / 2, 93 / 53 / 2, 89 / 54 / 2, 31 / 55 / 3, 62 / 56 / 2, 29 / 57 / 3, 60 / 58 / 2, 52 / 59 / 6, 83 / 60 / 2, 75 / 61 / 2, 20 / 62 / 3, 42 / 63 / 2, 55 / 64 / 2, 94 / 65 / 3, 49 / 66 / 2, 67 / 67 / 2, 79 / 68 / 2, 97 / 69 / 2, 21 / 70 / 2, 69 / 71 / 3, 95 / 72 / 2, 51 / 73 / 2, 73 / 74 / 3, 50 / 75 / 2, 99 / 76 / 2, 54 / 77 / 3, 91 / 78 / 2, 10 / 79 / 2, 58 / 80 / 3, 48 / 81 / 2, 66 / 82 / 2, 27 / 83 / 5, 47 / 84 / 2, 25 / 85 / 2, 82 / 86 / 3, 11 / 87 / 2, 46 / 88 / 2, 64 / 89 / 2, 15 / 90 / 2, 34 / 91 / 2, 13 / 92 / 2, 2 / 93 / 2, 70 / 94 / 2, 4 / 95 / 2, 22 / 96 / 20, 53 / 97 / 2, 28 / 98 / 2, 8 / 99 / 2
singlecenter-alpha_1-98-n100.txt, 1, 1, 100, 1501.22, 880, 780, 8, 99,8 / 1 / 6, 61 / 2 / 2, 47 / 3 / 2, 11 / 4 / 3, 27 / 5 / 2, 36 / 6 / 3, 91 / 7 / 2, 39 / 8 / 2, 49 / 9 / 2, 22 / 10 / 2, 73 / 11 / 2, 50 / 12 / 3, 55 / 13 / 2, 23 / 14 / 2, 7 / 15 / 4, 40 / 16 / 2, 90 / 17 / 2, 83 / 18 / 2, 53 / 19 / 4, 93 / 20 / 2, 71 / 21 / 2, 9 / 22 / 2, 94 / 23 / 2, 72 / 24 / 2, 29 / 25 / 5, 54 / 26 / 2, 26 / 27 / 2, 34 / 28 / 2, 60 / 29 / 4, 13 / 30 / 2, 18 / 31 / 2, 20 / 32 / 2, 33 / 33 / 2, 87 / 34 / 2, 17 / 35 / 2, 35 / 36 / 2, 14 / 37 / 2, 96 / 38 / 3, 78 / 39 / 2, 97 / 40 / 2, 86 / 41 / 2, 46 / 42 / 3, 4 / 43 / 2, 63 / 44 / 4, 57 / 45 / 2, 3 / 46 / 2, 95 / 47 / 4, 82 / 48 / 2, 5 / 49 / 2, 6 / 50 / 3, 43 / 51 / 2, 48 / 52 / 2, 56 / 53 / 3, 74 / 54 / 2, 16 / 55 / 2, 84 / 56 / 3, 99 / 57 / 2, 12 / 58 / 6, 75 / 59 / 2, 68 / 60 / 3, 59 / 61 / 2, 1 / 62 / 3, 30 / 63 / 2, 45 / 64 / 3, 21 / 65 / 2, 98 / 66 / 2, 67 / 67 / 3, 41 / 68 / 2, 92 / 69 / 2, 37 / 70 / 4, 31 / 71 / 2, 24 / 72 / 2, 42 / 73 / 3, 85 / 74 / 2, 44 / 75 / 4, 80 / 76 / 2, 28 / 77 / 2, 77 / 78 / 4, 65 / 79 / 2, 62 / 80 / 2, 58 / 81 / 2, 52 / 82 / 2, 32 / 83 / 3, 19 / 84 / 2, 10 / 85 / 2, 51 / 86 / 8, 64 / 87 / 2, 79 / 88 / 2, 25 / 89 / 2, 15 / 90 / 2, 38 / 91 / 2, 76 / 92 / 2, 81 / 93 / 2, 70 / 94 / 4, 69 / 95 / 2, 88 / 96 / 2, 66 / 97 / 2, 2 / 98 / 2, 89 / 99 / 3
singlecenter-alpha_1-99-n100.txt, 1, 1, 100, 1124.9, 831, 731, 6, 99,90 / 1 / 6, 21 / 2 / 2, 65 / 3 / 2, 45 / 4 / 3, 74 / 5 / 2, 78 / 6 / 4, 15 / 7 / 2, 16 / 8 / 2, 19 / 9 / 4, 56 / 10 / 2, 46 / 11 / 2, 20 / 12 / 2, 1 / 13 / 2, 72 / 14 / 3, 75 / 15 / 2, 94 / 16 / 2, 66 / 17 / 2, 27 / 18 / 2, 34 / 19 / 3, 52 / 20 / 2, 4 / 21 / 3, 33 / 22 / 2, 14 / 23 / 2, 37 / 24 / 2, 40 / 25 / 2, 93 / 26 / 2, 89 / 27 / 4, 98 / 28 / 2, 31 / 29 / 2, 25 / 30 / 2, 61 / 31 / 3, 68 / 32 / 2, 97 / 33 / 2, 23 / 34 / 2, 42 / 35 / 2, 88 / 36 / 3, 51 / 37 / 2, 43 / 38 / 2, 71 / 39 / 3, 32 / 40 / 2, 50 / 41 / 2, 47 / 42 / 2, 79 / 43 / 2, 76 / 44 / 2, 35 / 45 / 5, 73 / 46 / 2, 91 / 47 / 3, 17 / 48 / 2, 95 / 49 / 5, 13 / 50 / 2, 55 / 51 / 2, 58 / 52 / 3, 7 / 53 / 2, 8 / 54 / 3, 22 / 55 / 2, 84 / 56 / 3, 67 / 57 / 2, 10 / 58 / 3, 99 / 59 / 2, 80 / 60 / 3, 38 / 61 / 2, 44 / 62 / 3, 85 / 63 / 2, 70 / 64 / 2, 86 / 65 / 2, 6 / 66 / 2, 60 / 67 / 2, 2 / 68 / 2, 87 / 69 / 5, 12 / 70 / 2, 11 / 71 / 3, 30 / 72 / 2, 28 / 73 / 5, 92 / 74 / 2, 96 / 75 / 2, 26 / 76 / 2, 24 / 77 / 2, 62 / 78 / 4, 36 / 79 / 2, 82 / 80 / 2, 53 / 81 / 3, 49 / 82 / 2, 39 / 83 / 3, 63 / 84 / 2, 5 / 85 / 3, 83 / 86 / 2, 54 / 87 / 3, 29 / 88 / 2, 64 / 89 / 2, 57 / 90 / 3, 48 / 91 / 2, 59 / 92 / 2, 3 / 93 / 2, 69 / 94 / 3, 9 / 95 / 2, 77 / 96 / 3, 81 / 97 / 2, 18 / 98 / 3, 41 / 99 / 2
singlecenter-alpha_3-1-n250.txt, 1, 0.333333, 250, 2079.09, 519, 269, 3, 4,82 / 78 / 2, 117 / 93 / 3, 222 / 210 / 2, 137 / 224 / 3
singlecenter-alpha_3-1-n375.txt, 1, 0.333333, 375, 2839.91, 770, 395, 2, 7,91 / 39 / 2, 102 / 66 / 2, 194 / 141 / 2, 211 / 170 / 2, 58 / 189 / 2, 11 / 240 / 2, 286 / 279 / 2
singlecenter-alpha_3-1-n5.txt, 1, 0.333333, 5, 287.752, 9, 4, 1, 0,
singlecenter-alpha_3-10-n250.txt, 1, 0.333333, 250, 2147.05, 506, 256, 2, 3,79 / 38 / 2, 74 / 74 / 2, 50 / 126 / 2
singlecenter-alpha_3-10-n5.txt, 1, 0.333333, 5, 250.196, 9, 4, 1, 0,
singlecenter-alpha_3-10-n500.txt, 1, 0.333333, 500, 3190.47, 1013, 513, 2, 7,275 / 57 / 2, 473 / 77 / 2, 171 / 170 / 2, 253 / 207 / 2, 91 / 373 / 2, 439 / 409 / 2, 237 / 422 / 2
singlecenter-alpha_3-100-n100.txt, 1, 0.333333, 100, 1304.7, 203, 103, 2, 2,99 / 8 / 2, 16 / 18 / 2
singlecenter-alpha_3-101-n175.txt, 1, 0.333333, 175, 1838.4, 351, 176, 2, 1,114 / 92 / 2
singlecenter-alpha_3-102-n175.txt, 1, 0.333333, 175, 1921.64, 351, 176, 2, 1,138 / 43 / 2
singlecenter-alpha_3-103-n175.txt, 1, 0.333333, 175, 1824.32, 351, 176, 2, 1,50 / 28 / 2
singlecenter-alpha_3-104-n175.txt, 1, 0.333333, 175, 1819.09, 351, 176, 2, 1,134 / 68 / 2
singlecenter-alpha_3-105-n175.txt, 1, 0.333333, 175, 1795.79, 351, 176, 2, 1,152 / 107 / 2
singlecenter-alpha_3-106-n175.txt, 1, 0.333333, 175, 1878.4, 358, 183, 2, 4,115 / 55 / 2, 149 / 89 / 2, 118 / 147 / 2, 90 / 153 / 2
singlecenter-alpha_3-107-n175.txt, 1, 0.333333, 175, 1884.74, 351, 176, 2, 1,60 / 154 / 2
singlecenter-alpha_3-108-n175.txt, 1, 0.333333, 175, 1925.15, 353, 178, 2, 2,38 / 34 / 2, 61 / 37 / 2
singlecenter-alpha_3-109-n175.txt, 1, 0.333333, 175, 1820.22, 353, 178, 2, 2,24 / 9 / 2, 129 / 40 / 2
singlecenter-alpha_3-11-n375.txt, 1, 0.333333, 375, 2643.58, 762, 387, 2, 6,132 / 80 / 2, 196 / 109 / 2, 317 / 151 / 2, 347 / 168 / 2, 323 / 212 / 2, 167 / 310 / 2
singlecenter-alpha_3-11-n500.txt, 1, 0.333333, 500, 3115.28, 1013, 513, 2, 6,21 / 38 / 2, 155 / 64 / 2, 19 / 204 / 2, 78 / 229 / 2, 446 / 247 / 2, 408 / 351 / 2
singlecenter-alpha_3-11-n6.txt, 1, 0.333333, 6, 266.872, 15, 9, 2, 1,5 / 4 / 2
singlecenter-alpha_3-110-n175.txt, 1, 0.333333, 175, 1892.47, 352, 177, 2, 1,119 / 52 / 2
singlecenter-alpha_3-111-n250.txt, 1, 0.333333, 250, 2121.93, 501, 251, 2, 1,5 / 209 / 2
singlecenter-alpha_3-112-n250.txt, 1, 0.333333, 250, 2013.93, 501, 251, 2, 1,148 / 101 / 2
singlecenter-alpha_3-113-n250.txt, 1, 0.333333, 250, 2221.31, 507, 257, 2, 4,224 / 9 / 2, 8 / 127 / 2, 23 / 132 / 2, 249 / 196 / 2
singlecenter-alpha_3-114-n250.txt, 1, 0.333333, 250, 2115.72, 506, 256, 2, 3,76 / 76 / 2, 169 / 111 / 2, 75 / 169 / 2
singlecenter-alpha_3-115-n250.txt, 1, 0.333333, 250, 2307.05, 511, 261, 2, 5,106 / 42 / 2, 47 / 47 / 2, 98 / 52 / 2, 241 / 58 / 2, 124 / 127 / 2
singlecenter-alpha_3-116-n250.txt, 1, 0.333333, 250, 2219.04, 507, 257, 2, 4,118 / 76 / 2, 44 / 121 / 2, 209 / 200 / 2, 130 / 232 / 2
singlecenter-alpha_3-117-n250.txt, 1, 0.333333, 250, 2259.78, 505, 255, 2, 3,214 / 170 / 2, 161 / 184 / 2, 216 / 224 / 2
singlecenter-alpha_3-118-n250.txt, 1, 0.333333, 250, 2334.43, 514, 264, 2, 7,161 / 63 / 2, 95 / 91 / 2, 221 / 99 / 2, 83 / 104 / 2, 227 / 195 / 2, 57 / 231 / 2, 169 / 249 / 2
singlecenter-alpha_3-119-n250.txt, 1, 0.333333, 250, 2154.99, 504, 254, 2, 2,213 / 90 / 2, 121 / 149 / 2
singlecenter-alpha_3-12-n375.txt, 1, 0.333333, 375, 2791.68, 778, 403, 4, 8,183 / 84 / 4, 224 / 91 / 2, 45 / 94 / 2, 168 / 104 / 2, 253 / 154 / 2, 84 / 166 / 2, 216 / 275 / 2, 362 / 320 / 2
singlecenter-alpha_3-12-n500.txt, 1, 0.333333, 500, 3553.04, 1011, 511, 2, 6,489 / 4 / 2, 167 / 297 / 2, 425 / 330 / 2, 130 / 378 / 2, 79 / 410 / 2, 236 / 494 / 2
singlecenter-alpha_3-12-n6.txt, 1, 0.333333, 6, 254.028, 14, 8, 2, 1,4 / 4 / 2
singlecenter-alpha_3-120-n250.txt, 1, 0.333333, 250, 2142.64, 509, 259, 2, 4,147 / 21 / 2, 10 / 53 / 2, 175 / 126 / 2, 160 / 168 / 2
singlecenter-alpha_3-13-n375.txt, 1, 0.333333, 375, 2646.46, 757, 382, 2, 3,116 / 136 / 2, 188 / 280 / 2, 363 / 287 / 2
singlecenter-alpha_3-13-n500.txt, 1, 0.333333, 500, 3101.26, 1003, 503, 2, 2,257 / 241 / 2, 45 / 455 / 2
singlecenter-alpha_3-13-n6.txt, 1, 0.333333, 6, 379.725, 11, 5, 1, 0,
singlecenter-alpha_3-14-n375.txt, 1, 0.333333, 375, 2771.75, 759, 384, 3, 3,238 / 269 / 2, 12 / 340 / 2, 324 / 374 / 3
singlecenter-alpha_3-14-n500.txt, 1, 0.333333, 500, 3060.76, 1009, 509, 2, 5,54 / 133 / 2, 390 / 271 / 2, 273 / 299 / 2, 67 / 311 / 2, 80 / 402 / 2
singlecenter-alpha_3-14-n6.txt, 1, 0.333333, 6, 287.582, 15, 9, 5, 1,2 / 1 / 5
singlecenter-alpha_3-15-n375.txt, 1, 0.333333, 375, 2867.93, 757, 382, 2, 4,15 / 60 / 2, 320 / 65 / 2, 98 / 82 / 2, 27 / 150 / 2
singlecenter-alpha_3-15-n6.txt, 1, 0.333333, 6, 267.742, 11, 5, 1, 0,
singlecenter-alpha_3-16-n375.txt, 1, 0.333333, 375, 2701.89, 766, 391, 2, 8,152 / 33 / 2, 127 / 44 / 2, 258 / 103 / 2, 112 / 119 / 2, 334 / 208 / 2, 15 / 212 / 2, 140 / 244 / 2, 38 / 301 / 2
singlecenter-alpha_3-16-n6.txt, 1, 0.333333, 6, 294.135, 12, 6, 2, 1,1 / 5 / 2
singlecenter-alpha_3-17-n375.txt, 1, 0.333333, 375, 2503.66, 755, 380, 2, 3,38 / 74 / 2, 371 / 184 / 2, 88 / 316 / 2
singlecenter-alpha_3-17-n6.txt, 1, 0.333333, 6, 543.347, 11, 5, 1, 0,
singlecenter-alpha_3-18-n375.txt, 1, 0.333333, 375, 2843.5, 761, 386, 2, 6,172 / 52 / 2, 164 / 89 / 2, 86 / 97 / 2, 49 / 161 / 2, 32 / 187 / 2, 279 / 196 / 2
singlecenter-alpha_3-18-n6.txt, 1, 0.333333, 6, 451.076, 11, 5, 1, 0,
singlecenter-alpha_3-19-n375.txt, 1, 0.333333, 375, 2645.82, 760, 385, 2, 5,294 / 55 / 2, 13 / 218 / 2, 140 / 246 / 2, 37 / 300 / 2, 167 / 350 / 2
singlecenter-alpha_3-19-n6.txt, 1, 0.333333, 6, 298.648, 11, 5, 1, 0,
singlecenter-alpha_3-2-n250.txt, 1, 0.333333, 250, 2238.92, 502, 252, 2, 1,202 / 226 / 2
singlecenter-alpha_3-2-n375.txt, 1, 0.333333, 375, 2607.74, 770, 395, 2, 9,243 / 80 / 2, 268 / 83 / 2, 318 / 122 / 2, 238 / 130 / 2, 2 / 224 / 2, 192 / 242 / 2, 140 / 262 / 2, 184 / 299 / 2, 329 / 327 / 2
singlecenter-alpha_3-2-n5.txt, 1, 0.333333, 5, 302.336, 11, 6, 3, 1,2 / 4 / 3
singlecenter-alpha_3-20-n375.txt, 1, 0.333333, 375, 2743.53, 755, 380, 2, 3,313 / 15 / 2, 139 / 246 / 2, 250 / 305 / 2
singlecenter-alpha_3-20-n6.txt, 1, 0.333333, 6, 230.966, 11, 5, 1, 0,
singlecenter-alpha_3-21-n7.txt, 1, 0.333333, 7, 373.051, 13, 6, 1, 0,
singlecenter-alpha_3-22-n7.txt, 1, 0.333333, 7, 369.126, 15, 8, 3, 1,3 / 6 / 3
singlecenter-alpha_3-23-n7.txt, 1, 0.333333, 7, 205.217, 13, 6, 1, 0,
singlecenter-alpha_3-24-n7.txt, 1, 0.333333, 7, 299.706, 13, 6, 1, 0,
singlecenter-alpha_3-25-n7.txt, 1, 0.333333, 7, 365.71, 19, 12, 3, 1,1 / 5 / 3
singlecenter-alpha_3-26-n7.txt, 1, 0.333333, 7, 202.192, 20, 13, 4, 2,1 / 2 / 2, 3 / 6 / 4
singlecenter-alpha_3-27-n7.txt, 1, 0.333333, 7, 288.22, 13, 6, 1, 0,
singlecenter-alpha_3-28-n7.txt, 1, 0.333333, 7, 326.378, 13, 6, 1, 0,
singlecenter-alpha_3-29-n7.txt, 1, 0.333333, 7, 368.33, 13, 6, 1, 0,
singlecenter-alpha_3-3-n250.txt, 1, 0.333333, 250, 2406.59, 514, 264, 2, 6,62 / 82 / 2, 30 / 98 / 2, 244 / 129 / 2, 208 / 147 / 2, 105 / 176 / 2, 17 / 236 / 2
singlecenter-alpha_3-3-n375.txt, 1, 0.333333, 375, 2585.53, 766, 391, 2, 8,282 / 81 / 2, 15 / 111 / 2, 88 / 152 / 2, 247 / 234 / 2, 229 / 289 / 2, 363 / 310 / 2, 110 / 334 / 2, 340 / 338 / 2
singlecenter-alpha_3-3-n5.txt, 1, 0.333333, 5, 114.984, 9, 4, 1, 0,
singlecenter-alpha_3-30-n7.txt, 1, 0.333333, 7, 302.967, 13, 6, 1, 0,
singlecenter-alpha_3-31-n8.txt, 1, 0.333333, 8, 287.197, 15, 7, 1, 0,
singlecenter-alpha_3-32-n8.txt, 1, 0.333333, 8, 189.851, 15, 7, 1, 0,
singlecenter-alpha_3-33-n8.txt, 1, 0.333333, 8, 354.384, 17, 9, 2, 1,5 / 6 / 2
singlecenter-alpha_3-34-n8.txt, 1, 0.333333, 8, 424.203, 16, 8, 2, 1,7 / 1 / 2
singlecenter-alpha_3-35-n8.txt, 1, 0.333333, 8, 350.397, 15, 7, 1, 0,
singlecenter-alpha_3-36-n8.txt, 1, 0.333333, 8, 397.13, 25, 17, 3, 2,6 / 3 / 3, 3 / 7 / 3
singlecenter-alpha_3-37-n8.txt, 1, 0.333333, 8, 274.661, 17, 9, 3, 1,2 / 7 / 3
singlecenter-alpha_3-38-n8.txt, 1, 0.333333, 8, 514.708, 15, 7, 1, 0,
singlecenter-alpha_3-39-n8.txt, 1, 0.333333, 8, 343.291, 20, 12, 2, 1,1 / 3 / 2
singlecenter-alpha_3-4-n250.txt, 1, 0.333333, 250, 2220.8, 504, 254, 2, 2,242 / 67 / 2, 153 / 70 / 2
singlecenter-alpha_3-4-n375.txt, 1, 0.333333, 375, 2780.04, 766, 391, 2, 6,29 / 94 / 2, 133 / 161 / 2, 43 / 225 / 2, 360 / 254 / 2, 286 / 284 / 2, 13 / 340 / 2
singlecenter-alpha_3-4-n5.txt, 1, 0.333333, 5, 247.616, 11, 6, 3, 1,2 / 4 / 3
singlecenter-alpha_3-40-n8.txt, 1, 0.333333, 8, 375.521, 15, 7, 1, 0,
singlecenter-alpha_3-41-n9.txt, 1, 0.333333, 9, 238.743, 19, 10, 2, 1,5 / 2 / 2
singlecenter-alpha_3-42-n9.txt, 1, 0.333333, 9, 566.413, 19, 10, 2, 1,1 / 7 / 2
singlecenter-alpha_3-43-n9.txt, 1, 0.333333, 9, 388.68, 19, 10, 2, 1,3 / 5 / 2
singlecenter-alpha_3-44-n9.txt, 1, 0.333333, 9, 368.246, 17, 8, 1, 0,
singlecenter-alpha_3-45-n9.txt, 1, 0.333333, 9, 460.58, 17, 8, 1, 0,
singlecenter-alpha_3-46-n9.txt, 1, 0.333333, 9, 386.483, 17, 8, 1, 0,
singlecenter-alpha_3-47-n9.txt, 1, 0.333333, 9, 472.004, 17, 8, 1, 0,
singlecenter-alpha_3-48-n9.txt, 1, 0.333333, 9, 361.168, 19, 10, 2, 1,4 / 3 / 2
singlecenter-alpha_3-49-n9.txt, 1, 0.333333, 9, 516.351, 17, 8, 1, 0,
singlecenter-alpha_3-5-n250.txt, 1, 0.333333, 250, 2402.7, 514, 264, 3, 3,225 / 56 / 2, 179 / 68 / 2, 9 / 205 / 3
singlecenter-alpha_3-5-n5.txt, 1, 0.333333, 5, 248.933, 11, 6, 3, 1,1 / 1 / 3
singlecenter-alpha_3-5-n500.txt, 1, 0.333333, 500, 3126.19, 1017, 517, 2, 9,371 / 20 / 2, 450 / 135 / 2, 355 / 154 / 2, 409 / 222 / 2, 428 / 227 / 2, 316 / 252 / 2, 95 / 337 / 2, 368 / 378 / 2, 445 / 421 / 2
singlecenter-alpha_3-50-n9.txt, 1, 0.333333, 9, 367.104, 17, 8, 1, 0,
singlecenter-alpha_3-51-n10.txt, 1, 0.333333, 10, 470.917, 19, 9, 1, 0,
singlecenter-alpha_3-52-n10.txt, 1, 0.333333, 10, 389.494, 19, 9, 1, 0,
singlecenter-alpha_3-53-n10.txt, 1, 0.333333, 10, 510.455, 19, 9, 1, 0,
singlecenter-alpha_3-54-n10.txt, 1, 0.333333, 10, 532.214, 19, 9, 1, 0,
singlecenter-alpha_3-55-n10.txt, 1, 0.333333, 10, 398.001, 19, 9, 1, 0,
singlecenter-alpha_3-56-n10.txt, 1, 0.333333, 10, 536.959, 23, 13, 2, 2,6 / 4 / 2, 3 / 8 / 2
singlecenter-alpha_3-57-n10.txt, 1, 0.333333, 10, 394.862, 19, 9, 1, 0,
singlecenter-alpha_3-58-n10.txt, 1, 0.333333, 10, 365.014, 22, 12, 2, 1,9 / 5 / 2
singlecenter-alpha_3-59-n10.txt, 1, 0.333333, 10, 548.459, 21, 11, 2, 1,1 / 8 / 2
singlecenter-alpha_3-6-n250.txt, 1, 0.333333, 250, 2155.4, 510, 260, 2, 5,214 / 21 / 2, 10 / 37 / 2, 89 / 89 / 2, 133 / 132 / 2, 104 / 173 / 2
singlecenter-alpha_3-6-n5.txt, 1, 0.333333, 5, 359.574, 11, 6, 2, 1,4 / 3 / 2
singlecenter-alpha_3-6-n500.txt, 1, 0.333333, 500, 3159.25, 1014, 514, 3, 5,25 / 5 / 2, 495 / 9 / 2, 424 / 245 / 3, 432 / 275 / 2, 492 / 447 / 2
singlecenter-alpha_3-60-n10.txt, 1, 0.333333, 10, 450.887, 19, 9, 1, 0,
singlecenter-alpha_3-61-n20.txt, 1, 0.333333, 20, 625.208, 44, 24, 2, 2,2 / 7 / 2, 3 / 11 / 2
singlecenter-alpha_3-62-n20.txt, 1, 0.333333, 20, 540.158, 39, 19, 1, 0,
singlecenter-alpha_3-63-n20.txt, 1, 0.333333, 20, 773.771, 41, 21, 2, 1,15 / 15 / 2
singlecenter-alpha_3-64-n20.txt, 1, 0.333333, 20, 633.661, 41, 21, 2, 1,8 / 2 / 2
singlecenter-alpha_3-65-n20.txt, 1, 0.333333, 20, 670.187, 46, 26, 2, 3,19 / 8 / 2, 3 / 10 / 2, 9 / 19 / 2
singlecenter-alpha_3-66-n20.txt, 1, 0.333333, 20, 494.764, 39, 19, 1, 0,
singlecenter-alpha_3-67-n20.txt, 1, 0.333333, 20, 595.115, 39, 19, 1, 0,
singlecenter-alpha_3-68-n20.txt, 1, 0.333333, 20, 595.815, 44, 24, 2, 2,15 / 3 / 2, 6 / 7 / 2
singlecenter-alpha_3-69-n20.txt, 1, 0.333333, 20, 711.305, 44, 24, 2, 1,13 / 9 / 2
singlecenter-alpha_3-7-n250.txt, 1, 0.333333, 250, 2162.25, 503, 253, 2, 2,126 / 142 / 2, 234 / 242 / 2
singlecenter-alpha_3-7-n5.txt, 1, 0.333333, 5, 232.344, 9, 4, 1, 0,
singlecenter-alpha_3-7-n500.txt, 1, 0.333333, 500, 3167.61, 1022, 522, 2, 10,396 / 93 / 2, 486 / 111 / 2, 183 / 179 / 2, 337 / 297 / 2, 113 / 338 / 2, 484 / 348 / 2, 170 / 372 / 2, 269 / 385 / 2, 28 / 401 / 2, 421 / 455 / 2
singlecenter-alpha_3-70-n20.txt, 1, 0.333333, 20, 532.42, 41, 21, 2, 1,10 / 17 / 2
singlecenter-alpha_3-71-n50.txt, 1, 0.333333, 50, 721.489, 101, 51, 2, 1,11 / 44 / 2
singlecenter-alpha_3-72-n50.txt, 1, 0.333333, 50, 816.161, 99, 49, 1, 0,
singlecenter-alpha_3-73-n50.txt, 1, 0.333333, 50, 684.364, 101, 51, 2, 1,40 / 6 / 2
singlecenter-alpha_3-74-n50.txt, 1, 0.333333, 50, 940.533, 99, 49, 1, 0,
singlecenter-alpha_3-75-n50.txt, 1, 0.333333, 50, 1046.98, 99, 49, 1, 0,
singlecenter-alpha_3-76-n50.txt, 1, 0.333333, 50, 987.505, 103, 53, 2, 2,41 / 12 / 2, 44 / 23 / 2
singlecenter-alpha_3-77-n50.txt, 1, 0.333333, 50, 800.14, 108, 58, 3, 1,26 / 47 / 3
singlecenter-alpha_3-78-n50.txt, 1, 0.333333, 50, 934.774, 99, 49, 1, 0,
singlecenter-alpha_3-79-n50.txt, 1, 0.333333, 50, 825.124, 104, 54, 2, 1,47 / 18 / 2
singlecenter-alpha_3-8-n250.txt, 1, 0.333333, 250, 2271.96, 519, 269, 3, 3,161 / 28 / 3, 41 / 116 / 2, 51 / 203 / 2
singlecenter-alpha_3-8-n5.txt, 1, 0.333333, 5, 152.815, 9, 4, 1, 0,
singlecenter-alpha_3-8-n500.txt, 1, 0.333333, 500, 2940.02, 1005, 505, 2, 3,110 / 272 / 2, 96 / 284 / 2, 147 / 398 / 2
singlecenter-alpha_3-80-n50.txt, 1, 0.333333, 50, 1013.06, 101, 51, 2, 1,26 / 37 / 2
singlecenter-alpha_3-81-n75.txt, 1, 0.333333, 75, 1318.61, 151, 76, 2, 1,70 / 7 / 2
singlecenter-alpha_3-82-n75.txt, 1, 0.333333, 75, 1025.52, 151, 76, 2, 1,48 / 54 / 2
singlecenter-alpha_3-83-n75.txt, 1, 0.333333, 75, 1027.93, 157, 82, 2, 3,10 / 14 / 2, 36 / 34 / 2, 70 / 54 / 2
singlecenter-alpha_3-84-n75.txt, 1, 0.333333, 75, 1140.19, 151, 76, 2, 1,36 / 16 / 2
singlecenter-alpha_3-85-n75.txt, 1, 0.333333, 75, 1057.76, 159, 84, 3, 1,57 / 16 / 3
singlecenter-alpha_3-86-n75.txt, 1, 0.333333, 75, 1272.44, 149, 74, 1, 0,
singlecenter-alpha_3-87-n75.txt, 1, 0.333333, 75, 1145.48, 153, 78, 2, 1,14 / 63 / 2
singlecenter-alpha_3-88-n75.txt, 1, 0.333333, 75, 1276.75, 153, 78, 2, 2,69 / 29 / 2, 23 / 68 / 2
singlecenter-alpha_3-89-n75.txt, 1, 0.333333, 75, 1060.54, 149, 74, 1, 0,
singlecenter-alpha_3-9-n250.txt, 1, 0.333333, 250, 2091.33, 505, 255, 2, 3,156 / 67 / 2, 135 / 186 / 2, 223 / 197 / 2
singlecenter-alpha_3-9-n5.txt, 1, 0.333333, 5, 288.425, 11, 6, 3, 1,1 / 1 / 3
singlecenter-alpha_3-9-n500.txt, 1, 0.333333, 500, 3140.76, 1020, 520, 2, 9,269 / 20 / 2, 76 / 37 / 2, 469 / 109 / 2, 151 / 138 / 2, 385 / 363 / 2, 117 / 370 / 2, 413 / 391 / 2, 195 / 449 / 2, 361 / 452 / 2
singlecenter-alpha_3-90-n75.txt, 1, 0.333333, 75, 1334.66, 151, 76, 2, 1,15 / 14 / 2
singlecenter-alpha_3-91-n100.txt, 1, 0.333333, 100, 1409.92, 199, 99, 1, 0,
singlecenter-alpha_3-92-n100.txt, 1, 0.333333, 100, 1504.74, 203, 103, 2, 2,68 / 34 / 2, 90 / 51 / 2
singlecenter-alpha_3-93-n100.txt, 1, 0.333333, 100, 1426.18, 199, 99, 1, 0,
singlecenter-alpha_3-94-n100.txt, 1, 0.333333, 100, 1565.6, 204, 104, 2, 2,90 / 49 / 2, 56 / 68 / 2
singlecenter-alpha_3-95-n100.txt, 1, 0.333333, 100, 1261.88, 203, 103, 2, 2,10 / 8 / 2, 53 / 21 / 2
singlecenter-alpha_3-96-n100.txt, 1, 0.333333, 100, 1397.65, 201, 101, 2, 1,2 / 52 / 2
singlecenter-alpha_3-97-n100.txt, 1, 0.333333, 100, 1453.99, 201, 101, 2, 1,45 / 68 / 2
singlecenter-alpha_3-98-n100.txt, 1, 0.333333, 100, 1496.81, 203, 103, 2, 1,77 / 80 / 2
singlecenter-alpha_3-99-n100.txt, 1, 0.333333, 100, 1152.66, 201, 101, 2, 1,95 / 82 / 2
uniform-1-n250.txt, 1, 0.5, 250, 1252.42, 516, 266, 2, 8,173 / 13 / 2, 166 / 34 / 2, 110 / 51 / 2, 77 / 77 / 2, 242 / 109 / 2, 66 / 159 / 2, 199 / 194 / 2, 228 / 242 / 2
uniform-1-n375.txt, 1, 0.5, 375, 1516.96, 788, 413, 3, 16,237 / 34 / 2, 60 / 57 / 3, 336 / 61 / 2, 305 / 97 / 2, 46 / 204 / 2, 272 / 251 / 2, 360 / 256 / 2, 349 / 277 / 2, 85 / 292 / 2, 88 / 298 / 2, 97 / 307 / 2, 243 / 343 / 2, 224 / 351 / 2, 92 / 352 / 2, 353 / 360 / 2, 270 / 368 / 2
uniform-1-n5.txt, 1, 0.5, 5, 313.233, 10, 5, 2, 1,1 / 1 / 2
uniform-10-n250.txt, 1, 0.5, 250, 1258.99, 532, 282, 3, 11,180 / 28 / 2, 14 / 61 / 2, 247 / 73 / 2, 10 / 108 / 2, 183 / 116 / 2, 185 / 134 / 3, 249 / 218 / 2, 2 / 226 / 2, 40 / 238 / 2, 28 / 245 / 2, 47 / 247 / 2
uniform-10-n5.txt, 1, 0.5, 5, 286.121, 9, 4, 1, 0,
uniform-10-n500.txt, 1, 0.5, 500, 1802.07, 1067, 567, 3, 25,478 / 7 / 2, 337 / 22 / 2, 415 / 35 / 2, 49 / 37 / 2, 54 / 67 / 2, 281 / 188 / 2, 219 / 204 / 2, 31 / 207 / 2, 68 / 213 / 3, 449 / 239 / 2, 96 / 255 / 2, 204 / 263 / 2, 408 / 266 / 2, 137 / 271 / 2, 94 / 275 / 2, 64 / 287 / 2, 216 / 306 / 2, 65 / 369 / 2, 223 / 386 / 3, 340 / 416 / 2, 371 / 443 / 2, 100 / 446 / 2, 77 / 471 / 2, 294 / 474 / 2, 221 / 481 / 2
uniform-100-n100.txt, 1, 0.5, 100, 800.692, 209, 109, 2, 5,47 / 28 / 2, 84 / 30 / 2, 31 / 33 / 2, 25 / 72 / 2, 17 / 78 / 2
uniform-101-n175.txt, 1, 0.5, 175, 1122.25, 376, 201, 2, 13,168 / 4 / 2, 19 / 9 / 2, 163 / 38 / 2, 129 / 50 / 2, 30 / 59 / 2, 10 / 65 / 2, 155 / 73 / 2, 12 / 94 / 2, 94 / 97 / 2, 65 / 105 / 2, 105 / 106 / 2, 121 / 136 / 2, 34 / 156 / 2
uniform-102-n175.txt, 1, 0.5, 175, 1104.51, 368, 193, 2, 9,134 / 29 / 2, 158 / 50 / 2, 102 / 95 / 2, 157 / 108 / 2, 9 / 116 / 2, 113 / 134 / 2, 22 / 151 / 2, 168 / 160 / 2, 24 / 171 / 2
uniform-103-n175.txt, 1, 0.5, 175, 1031.65, 363, 188, 2, 7,162 / 9 / 2, 88 / 24 / 2, 82 / 26 / 2, 29 / 50 / 2, 16 / 117 / 2, 138 / 157 / 2, 117 / 164 / 2
uniform-104-n175.txt, 1, 0.5, 175, 1049.43, 364, 189, 2, 7,40 / 12 / 2, 84 / 34 / 2, 69 / 51 / 2, 78 / 95 / 2, 161 / 122 / 2, 65 / 128 / 2, 3 / 150 / 2
uniform-105-n175.txt, 1, 0.5, 175, 1119.22, 371, 196, 3, 8,108 / 26 / 2, 31 / 33 / 2, 16 / 54 / 2, 173 / 59 / 2, 44 / 66 / 2, 153 / 97 / 3, 37 / 112 / 2, 120 / 120 / 2
uniform-106-n175.txt, 1, 0.5, 175, 1099.43, 368, 193, 2, 8,162 / 10 / 2, 45 / 32 / 2, 87 / 56 / 2, 2 / 80 / 2, 15 / 88 / 2, 5 / 111 / 2, 144 / 139 / 2, 101 / 153 / 2
uniform-107-n175.txt, 1, 0.5, 175, 1038.7, 389, 214, 3, 13,38 / 4 / 2, 67 / 7 / 3, 130 / 17 / 2, 20 / 28 / 2, 27 / 29 / 2, 93 / 40 / 2, 59 / 91 / 2, 111 / 97 / 2, 19 / 116 / 2, 86 / 118 / 2, 84 / 147 / 2, 45 / 157 / 2, 123 / 169 / 2
uniform-108-n175.txt, 1, 0.5, 175, 1111.02, 369, 194, 2, 7,74 / 56 / 2, 136 / 59 / 2, 50 / 62 / 2, 106 / 84 / 2, 134 / 88 / 2, 156 / 118 / 2, 4 / 138 / 2
uniform-109-n175.txt, 1, 0.5, 175, 1102.42, 363, 188, 2, 6,146 / 44 / 2, 145 / 71 / 2, 32 / 89 / 2, 83 / 119 / 2, 34 / 160 / 2, 128 / 166 / 2
uniform-11-n375.txt, 1, 0.5, 375, 1547.42, 793, 418, 2, 19,372 / 16 / 2, 160 / 54 / 2, 100 / 69 / 2, 145 / 74 / 2, 56 / 97 / 2, 343 / 106 / 2, 174 / 120 / 2, 231 / 137 / 2, 2 / 163 / 2, 318 / 239 / 2, 295 / 280 / 2, 51 / 291 / 2, 349 / 320 / 2, 219 / 330 / 2, 340 / 339 / 2, 59 / 345 / 2, 1 / 348 / 2, 35 / 349 / 2, 119 / 367 / 2
uniform-11-n500.txt, 1, 0.5, 500, 1822.68, 1058, 558, 2, 25,326 / 11 / 2, 73 / 44 / 2, 307 / 50 / 2, 145 / 80 / 2, 312 / 83 / 2, 347 / 96 / 2, 238 / 116 / 2, 421 / 124 / 2, 67 / 140 / 2, 207 / 145 / 2, 473 / 151 / 2, 27 / 169 / 2, 140 / 175 / 2, 197 / 177 / 2, 24 / 188 / 2, 320 / 204 / 2, 190 / 229 / 2, 441 / 244 / 2, 120 / 292 / 2, 379 / 310 / 2, 242 / 413 / 2, 297 / 421 / 2, 257 / 430 / 2, 92 / 472 / 2, 356 / 477 / 2
uniform-11-n6.txt, 1, 0.5, 6, 262.634, 11, 5, 1, 0,
uniform-110-n175.txt, 1, 0.5, 175, 1065.04, 378, 203, 2, 12,54 / 3 / 2, 43 / 16 / 2, 38 / 20 / 2, 124 / 31 / 2, 1 / 34 / 2, 129 / 42 / 2, 66 / 57 / 2, 30 / 70 / 2, 111 / 110 / 2, 5 / 125 / 2, 52 / 129 / 2, 101 / 159 / 2
uniform-111-n250.txt, 1, 0.5, 250, 1270.36, 532, 282, 2, 13,71 / 2 / 2, 141 / 14 / 2, 172 / 18 / 2, 41 / 41 / 2, 238 / 62 / 2, 43 / 80 / 2, 97 / 87 / 2, 113 / 128 / 2, 87 / 150 / 2, 47 / 162 / 2, 95 / 203 / 2, 65 / 244 / 2, 118 / 247 / 2
uniform-112-n250.txt, 1, 0.5, 250, 1256.11, 525, 275, 2, 11,145 / 13 / 2, 153 / 59 / 2, 44 / 78 / 2, 199 / 80 / 2, 61 / 102 / 2, 46 / 113 / 2, 118 / 152 / 2, 166 / 202 / 2, 197 / 209 / 2, 60 / 210 / 2, 142 / 235 / 2
uniform-113-n250.txt, 1, 0.5, 250, 1292.81, 531, 281, 2, 15,12 / 8 / 2, 63 / 14 / 2, 52 / 56 / 2, 143 / 60 / 2, 164 / 80 / 2, 48 / 82 / 2, 185 / 108 / 2, 162 / 121 / 2, 10 / 144 / 2, 177 / 154 / 2, 6 / 170 / 2, 81 / 179 / 2, 117 / 209 / 2, 163 / 220 / 2, 33 / 245 / 2
uniform-114-n250.txt, 1, 0.5, 250, 1250.7, 533, 283, 2, 14,96 / 5 / 2, 200 / 9 / 2, 14 / 33 / 2, 46 / 78 / 2, 230 / 101 / 2, 155 / 110 / 2, 88 / 136 / 2, 50 / 155 / 2, 74 / 160 / 2, 28 / 173 / 2, 221 / 180 / 2, 30 / 186 / 2, 202 / 198 / 2, 64 / 226 / 2
uniform-115-n250.txt, 1, 0.5, 250, 1340.32, 531, 281, 3, 13,199 / 42 / 2, 95 / 44 / 2, 79 / 51 / 2, 17 / 61 / 2, 50 / 68 / 3, 144 / 78 / 2, 213 / 83 / 2, 78 / 87 / 2, 46 / 159 / 2, 162 / 214 / 2, 116 / 220 / 2, 235 / 226 / 2, 44 / 243 / 2
uniform-116-n250.txt, 1, 0.5, 250, 1275.68, 524, 274, 2, 11,2 / 28 / 2, 58 / 78 / 2, 201 / 81 / 2, 116 / 94 / 2, 13 / 134 / 2, 153 / 147 / 2, 104 / 185 / 2, 200 / 208 / 2, 112 / 217 / 2, 42 / 226 / 2, 187 / 242 / 2
uniform-117-n250.txt, 1, 0.5, 250, 1300.21, 529, 279, 3, 11,42 / 26 / 3, 230 / 29 / 2, 237 / 34 / 2, 36 / 65 / 2, 175 / 84 / 2, 66 / 100 / 2, 43 / 130 / 2, 86 / 149 / 2, 209 / 167 / 2, 115 / 174 / 2, 211 / 221 / 2
uniform-118-n250.txt, 1, 0.5, 250, 1209.09, 533, 283, 3, 11,47 / 44 / 2, 136 / 120 / 2, 19 / 150 / 2, 63 / 170 / 2, 40 / 181 / 2, 69 / 195 / 2, 162 / 203 / 3, 234 / 210 / 2, 171 / 211 / 2, 53 / 215 / 2, 242 / 220 / 3
uniform-119-n250.txt, 1, 0.5, 250, 1370.52, 518, 268, 2, 9,194 / 2 / 2, 6 / 25 / 2, 231 / 36 / 2, 80 / 42 / 2, 133 / 85 / 2, 109 / 155 / 2, 48 / 189 / 2, 33 / 223 / 2, 219 / 235 / 2
uniform-12-n375.txt, 1, 0.5, 375, 1563.02, 798, 423, 3, 19,200 / 18 / 2, 8 / 77 / 2, 87 / 83 / 2, 215 / 93 / 2, 107 / 97 / 2, 358 / 110 / 2, 369 / 151 / 2, 270 / 160 / 2, 183 / 170 / 3, 191 / 192 / 2, 5 / 196 / 2, 300 / 201 / 2, 74 / 218 / 2, 299 / 247 / 2, 72 / 255 / 2, 307 / 281 / 2, 189 / 284 / 2, 320 / 296 / 2, 68 / 334 / 2
uniform-12-n500.txt, 1, 0.5, 500, 1830.17, 1060, 560, 3, 23,34 / 16 / 2, 236 / 30 / 2, 268 / 58 / 2, 102 / 59 / 2, 230 / 88 / 2, 223 / 98 / 2, 211 / 122 / 2, 359 / 136 / 2, 171 / 145 / 2, 376 / 166 / 2, 339 / 174 / 2, 463 / 208 / 2, 379 / 219 / 2, 215 / 251 / 2, 464 / 315 / 3, 130 / 348 / 2, 288 / 381 / 2, 424 / 393 / 2, 259 / 413 / 2, 445 / 421 / 2, 292 / 454 / 2, 456 / 489 / 2, 271 / 498 / 2
uniform-12-n6.txt, 1, 0.5, 6, 332.319, 11, 5, 1, 0,
uniform-120-n250.txt, 1, 0.5, 250, 1251.67, 530, 280, 2, 14,244 / 56 / 2, 30 / 65 / 2, 23 / 67 / 2, 181 / 100 / 2, 7 / 107 / 2, 136 / 112 / 2, 48 / 134 / 2, 193 / 144 / 2, 43 / 159 / 2, 198 / 172 / 2, 29 / 189 / 2, 78 / 227 / 2, 199 / 239 / 2, 167 / 243 / 2
uniform-121-n375.txt, 1, 0.5, 375, 1520.2, 796, 421, 3, 17,77 / 18 / 2, 235 / 35 / 2, 283 / 60 / 2, 139 / 69 / 2, 62 / 84 / 2, 361 / 97 / 2, 17 / 117 / 2, 126 / 127 / 2, 81 / 154 / 2, 49 / 176 / 2, 145 / 193 / 2, 76 / 218 / 2, 314 / 294 / 3, 85 / 301 / 2, 125 / 333 / 3, 11 / 335 / 2, 211 / 347 / 2
uniform-13-n375.txt, 1, 0.5, 375, 1598.44, 806, 431, 3, 19,72 / 49 / 2, 303 / 63 / 2, 87 / 71 / 2, 270 / 90 / 3, 128 / 99 / 3, 258 / 103 / 2, 322 / 123 / 2, 127 / 134 / 2, 297 / 138 / 2, 195 / 142 / 2, 254 / 174 / 3, 313 / 183 / 2, 339 / 219 / 2, 336 / 228 / 2, 166 / 242 / 2, 361 / 250 / 2, 34 / 261 / 2, 17 / 276 / 2, 140 / 300 / 2
uniform-13-n500.txt, 1, 0.5, 500, 1712.32, 1065, 565, 2, 25,166 / 8 / 2, 366 / 15 / 2, 482 / 31 / 2, 206 / 49 / 2, 100 / 57 / 2, 15 / 62 / 2, 39 / 81 / 2, 362 / 91 / 2, 152 / 105 / 2, 422 / 158 / 2, 288 / 172 / 2, 368 / 178 / 2, 186 / 191 / 2, 476 / 214 / 2, 95 / 303 / 2, 271 / 320 / 2, 415 / 340 / 2, 159 / 363 / 2, 302 / 365 / 2, 298 / 370 / 2, 498 / 383 / 2, 472 / 407 / 2, 477 / 425 / 2, 435 / 467 / 2, 130 / 491 / 2
uniform-13-n6.txt, 1, 0.5, 6, 240.425, 13, 7, 2, 1,5 / 4 / 2
uniform-14-n375.txt, 1, 0.5, 375, 1513.41, 800, 425, 3, 20,102 / 24 / 2, 21 / 35 / 2, 85 / 44 / 2, 48 / 58 / 2, 241 / 82 / 2, 139 / 86 / 2, 207 / 136 / 2, 313 / 145 / 2, 319 / 148 / 2, 316 / 155 / 2, 155 / 202 / 2, 9 / 238 / 2, 330 / 244 / 2, 10 / 265 / 3, 232 / 285 / 2, 182 / 286 / 2, 122 / 304 / 2, 247 / 329 / 3, 272 / 333 / 2, 131 / 338 / 2
uniform-14-n500.txt, 1, 0.5, 500, 1784.19, 1038, 538, 3, 15,30 / 13 / 2, 471 / 47 / 2, 194 / 66 / 3, 485 / 146 / 2, 422 / 152 / 2, 493 / 187 / 2, 430 / 204 / 2, 329 / 208 / 2, 407 / 213 / 2, 461 / 231 / 2, 179 / 274 / 2, 462 / 353 / 2, 143 / 421 / 2, 121 / 441 / 2, 447 / 450 / 2
uniform-14-n6.txt, 1, 0.5, 6, 239.081, 12, 6, 2, 1,4 / 1 / 2
uniform-15-n375.txt, 1, 0.5, 375, 1523.79, 797, 422, 3, 19,118 / 4 / 2, 210 / 12 / 3, 279 / 15 / 2, 315 / 32 / 2, 28 / 42 / 3, 369 / 45 / 2, 152 / 68 / 2, 167 / 107 / 2, 183 / 122 / 2, 189 / 125 / 2, 254 / 127 / 2, 154 / 171 / 2, 212 / 184 / 2, 310 / 237 / 2, 373 / 282 / 2, 244 / 322 / 2, 316 / 351 / 2, 88 / 357 / 2, 223 / 360 / 2
uniform-15-n6.txt, 1, 0.5, 6, 213.016, 13, 7, 2, 1,1 / 4 / 2
uniform-16-n375.txt, 1, 0.5, 375, 1598.95, 794, 419, 2, 17,66 / 38 / 2, 154 / 43 / 2, 299 / 49 / 2, 373 / 57 / 2, 218 / 111 / 2, 314 / 126 / 2, 149 / 157 / 2, 255 / 179 / 2, 263 / 186 / 2, 24 / 204 / 2, 285 / 211 / 2, 353 / 254 / 2, 306 / 271 / 2, 99 / 293 / 2, 217 / 306 / 2, 42 / 346 / 2, 89 / 363 / 2
uniform-16-n6.txt, 1, 0.5, 6, 272.92, 13, 7, 2, 1,2 / 3 / 2
uniform-17-n375.txt, 1, 0.5, 375, 1509.47, 778, 403, 2, 11,100 / 14 / 2, 58 / 15 / 2, 224 / 64 / 2, 263 / 77 / 2, 267 / 131 / 2, 356 / 208 / 2, 90 / 214 / 2, 303 / 224 / 2, 87 / 248 / 2, 295 / 334 / 2, 149 / 360 / 2
uniform-17-n6.txt, 1, 0.5, 6, 302.02, 11, 5, 1, 0,
uniform-18-n375.txt, 1, 0.5, 375, 1548.15, 787, 412, 2, 16,322 / 10 / 2, 217 / 49 / 2, 194 / 94 / 2, 74 / 98 / 2, 320 / 117 / 2, 14 / 149 / 2, 210 / 151 / 2, 185 / 153 / 2, 146 / 156 / 2, 289 / 159 / 2, 154 / 177 / 2, 350 / 243 / 2, 87 / 271 / 2, 191 / 306 / 2, 149 / 338 / 2, 361 / 346 / 2
uniform-18-n6.txt, 1, 0.5, 6, 238.14, 11, 5, 1, 0,
uniform-19-n375.txt, 1, 0.5, 375, 1486.42, 809, 434, 3, 21,54 / 26 / 2, 325 / 33 / 2, 253 / 55 / 2, 228 / 59 / 2, 141 / 65 / 2, 123 / 100 / 2, 144 / 106 / 3, 311 / 128 / 2, 371 / 152 / 2, 349 / 156 / 2, 57 / 198 / 2, 290 / 208 / 2, 10 / 223 / 2, 53 / 233 / 2, 188 / 283 / 2, 159 / 304 / 2, 163 / 337 / 2, 322 / 344 / 2, 315 / 349 / 3, 190 / 356 / 2, 148 / 367 / 2
uniform-19-n6.txt, 1, 0.5, 6, 277.659, 16, 10, 3, 1,5 / 3 / 3
uniform-2-n250.txt, 1, 0.5, 250, 1270.73, 534, 284, 3, 10,118 / 9 / 2, 76 / 22 / 2, 244 / 29 / 3, 192 / 56 / 2, 67 / 59 / 2, 191 / 129 / 2, 134 / 170 / 2, 146 / 194 / 2, 17 / 223 / 2, 15 / 247 / 2
uniform-2-n375.txt, 1, 0.5, 375, 1584.04, 802, 427, 3, 19,273 / 33 / 2, 199 / 92 / 2, 182 / 110 / 2, 217 / 124 / 2, 160 / 150 / 2, 307 / 160 / 2, 352 / 172 / 2, 143 / 184 / 2, 86 / 205 / 3, 212 / 231 / 2, 103 / 233 / 2, 343 / 261 / 2, 236 / 279 / 2, 301 / 289 / 2, 184 / 313 / 2, 40 / 315 / 2, 61 / 319 / 2, 30 / 342 / 2, 119 / 351 / 2
uniform-2-n5.txt, 1, 0.5, 5, 261.478, 9, 4, 1, 0,
uniform-20-n375.txt, 1, 0.5, 375, 1501.29, 789, 414, 2, 17,320 / 20 / 2, 88 / 25 / 2, 336 / 28 / 2, 313 / 44 / 2, 102 / 50 / 2, 123 / 111 / 2, 211 / 147 / 2, 106 / 191 / 2, 15 / 203 / 2, 247 / 219 / 2, 187 / 228 / 2, 108 / 239 / 2, 296 / 248 / 2, 204 / 280 / 2, 29 / 283 / 2, 111 / 288 / 2, 155 / 332 / 2
uniform-20-n6.txt, 1, 0.5, 6, 272.553, 15, 9, 2, 1,1 / 2 / 2
uniform-21-n500.txt, 1, 0.5, 500, 1862.88, 1084, 584, 3, 33,324 / 6 / 2, 446 / 62 / 2, 102 / 82 / 2, 456 / 91 / 2, 199 / 96 / 2, 158 / 111 / 2, 128 / 131 / 3, 40 / 134 / 2, 151 / 139 / 2, 388 / 142 / 2, 464 / 148 / 2, 275 / 154 / 2, 283 / 191 / 2, 205 / 204 / 2, 356 / 212 / 2, 73 / 222 / 2, 230 / 241 / 2, 374 / 259 / 2, 9 / 275 / 2, 98 / 320 / 2, 1 / 335 / 2, 53 / 341 / 2, 55 / 352 / 2, 84 / 360 / 3, 460 / 368 / 2, 165 / 376 / 2, 6 / 387 / 2, 143 / 404 / 2, 317 / 430 / 2, 186 / 459 / 2, 380 / 465 / 2, 105 / 478 / 2, 310 / 496 / 2
uniform-21-n7.txt, 1, 0.5, 7, 270.69, 13, 6, 1, 0,
uniform-22-n7.txt, 1, 0.5, 7, 314.335, 16, 9, 2, 1,6 / 3 / 2
uniform-23-n7.txt, 1, 0.5, 7, 297.738, 13, 6, 1, 0,
uniform-24-n7.txt, 1, 0.5, 7, 297.721, 13, 6, 1, 0,
uniform-25-n7.txt, 1, 0.5, 7, 291.346, 16, 9, 2, 1,6 / 4 / 2
uniform-26-n7.txt, 1, 0.5, 7, 242.938, 13, 6, 1, 0,
uniform-27-n7.txt, 1, 0.5, 7, 287.874, 16, 9, 2, 1,3 / 3 / 2
uniform-28-n7.txt, 1, 0.5, 7, 364.48, 13, 6, 1, 0,
uniform-29-n7.txt, 1, 0.5, 7, 393.442, 17, 10, 2, 1,6 / 2 / 2
uniform-3-n250.txt, 1, 0.5, 250, 1406.75, 531, 281, 3, 9,101 / 67 / 3, 82 / 92 / 3, 139 / 98 / 2, 145 / 114 / 2, 179 / 130 / 2, 167 / 135 / 2, 42 / 157 / 2, 166 / 171 / 2, 198 / 191 / 2
uniform-3-n375.txt, 1, 0.5, 375, 1510.02, 790, 415, 2, 17,5 / 12 / 2, 340 / 30 / 2, 74 / 31 / 2, 292 / 45 / 2, 329 / 65 / 2, 283 / 84 / 2, 352 / 119 / 2, 313 / 172 / 2, 110 / 175 / 2, 8 / 192 / 2, 88 / 241 / 2, 155 / 256 / 2, 365 / 269 / 2, 330 / 275 / 2, 325 / 315 / 2, 128 / 346 / 2, 60 / 355 / 2
uniform-3-n5.txt, 1, 0.5, 5, 272.513, 12, 7, 2, 1,3 / 3 / 2
uniform-30-n7.txt, 1, 0.5, 7, 238.887, 13, 6, 1, 0,
uniform-31-n8.txt, 1, 0.5, 8, 339.695, 15, 7, 1, 0,
uniform-32-n8.txt, 1, 0.5, 8, 259.905, 28, 20, 5, 1,1 / 5 / 5
uniform-33-n8.txt, 1, 0.5, 8, 246.208, 15, 7, 1, 0,
uniform-34-n8.txt, 1, 0.5, 8, 342.836, 17, 9, 2, 1,6 / 5 / 2
uniform-35-n8.txt, 1, 0.5, 8, 254.714, 15, 7, 1, 0,
uniform-36-n8.txt, 1, 0.5, 8, 347.116, 17, 9, 3, 1,6 / 1 / 3
uniform-37-n8.txt, 1, 0.5, 8, 340.2, 17, 9, 2, 1,2 / 4 / 2
uniform-38-n8.txt, 1, 0.5, 8, 333.952, 18, 10, 2, 1,1 / 4 / 2
uniform-39-n8.txt, 1, 0.5, 8, 297.747, 15, 7, 1, 0,
uniform-4-n250.txt, 1, 0.5, 250, 1268.37, 522, 272, 2, 12,126 / 1 / 2, 91 / 16 / 2, 4 / 26 / 2, 82 / 44 / 2, 40 / 104 / 2, 241 / 106 / 2, 61 / 126 / 2, 100 / 137 / 2, 26 / 138 / 2, 111 / 206 / 2, 211 / 224 / 2, 247 / 241 / 2
uniform-4-n375.txt, 1, 0.5, 375, 1712.59, 801, 426, 2, 22,44 / 12 / 2, 355 / 41 / 2, 40 / 103 / 2, 342 / 122 / 2, 180 / 129 / 2, 247 / 131 / 2, 248 / 139 / 2, 243 / 146 / 2, 320 / 161 / 2, 31 / 175 / 2, 161 / 202 / 2, 93 / 207 / 2, 218 / 211 / 2, 234 / 231 / 2, 98 / 270 / 2, 78 / 289 / 2, 30 / 319 / 2, 9 / 337 / 2, 330 / 354 / 2, 287 / 361 / 2, 249 / 365 / 2, 166 / 367 / 2
uniform-4-n5.txt, 1, 0.5, 5, 224.592, 9, 4, 1, 0,
uniform-40-n8.txt, 1, 0.5, 8, 262.318, 15, 7, 1, 0,
uniform-41-n9.txt, 1, 0.5, 9, 360.836, 17, 8, 1, 0,
uniform-42-n9.txt, 1, 0.5, 9, 290.198, 17, 8, 1, 0,
uniform-43-n9.txt, 1, 0.5, 9, 316.938, 19, 10, 2, 1,3 / 4 / 2
uniform-44-n9.txt, 1, 0.5, 9, 289.015, 21, 12, 2, 2,2 / 3 / 2, 1 / 6 / 2
uniform-45-n9.txt, 1, 0.5, 9, 370.65, 22, 13, 2, 1,4 / 5 / 2
uniform-46-n9.txt, 1, 0.5, 9, 306.315, 17, 8, 1, 0,
uniform-47-n9.txt, 1, 0.5, 9, 349.988, 19, 10, 2, 1,5 / 5 / 2
uniform-48-n9.txt, 1, 0.5, 9, 344.493, 19, 10, 2, 1,1 / 7 / 2
uniform-49-n9.txt, 1, 0.5, 9, 228.611, 19, 10, 2, 1,7 / 3 / 2
uniform-5-n250.txt, 1, 0.5, 250, 1284.59, 521, 271, 2, 9,29 / 11 / 2, 23 / 20 / 2, 76 / 28 / 2, 36 / 37 / 2, 134 / 49 / 2, 75 / 87 / 2, 44 / 178 / 2, 105 / 210 / 2, 166 / 247 / 2
uniform-5-n5.txt, 1, 0.5, 5, 319.61, 9, 4, 1, 0,
uniform-5-n500.txt, 1, 0.5, 500, 1792.13, 1063, 563, 3, 22,165 / 16 / 2, 96 / 25 / 2, 211 / 28 / 2, 477 / 30 / 2, 94 / 61 / 2, 428 / 66 / 2, 287 / 79 / 2, 485 / 120 / 2, 63 / 129 / 2, 95 / 142 / 3, 240 / 156 / 2, 437 / 220 / 2, 450 / 249 / 2, 417 / 255 / 2, 229 / 302 / 2, 387 / 305 / 2, 470 / 325 / 2, 330 / 359 / 2, 13 / 450 / 2, 347 / 462 / 2, 83 / 481 / 2, 157 / 488 / 2
uniform-50-n9.txt, 1, 0.5, 9, 398.903, 18, 9, 2, 1,4 / 1 / 2
uniform-51-n10.txt, 1, 0.5, 10, 351.055, 22, 12, 2, 2,8 / 1 / 2, 2 / 2 / 2
uniform-52-n10.txt, 1, 0.5, 10, 312.177, 22, 12, 2, 1,6 / 5 / 2
uniform-53-n10.txt, 1, 0.5, 10, 284.656, 19, 9, 1, 0,
uniform-54-n10.txt, 1, 0.5, 10, 312.316, 19, 9, 1, 0,
uniform-55-n10.txt, 1, 0.5, 10, 338.061, 19, 9, 1, 0,
uniform-56-n10.txt, 1, 0.5, 10, 334.976, 19, 9, 1, 0,
uniform-57-n10.txt, 1, 0.5, 10, 261.681, 19, 9, 1, 0,
uniform-58-n10.txt, 1, 0.5, 10, 330.286, 21, 11, 2, 1,7 / 2 / 2
uniform-59-n10.txt, 1, 0.5, 10, 362.251, 19, 9, 1, 0,
uniform-6-n250.txt, 1, 0.5, 250, 1255.91, 522, 272, 2, 10,137 / 8 / 2, 35 / 15 / 2, 156 / 17 / 2, 131 / 79 / 2, 229 / 144 / 2, 28 / 165 / 2, 210 / 174 / 2, 122 / 177 / 2, 102 / 180 / 2, 14 / 192 / 2
uniform-6-n5.txt, 1, 0.5, 5, 325.691, 13, 8, 2, 2,4 / 3 / 2, 3 / 4 / 2
uniform-6-n500.txt, 1, 0.5, 500, 1872.46, 1051, 551, 3, 17,337 / 27 / 2, 200 / 66 / 2, 452 / 146 / 2, 239 / 152 / 2, 295 / 210 / 2, 474 / 216 / 2, 17 / 265 / 2, 90 / 280 / 2, 366 / 300 / 2, 71 / 303 / 2, 56 / 355 / 2, 72 / 375 / 2, 425 / 378 / 2, 112 / 392 / 3, 455 / 465 / 3, 79 / 467 / 2, 242 / 485 / 2
uniform-60-n10.txt, 1, 0.5, 10, 280.236, 19, 9, 1, 0,
uniform-61-n20.txt, 1, 0.5, 20, 412.017, 41, 21, 2, 1,9 / 2 / 2
uniform-62-n20.txt, 1, 0.5, 20, 397.151, 39, 19, 1, 0,
uniform-63-n20.txt, 1, 0.5, 20, 394.501, 46, 26, 2, 3,4 / 2 / 2, 9 / 5 / 2, 1 / 17 / 2
uniform-64-n20.txt, 1, 0.5, 20, 395.481, 44, 24, 2, 1,3 / 14 / 2
uniform-65-n20.txt, 1, 0.5, 20, 399.773, 42, 22, 2, 1,14 / 7 / 2
uniform-66-n20.txt, 1, 0.5, 20, 440.764, 39, 19, 1, 0,
uniform-67-n20.txt, 1, 0.5, 20, 391.609, 39, 19, 1, 0,
uniform-68-n20.txt, 1, 0.5, 20, 439.351, 41, 21, 2, 1,6 / 17 / 2
uniform-69-n20.txt, 1, 0.5, 20, 380.47, 41, 21, 2, 1,17 / 15 / 2
uniform-7-n250.txt, 1, 0.5, 250, 1400.13, 529, 279, 2, 9,108 / 37 / 2, 238 / 91 / 2, 166 / 100 / 2, 222 / 102 / 2, 234 / 113 / 2, 221 / 125 / 2, 216 / 166 / 2, 149 / 235 / 2, 151 / 245 / 2
uniform-7-n5.txt, 1, 0.5, 5, 291.804, 9, 4, 1, 0,
uniform-7-n500.txt, 1, 0.5, 500, 1780.76, 1062, 562, 2, 28,156 / 55 / 2, 136 / 63 / 2, 310 / 70 / 2, 487 / 81 / 2, 434 / 114 / 2, 66 / 128 / 2, 79 / 131 / 2, 490 / 136 / 2, 112 / 148 / 2, 326 / 154 / 2, 68 / 170 / 2, 180 / 184 / 2, 355 / 201 / 2, 491 / 223 / 2, 17 / 226 / 2, 260 / 239 / 2, 91 / 253 / 2, 411 / 261 / 2, 295 / 289 / 2, 111 / 310 / 2, 151 / 314 / 2, 103 / 316 / 2, 290 / 354 / 2, 327 / 355 / 2, 266 / 445 / 2, 193 / 471 / 2, 482 / 476 / 2, 131 / 490 / 2
uniform-70-n20.txt, 1, 0.5, 20, 428.423, 47, 27, 2, 2,11 / 7 / 2, 10 / 9 / 2
uniform-71-n50.txt, 1, 0.5, 50, 615.018, 106, 56, 2, 3,11 / 24 / 2, 44 / 39 / 2, 46 / 43 / 2
uniform-72-n50.txt, 1, 0.5, 50, 680.466, 103, 53, 2, 2,32 / 6 / 2, 24 / 41 / 2
uniform-73-n50.txt, 1, 0.5, 50, 615.987, 107, 57, 2, 3,40 / 5 / 2, 12 / 10 / 2, 11 / 46 / 2
uniform-74-n50.txt, 1, 0.5, 50, 592.029, 111, 61, 2, 4,33 / 8 / 2, 40 / 22 / 2, 30 / 24 / 2, 18 / 43 / 2
uniform-75-n50.txt, 1, 0.5, 50, 651.132, 105, 55, 2, 2,39 / 23 / 2, 17 / 27 / 2
uniform-76-n50.txt, 1, 0.5, 50, 623.931, 103, 53, 2, 2,42 / 2 / 2, 17 / 46 / 2
uniform-77-n50.txt, 1, 0.5, 50, 726.191, 105, 55, 2, 3,17 / 23 / 2, 45 / 25 / 2, 41 / 32 / 2
uniform-78-n50.txt, 1, 0.5, 50, 604.382, 104, 54, 2, 2,10 / 20 / 2, 34 / 33 / 2
uniform-79-n50.txt, 1, 0.5, 50, 559.931, 103, 53, 2, 2,16 / 5 / 2, 22 / 33 / 2
uniform-8-n250.txt, 1, 0.5, 250, 1340.8, 514, 264, 2, 7,26 / 29 / 2, 132 / 40 / 2, 7 / 70 / 2, 61 / 101 / 2, 153 / 182 / 2, 138 / 199 / 2, 198 / 245 / 2
uniform-8-n5.txt, 1, 0.5, 5, 245.206, 9, 4, 1, 0,
uniform-8-n500.txt, 1, 0.5, 500, 1847.95, 1085, 585, 3, 25,167 / 34 / 2, 414 / 46 / 2, 375 / 107 / 2, 73 / 109 / 2, 58 / 130 / 2, 415 / 150 / 2, 162 / 170 / 2, 356 / 178 / 2, 161 / 193 / 2, 498 / 199 / 2, 496 / 245 / 2, 266 / 262 / 3, 43 / 302 / 2, 114 / 310 / 2, 431 / 313 / 2, 342 / 322 / 2, 493 / 333 / 2, 158 / 339 / 2, 99 / 350 / 2, 59 / 403 / 3, 391 / 411 / 2, 93 / 419 / 3, 77 / 434 / 3, 7 / 444 / 3, 144 / 452 / 2
uniform-80-n50.txt, 1, 0.5, 50, 566.846, 111, 61, 2, 5,40 / 9 / 2, 19 / 29 / 2, 11 / 36 / 2, 16 / 38 / 2, 34 / 45 / 2
uniform-81-n75.txt, 1, 0.5, 75, 728.977, 164, 89, 2, 5,67 / 6 / 2, 49 / 21 / 2, 5 / 38 / 2, 69 / 49 / 2, 20 / 67 / 2
uniform-82-n75.txt, 1, 0.5, 75, 654.044, 160, 85, 2, 4,66 / 4 / 2, 58 / 7 / 2, 2 / 15 / 2, 14 / 44 / 2
uniform-83-n75.txt, 1, 0.5, 75, 668.412, 158, 83, 2, 4,47 / 8 / 2, 27 / 16 / 2, 17 / 43 / 2, 61 / 55 / 2
uniform-84-n75.txt, 1, 0.5, 75, 747.495, 154, 79, 2, 2,20 / 36 / 2, 67 / 54 / 2
uniform-85-n75.txt, 1, 0.5, 75, 816.148, 160, 85, 3, 1,50 / 19 / 3
uniform-86-n75.txt, 1, 0.5, 75, 753.745, 168, 93, 2, 6,50 / 5 / 2, 63 / 29 / 2, 10 / 39 / 2, 27 / 41 / 2, 53 / 49 / 2, 17 / 58 / 2
uniform-87-n75.txt, 1, 0.5, 75, 751.239, 162, 87, 2, 6,65 / 20 / 2, 20 / 38 / 2, 38 / 41 / 2, 70 / 54 / 2, 18 / 60 / 2, 1 / 72 / 2
uniform-88-n75.txt, 1, 0.5, 75, 783.628, 156, 81, 2, 3,70 / 25 / 2, 60 / 34 / 2, 14 / 57 / 2
uniform-89-n75.txt, 1, 0.5, 75, 691.281, 167, 92, 3, 7,26 / 25 / 3, 53 / 32 / 2, 65 / 44 / 2, 17 / 51 / 2, 54 / 60 / 2, 14 / 62 / 2, 21 / 69 / 2
uniform-9-n250.txt, 1, 0.5, 250, 1289.54, 518, 268, 2, 7,178 / 38 / 2, 234 / 44 / 2, 31 / 98 / 2, 202 / 105 / 2, 103 / 161 / 2, 167 / 178 / 2, 83 / 182 / 2
uniform-9-n5.txt, 1, 0.5, 5, 232.434, 11, 6, 2, 1,1 / 2 / 2
uniform-9-n500.txt, 1, 0.5, 500, 1733.16, 1038, 538, 2, 18,160 / 15 / 2, 401 / 21 / 2, 405 / 61 / 2, 412 / 80 / 2, 46 / 89 / 2, 320 / 100 / 2, 228 / 118 / 2, 67 / 154 / 2, 316 / 175 / 2, 256 / 280 / 2, 347 / 306 / 2, 337 / 327 / 2, 91 / 334 / 2, 57 / 369 / 2, 22 / 397 / 2, 16 / 429 / 2, 430 / 445 / 2, 93 / 459 / 2
uniform-90-n75.txt, 1, 0.5, 75, 752.177, 157, 82, 2, 3,18 / 18 / 2, 72 / 36 / 2, 29 / 48 / 2
uniform-91-n100.txt, 1, 0.5, 100, 840.524, 204, 104, 2, 2,9 / 32 / 2, 69 / 80 / 2
uniform-92-n100.txt, 1, 0.5, 100, 801.271, 213, 113, 3, 5,70 / 18 / 2, 5 / 33 / 2, 69 / 40 / 2, 65 / 76 / 3, 48 / 83 / 2
uniform-93-n100.txt, 1, 0.5, 100, 824.282, 209, 109, 2, 5,91 / 36 / 2, 74 / 42 / 2, 41 / 45 / 2, 11 / 52 / 2, 29 / 55 / 2
uniform-94-n100.txt, 1, 0.5, 100, 866.834, 211, 111, 2, 4,15 / 8 / 2, 32 / 20 / 2, 16 / 27 / 2, 93 / 68 / 2
uniform-95-n100.txt, 1, 0.5, 100, 826.35, 208, 108, 2, 4,67 / 4 / 2, 90 / 17 / 2, 36 / 80 / 2, 72 / 91 / 2
uniform-96-n100.txt, 1, 0.5, 100, 837.927, 205, 105, 2, 3,20 / 6 / 2, 77 / 53 / 2, 14 / 65 / 2
uniform-97-n100.txt, 1, 0.5, 100, 938.451, 205, 105, 2, 3,93 / 23 / 2, 4 / 34 / 2, 24 / 54 / 2
uniform-98-n100.txt, 1, 0.5, 100, 845.802, 214, 114, 3, 4,92 / 51 / 2, 55 / 56 / 3, 84 / 66 / 2, 57 / 74 / 2
uniform-99-n100.txt, 1, 0.5, 100, 873.511, 208, 108, 2, 5,29 / 43 / 2, 37 / 49 / 2, 79 / 52 / 2, 40 / 80 / 2, 34 / 99 / 2
uniform-alpha_1-1-n250.txt, 1, 1, 250, 1280.15, 1721, 1471, 5, 239,69 / 1 / 2, 53 / 2 / 3, 202 / 3 / 2, 71 / 4 / 3, 148 / 5 / 2, 228 / 6 / 2, 191 / 7 / 2, 152 / 8 / 4, 32 / 9 / 2, 234 / 10 / 2, 147 / 11 / 3, 92 / 12 / 2, 240 / 13 / 3, 224 / 14 / 2, 139 / 15 / 2, 136 / 16 / 2, 232 / 17 / 2, 180 / 18 / 2, 164 / 19 / 2, 231 / 20 / 2, 66 / 21 / 5, 2 / 22 / 2, 101 / 23 / 2, 88 / 24 / 2, 14 / 25 / 2, 100 / 26 / 2, 194 / 27 / 4, 10 / 28 / 2, 243 / 29 / 3, 198 / 30 / 2, 215 / 31 / 3, 153 / 32 / 2, 186 / 33 / 3, 206 / 34 / 2, 81 / 35 / 2, 122 / 36 / 2, 27 / 37 / 2, 58 / 38 / 3, 154 / 39 / 2, 105 / 40 / 5, 169 / 41 / 2, 98 / 42 / 2, 80 / 43 / 2, 94 / 44 / 4, 190 / 45 / 2, 149 / 46 / 2, 156 / 47 / 2, 207 / 48 / 2, 113 / 49 / 3, 201 / 50 / 2, 131 / 51 / 2, 111 / 52 / 3, 155 / 53 / 2, 1 / 54 / 2, 138 / 55 / 3, 25 / 56 / 2, 160 / 57 / 3, 161 / 58 / 2, 172 / 59 / 3, 162 / 60 / 2, 241 / 61 / 2, 125 / 62 / 2, 185 / 63 / 2, 214 / 64 / 4, 19 / 65 / 2, 193 / 66 / 2, 5 / 67 / 4, 115 / 68 / 2, 195 / 69 / 3, 38 / 70 / 2, 219 / 71 / 3, 133 / 72 / 2, 143 / 73 / 3, 114 / 74 / 2, 199 / 77 / 2, 34 / 78 / 3, 42 / 79 / 2, 46 / 80 / 2, 157 / 81 / 2, 230 / 82 / 3, 41 / 84 / 2, 36 / 85 / 2, 62 / 86 / 2, 246 / 87 / 2, 242 / 88 / 4, 90 / 89 / 2, 178 / 90 / 2, 233 / 91 / 2, 196 / 92 / 2, 167 / 93 / 2, 82 / 96 / 3, 222 / 97 / 2, 145 / 98 / 2, 249 / 99 / 3, 37 / 100 / 2, 73 / 101 / 2, 225 / 102 / 2, 11 / 103 / 2, 179 / 104 / 4, 9 / 105 / 2, 188 / 106 / 2, 47 / 107 / 2, 189 / 108 / 3, 184 / 109 / 2, 238 / 110 / 3, 55 / 111 / 2, 16 / 112 / 2, 208 / 113 / 3, 109 / 115 / 2, 223 / 116 / 2, 85 / 117 / 2, 144 / 118 / 2, 165 / 119 / 3, 171 / 120 / 2, 91 / 121 / 2, 104 / 122 / 4, 84 / 123 / 2, 59 / 124 / 2, 247 / 125 / 2, 127 / 126 / 3, 200 / 127 / 2, 183 / 128 / 3, 45 / 129 / 2, 212 / 130 / 2, 244 / 131 / 2, 117 / 132 / 4, 95 / 133 / 2, 174 / 134 / 2, 182 / 135 / 4, 43 / 136 / 2, 28 / 137 / 2, 39 / 138 / 2, 72 / 139 / 2, 97 / 140 / 3, 217 / 141 / 2, 236 / 142 / 2, 119 / 144 / 2, 163 / 145 / 3, 213 / 146 / 2, 18 / 147 / 3, 126 / 148 / 2, 99 / 149 / 2, 245 / 150 / 2, 78 / 151 / 3, 120 / 152 / 2, 166 / 153 / 3, 76 / 154 / 2, 141 / 155 / 2, 107 / 156 / 3, 17 / 157 / 2, 176 / 158 / 3, 89 / 159 / 2, 86 / 160 / 3, 235 / 161 / 2, 83 / 162 / 3, 106 / 163 / 2, 20 / 164 / 2, 4 / 165 / 2, 29 / 166 / 2, 151 / 167 / 2, 132 / 168 / 2, 168 / 169 / 4, 67 / 170 / 2, 124 / 171 / 2, 192 / 172 / 2, 96 / 173 / 2, 40 / 174 / 3, 123 / 175 / 2, 205 / 176 / 2, 48 / 177 / 2, 216 / 178 / 2, 6 / 179 / 2, 135 / 180 / 3, 21 / 181 / 2, 63 / 182 / 3, 35 / 183 / 2, 170 / 184 / 3, 142 / 185 / 2, 77 / 186 / 2, 210 / 187 / 2, 130 / 188 / 2, 221 / 189 / 3, 3 / 190 / 2, 203 / 191 / 3, 74 / 192 / 2, 50 / 193 / 3, 8 / 194 / 2, 33 / 195 / 2, 79 / 196 / 2, 229 / 197 / 3, 103 / 198 / 2, 209 / 199 / 2, 93 / 200 / 2, 134 / 201 / 2, 49 / 202 / 2, 24 / 203 / 4, 13 / 204 / 2, 65 / 205 / 2, 239 / 206 / 3, 57 / 207 / 2, 70 / 208 / 2, 75 / 209 / 3, 61 / 210 / 2, 220 / 211 / 2, 129 / 212 / 2, 52 / 213 / 2, 60 / 214 / 2, 56 / 215 / 2, 54 / 216 / 2, 68 / 217 / 2, 218 / 218 / 2, 181 / 219 / 2, 110 / 220 / 2, 23 / 221 / 2, 31 / 222 / 4, 159 / 223 / 2, 15 / 225 / 2, 226 / 226 / 2, 197 / 227 / 2, 7 / 228 / 2, 121 / 229 / 2, 22 / 230 / 2, 173 / 231 / 3, 248 / 232 / 2, 237 / 233 / 2, 118 / 234 / 4, 30 / 235 / 2, 140 / 236 / 2, 175 / 237 / 2, 87 / 238 / 2, 116 / 239 / 4, 227 / 240 / 2, 211 / 241 / 2, 108 / 242 / 3, 187 / 243 / 2, 102 / 246 / 3, 177 / 247 / 2, 64 / 248 / 2, 204 / 249 / 3
uniform-alpha_1-1-n375.txt, 1, 1, 375, 1546.59, 2626, 2251, 6, 355,53 / 1 / 2, 318 / 2 / 2, 204 / 3 / 2, 351 / 4 / 5, 116 / 5 / 2, 344 / 6 / 2, 64 / 7 / 2, 307 / 8 / 4, 177 / 9 / 2, 251 / 10 / 2, 288 / 11 / 3, 298 / 12 / 2, 102 / 13 / 2, 275 / 14 / 2, 301 / 15 / 3, 118 / 16 / 2, 30 / 17 / 3, 140 / 18 / 2, 175 / 19 / 2, 87 / 20 / 3, 237 / 21 / 2, 371 / 22 / 2, 248 / 23 / 3, 173 / 24 / 2, 329 / 25 / 2, 279 / 26 / 2, 121 / 27 / 2, 7 / 28 / 2, 197 / 29 / 2, 261 / 30 / 2, 22 / 31 / 3, 316 / 32 / 2, 187 / 35 / 3, 359 / 36 / 2, 227 / 37 / 4, 108 / 40 / 4, 343 / 41 / 2, 72 / 42 / 2, 217 / 43 / 2, 236 / 44 / 3, 119 / 46 / 3, 163 / 47 / 2, 296 / 48 / 3, 314 / 49 / 2, 213 / 50 / 3, 349 / 51 / 2, 97 / 52 / 2, 226 / 53 / 4, 15 / 54 / 2, 350 / 55 / 2, 110 / 56 / 4, 23 / 57 / 2, 44 / 58 / 2, 159 / 59 / 2, 31 / 60 / 3, 126 / 61 / 2, 18 / 62 / 3, 334 / 63 / 2, 4 / 64 / 3, 29 / 65 / 2, 151 / 66 / 2, 341 / 67 / 3, 132 / 68 / 2, 345 / 70 / 2, 310 / 71 / 3, 124 / 72 / 2, 192 / 73 / 2, 96 / 74 / 3, 78 / 75 / 2, 120 / 76 / 3, 99 / 77 / 2, 245 / 78 / 2, 278 / 79 / 2, 374 / 80 / 3, 352 / 81 / 2, 308 / 82 / 5, 335 / 83 / 2, 263 / 84 / 2, 292 / 85 / 2, 328 / 86 / 3, 83 / 87 / 2, 106 / 88 / 2, 20 / 89 / 3, 86 / 90 / 2, 89 / 91 / 2, 235 / 92 / 3, 176 / 93 / 2, 336 / 94 / 4, 17 / 95 / 2, 107 / 96 / 3, 141 / 97 / 2, 76 / 98 / 2, 166 / 99 / 2, 325 / 100 / 2, 218 / 101 / 2, 372 / 102 / 3, 181 / 103 / 2, 68 / 104 / 3, 56 / 105 / 2, 54 / 106 / 2, 313 / 107 / 4, 60 / 108 / 2, 220 / 111 / 3, 52 / 112 / 2, 129 / 113 / 2, 61 / 114 / 2, 75 / 115 / 2, 70 / 116 / 2, 65 / 117 / 3, 13 / 118 / 2, 277 / 119 / 2, 348 / 120 / 2, 256 / 121 / 2, 24 / 122 / 2, 49 / 123 / 2, 134 / 124 / 2, 209 / 125 / 2, 93 / 126 / 2, 57 / 127 / 3, 239 / 128 / 2, 229 / 129 / 2, 103 / 130 / 4, 79 / 131 / 2, 33 / 132 / 2, 8 / 133 / 2, 266 / 134 / 2, 50 / 135 / 2, 74 / 136 / 2, 3 / 137 / 2, 203 / 138 / 2, 210 / 139 / 2, 77 / 140 / 5, 342 / 141 / 2, 317 / 142 / 2, 130 / 145 / 2, 257 / 146 / 2, 305 / 147 / 4, 297 / 148 / 2, 142 / 149 / 2, 299 / 150 / 4, 311 / 151 / 2, 294 / 152 / 3, 322 / 153 / 2, 242 / 154 / 2, 252 / 155 / 2, 90 / 156 / 2, 282 / 157 / 2, 167 / 160 / 2, 196 / 161 / 2, 233 / 162 / 3, 178 / 163 / 2, 246 / 164 / 2, 62 / 165 / 2, 36 / 166 / 2, 260 / 167 / 2, 309 / 168 / 3, 273 / 169 / 2, 12 / 170 / 2, 230 / 171 / 3, 219 / 172 / 2, 38 / 173 / 2, 195 / 174 / 2, 115 / 175 / 4, 281 / 176 / 2, 133 / 177 / 2, 143 / 178 / 2, 157 / 179 / 2, 46 / 180 / 2, 267 / 181 / 2, 253 / 183 / 2, 367 / 184 / 2, 303 / 185 / 4, 362 / 186 / 2, 332 / 187 / 2, 42 / 188 / 2, 271 / 189 / 4, 34 / 190 / 2, 370 / 191 / 2, 145 / 192 / 3, 222 / 193 / 2, 82 / 194 / 2, 73 / 195 / 4, 37 / 196 / 2, 249 / 197 / 2, 47 / 198 / 4, 188 / 199 / 2, 289 / 200 / 3, 9 / 201 / 2, 179 / 202 / 4, 291 / 203 / 2, 11 / 204 / 2, 225 / 205 / 2, 135 / 206 / 3, 21 / 207 / 2, 63 / 208 / 5, 6 / 209 / 2, 216 / 210 / 2, 320 / 211 / 3, 35 / 212 / 2, 170 / 213 / 2, 48 / 214 / 4, 205 / 215 / 2, 365 / 216 / 2, 123 / 217 / 2, 40 / 218 / 2, 67 / 219 / 5, 168 / 220 / 2, 302 / 221 / 2, 295 / 222 / 2, 184 / 223 / 2, 189 / 224 / 3, 250 / 225 / 2, 238 / 226 / 3, 208 / 227 / 2, 109 / 229 / 3, 366 / 230 / 2, 223 / 231 / 3, 85 / 232 / 2, 144 / 233 / 2, 171 / 234 / 4, 165 / 235 / 2, 339 / 236 / 3, 16 / 237 / 2, 55 / 238 / 3, 264 / 239 / 2, 91 / 240 / 3, 304 / 241 / 2, 104 / 242 / 2, 247 / 243 / 3, 59 / 244 / 2, 84 / 245 / 2, 272 / 246 / 3, 45 / 248 / 3, 212 / 249 / 2, 244 / 250 / 2, 117 / 251 / 3, 95 / 252 / 2, 357 / 253 / 3, 174 / 254 / 2, 360 / 255 / 3, 183 / 256 / 2, 200 / 257 / 2, 127 / 258 / 2, 276 / 259 / 2, 199 / 260 / 2, 269 / 261 / 2, 259 / 264 / 2, 114 / 265 / 3, 340 / 266 / 2, 5 / 267 / 2, 361 / 268 / 2, 193 / 269 / 3, 19 / 270 / 2, 255 / 271 / 2, 214 / 272 / 6, 185 / 273 / 2, 125 / 274 / 2, 354 / 275 / 2, 241 / 276 / 2, 162 / 277 / 2, 172 / 278 / 3, 161 / 279 / 2, 160 / 280 / 3, 25 / 281 / 2, 138 / 282 / 3, 331 / 283 / 2, 155 / 284 / 2, 1 / 285 / 3, 346 / 286 / 2, 312 / 287 / 4, 338 / 288 / 2, 131 / 289 / 2, 111 / 290 / 3, 156 / 291 / 2, 190 / 292 / 4, 207 / 294 / 2, 201 / 295 / 2, 113 / 296 / 2, 306 / 297 / 2, 364 / 298 / 4, 182 / 299 / 2, 43 / 300 / 2, 28 / 301 / 2, 333 / 302 / 2, 39 / 303 / 2, 98 / 304 / 3, 80 / 305 / 2, 94 / 306 / 3, 368 / 307 / 2, 280 / 308 / 2, 356 / 309 / 3, 169 / 310 / 2, 105 / 311 / 2, 154 / 312 / 2, 324 / 313 / 2, 323 / 314 / 2, 258 / 315 / 4, 327 / 316 / 2, 358 / 317 / 2, 330 / 318 / 2, 88 / 319 / 4, 101 / 320 / 2, 2 / 321 / 2, 286 / 322 / 2, 66 / 323 / 2, 254 / 324 / 2, 231 / 325 / 3, 283 / 326 / 2, 164 / 327 / 2, 180 / 328 / 3, 232 / 329 / 2, 136 / 330 / 2, 139 / 331 / 3, 285 / 332 / 2, 355 / 333 / 2, 100 / 334 / 3, 293 / 335 / 2, 14 / 336 / 3, 81 / 337 / 2, 122 / 338 / 2, 27 / 339 / 2, 321 / 340 / 3, 58 / 341 / 2, 206 / 342 / 2, 186 / 343 / 3, 153 / 344 / 2, 215 / 345 / 3, 198 / 346 / 2, 243 / 347 / 3, 10 / 348 / 2, 194 / 349 / 2, 240 / 350 / 2, 224 / 351 / 2, 284 / 352 / 2, 290 / 353 / 2, 147 / 354 / 2, 319 / 355 / 2, 347 / 356 / 2, 92 / 357 / 2, 353 / 358 / 3, 152 / 359 / 2, 32 / 360 / 2, 228 / 361 / 4, 191 / 362 / 2, 234 / 363 / 2, 373 / 364 / 2, 270 / 365 / 3, 71 / 366 / 2, 148 / 367 / 3, 268 / 368 / 2, 315 / 370 / 2, 202 / 371 / 2, 265 / 372 / 2, 337 / 373 / 2, 69 / 374 / 2
uniform-alpha_1-1-n5.txt, 1, 1, 5, 313.233, 20, 15, 4, 4,1 / 1 / 4, 2 / 2 / 2, 4 / 3 / 2, 3 / 4 / 4
uniform-alpha_1-10-n250.txt, 1, 1, 250, 1321.34, 1958, 1708, 11, 243,82 / 1 / 3, 88 / 2 / 2, 28 / 3 / 2, 2 / 4 / 2, 42 / 5 / 2, 55 / 6 / 2, 193 / 7 / 2, 212 / 8 / 3, 8 / 9 / 2, 41 / 10 / 3, 38 / 11 / 2, 198 / 12 / 3, 102 / 13 / 2, 44 / 14 / 2, 203 / 15 / 2, 4 / 16 / 4, 12 / 17 / 2, 178 / 18 / 2, 111 / 19 / 4, 24 / 20 / 2, 131 / 21 / 3, 23 / 22 / 2, 84 / 23 / 2, 104 / 24 / 2, 125 / 25 / 2, 68 / 26 / 2, 249 / 27 / 4, 243 / 28 / 2, 87 / 29 / 2, 248 / 30 / 6, 78 / 31 / 2, 48 / 32 / 2, 244 / 33 / 2, 153 / 34 / 2, 219 / 35 / 2, 9 / 36 / 3, 139 / 37 / 2, 16 / 38 / 2, 115 / 40 / 2, 220 / 41 / 5, 64 / 42 / 2, 66 / 43 / 2, 101 / 45 / 2, 172 / 46 / 4, 96 / 47 / 2, 170 / 48 / 2, 237 / 49 / 9, 184 / 50 / 2, 62 / 51 / 2, 67 / 52 / 2, 149 / 53 / 2, 196 / 54 / 2, 100 / 55 / 2, 221 / 56 / 3, 93 / 57 / 2, 215 / 58 / 2, 133 / 59 / 2, 179 / 60 / 2, 192 / 61 / 2, 58 / 62 / 2, 128 / 63 / 2, 18 / 64 / 4, 36 / 65 / 2, 194 / 66 / 2, 145 / 67 / 2, 195 / 68 / 2, 122 / 69 / 2, 73 / 70 / 2, 160 / 71 / 4, 140 / 72 / 2, 166 / 73 / 2, 119 / 74 / 2, 235 / 75 / 2, 27 / 76 / 2, 77 / 77 / 3, 148 / 78 / 2, 105 / 79 / 2, 214 / 80 / 4, 31 / 81 / 2, 70 / 82 / 2, 43 / 83 / 3, 191 / 84 / 2, 173 / 85 / 2, 60 / 86 / 2, 241 / 87 / 3, 29 / 88 / 2, 17 / 89 / 3, 217 / 90 / 2, 123 / 91 / 2, 185 / 92 / 5, 79 / 93 / 2, 117 / 94 / 2, 116 / 95 / 2, 26 / 96 / 2, 157 / 97 / 4, 72 / 98 / 2, 190 / 99 / 2, 95 / 100 / 3, 242 / 101 / 2, 1 / 102 / 5, 228 / 103 / 2, 230 / 104 / 2, 112 / 105 / 2, 211 / 106 / 2, 39 / 107 / 2, 164 / 108 / 2, 13 / 109 / 2, 113 / 110 / 3, 199 / 111 / 2, 109 / 112 / 2, 202 / 113 / 2, 210 / 114 / 2, 155 / 115 / 3, 6 / 116 / 2, 5 / 117 / 2, 63 / 118 / 4, 183 / 121 / 3, 189 / 122 / 2, 10 / 123 / 3, 89 / 124 / 2, 54 / 125 / 2, 231 / 126 / 3, 223 / 127 / 2, 152 / 128 / 2, 218 / 129 / 2, 74 / 130 / 2, 81 / 131 / 2, 25 / 132 / 2, 158 / 133 / 2, 200 / 134 / 3, 159 / 136 / 2, 106 / 137 / 2, 53 / 138 / 2, 45 / 139 / 3, 136 / 140 / 2, 94 / 141 / 2, 167 / 142 / 3, 103 / 143 / 2, 162 / 144 / 2, 99 / 145 / 2, 213 / 146 / 2, 182 / 147 / 3, 114 / 148 / 2, 206 / 149 / 2, 98 / 150 / 3, 239 / 151 / 2, 83 / 152 / 2, 34 / 153 / 2, 229 / 154 / 4, 86 / 155 / 2, 147 / 156 / 2, 240 / 157 / 3, 129 / 158 / 2, 141 / 159 / 3, 209 / 160 / 2, 208 / 161 / 2, 180 / 162 / 4, 108 / 163 / 2, 76 / 164 / 2, 46 / 165 / 2, 186 / 166 / 4, 137 / 167 / 2, 107 / 168 / 2, 14 / 169 / 3, 175 / 170 / 2, 234 / 171 / 3, 130 / 172 / 2, 187 / 173 / 2, 61 / 174 / 2, 226 / 175 / 4, 238 / 176 / 2, 197 / 177 / 2, 176 / 178 / 3, 126 / 179 / 2, 97 / 180 / 2, 7 / 181 / 2, 134 / 182 / 2, 22 / 183 / 2, 150 / 184 / 2, 35 / 185 / 6, 227 / 186 / 2, 85 / 187 / 3, 174 / 188 / 2, 80 / 189 / 2, 151 / 190 / 2, 207 / 191 / 2, 205 / 192 / 2, 59 / 193 / 2, 91 / 194 / 2, 169 / 195 / 2, 127 / 196 / 2, 144 / 197 / 2, 168 / 198 / 3, 37 / 199 / 2, 163 / 200 / 4, 156 / 201 / 2, 65 / 202 / 2, 165 / 203 / 3, 222 / 204 / 2, 71 / 205 / 2, 233 / 206 / 2, 181 / 207 / 2, 57 / 208 / 3, 201 / 209 / 2, 246 / 210 / 3, 32 / 211 / 2, 120 / 212 / 3, 216 / 213 / 2, 75 / 214 / 2, 15 / 215 / 2, 90 / 216 / 2, 51 / 217 / 2, 232 / 219 / 2, 21 / 220 / 4, 142 / 221 / 2, 92 / 222 / 2, 69 / 223 / 4, 161 / 224 / 2, 19 / 225 / 2, 33 / 226 / 2, 143 / 227 / 2, 204 / 228 / 2, 124 / 229 / 3, 247 / 230 / 2, 56 / 231 / 2, 225 / 232 / 4, 118 / 233 / 2, 30 / 234 / 2, 132 / 235 / 4, 146 / 236 / 2, 49 / 237 / 3, 20 / 238 / 2, 40 / 239 / 2, 11 / 240 / 3, 188 / 241 / 2, 3 / 242 / 2, 171 / 243 / 2, 245 / 244 / 3, 50 / 245 / 2, 52 / 246 / 2, 154 / 247 / 2, 135 / 248 / 2, 47 / 249 / 11
uniform-alpha_1-10-n5.txt, 1, 1, 5, 319.233, 19, 14, 4, 4,2 / 1 / 3, 3 / 2 / 2, 4 / 3 / 2, 1 / 4 / 4
uniform-alpha_1-10-n500.txt, 1, 1, 500, 1760.91, 3510, 3010, 6, 459,226 / 1 / 2, 302 / 2 / 4, 85 / 3 / 2, 283 / 5 / 4, 29 / 6 / 2, 110 / 7 / 3, 22 / 8 / 2, 133 / 9 / 2, 498 / 10 / 2, 478 / 11 / 4, 341 / 12 / 2, 435 / 14 / 2, 465 / 15 / 2, 121 / 16 / 3, 482 / 17 / 2, 176 / 18 / 2, 364 / 19 / 3, 238 / 20 / 2, 61 / 21 / 3, 103 / 22 / 2, 79 / 23 / 3, 279 / 24 / 2, 97 / 25 / 3, 438 / 26 / 2, 95 / 27 / 2, 331 / 28 / 5, 80 / 29 / 2, 45 / 30 / 3, 276 / 31 / 2, 221 / 32 / 5, 130 / 33 / 2, 209 / 34 / 2, 53 / 35 / 2, 225 / 36 / 3, 429 / 37 / 2, 447 / 38 / 2, 308 / 39 / 3, 346 / 42 / 3, 37 / 43 / 2, 475 / 44 / 3, 312 / 45 / 2, 105 / 46 / 3, 415 / 47 / 2, 109 / 48 / 2, 455 / 49 / 2, 310 / 50 / 2, 332 / 51 / 2, 49 / 53 / 3, 148 / 54 / 2, 107 / 55 / 2, 330 / 56 / 5, 497 / 57 / 2, 15 / 58 / 3, 11 / 59 / 2, 266 / 60 / 5, 461 / 61 / 2, 479 / 62 / 2, 398 / 63 / 2, 132 / 64 / 2, 14 / 65 / 2, 337 / 66 / 4, 389 / 67 / 2, 256 / 68 / 2, 399 / 69 / 3, 202 / 70 / 2, 155 / 71 / 2, 89 / 72 / 2, 144 / 73 / 2, 410 / 74 / 2, 390 / 75 / 4, 233 / 76 / 2, 267 / 77 / 2, 218 / 78 / 2, 168 / 79 / 2, 285 / 80 / 3, 292 / 81 / 2, 24 / 82 / 2, 348 / 83 / 2, 222 / 84 / 2, 232 / 86 / 2, 43 / 87 / 3, 417 / 88 / 2, 384 / 89 / 2, 273 / 90 / 2, 387 / 91 / 2, 54 / 92 / 2, 199 / 93 / 2, 480 / 94 / 2, 468 / 95 / 3, 290 / 96 / 2, 177 / 97 / 2, 172 / 98 / 2, 57 / 99 / 2, 404 / 100 / 2, 17 / 101 / 3, 373 / 102 / 2, 21 / 103 / 2, 419 / 104 / 2, 448 / 105 / 2, 488 / 106 / 4, 445 / 107 / 2, 402 / 108 / 2, 372 / 109 / 3, 120 / 110 / 2, 411 / 111 / 2, 247 / 112 / 2, 111 / 113 / 3, 178 / 114 / 2, 246 / 115 / 3, 193 / 116 / 2, 239 / 117 / 2, 459 / 119 / 2, 451 / 120 / 3, 143 / 121 / 2, 375 / 122 / 2, 426 / 123 / 4, 167 / 124 / 2, 458 / 125 / 2, 170 / 126 / 4, 472 / 127 / 2, 339 / 128 / 2, 229 / 129 / 2, 166 / 130 / 3, 156 / 131 / 2, 13 / 132 / 3, 288 / 133 / 2, 370 / 134 / 3, 126 / 135 / 2, 423 / 136 / 2, 315 / 137 / 2, 8 / 138 / 3, 452 / 139 / 2, 25 / 140 / 3, 1 / 141 / 2, 231 / 144 / 6, 347 / 147 / 3, 131 / 148 / 2, 58 / 149 / 3, 382 / 150 / 2, 301 / 151 / 2, 362 / 152 / 4, 481 / 153 / 2, 83 / 154 / 2, 319 / 155 / 2, 367 / 156 / 2, 326 / 157 / 2, 316 / 158 / 4, 92 / 159 / 2, 27 / 160 / 2, 48 / 161 / 2, 376 / 162 / 2, 115 / 163 / 4, 490 / 164 / 2, 300 / 165 / 2, 240 / 166 / 4, 108 / 167 / 2, 271 / 168 / 2, 93 / 169 / 2, 113 / 170 / 2, 18 / 171 / 3, 289 / 172 / 2, 161 / 173 / 2, 403 / 174 / 2, 485 / 175 / 3, 117 / 177 / 3, 352 / 178 / 2, 106 / 179 / 2, 153 / 180 / 3, 450 / 181 / 2, 305 / 182 / 2, 219 / 183 / 5, 194 / 184 / 2, 356 / 185 / 3, 169 / 186 / 2, 418 / 187 / 2, 471 / 188 / 2, 31 / 189 / 2, 68 / 190 / 2, 88 / 191 / 2, 145 / 192 / 2, 434 / 193 / 2, 338 / 194 / 2, 483 / 195 / 3, 114 / 196 / 2, 224 / 197 / 2, 349 / 198 / 2, 486 / 199 / 4, 227 / 200 / 2, 142 / 201 / 2, 354 / 202 / 4, 55 / 203 / 2, 353 / 204 / 2, 383 / 205 / 2, 39 / 206 / 2, 408 / 207 / 2, 251 / 208 / 2, 263 / 209 / 5, 204 / 210 / 2, 40 / 211 / 3, 262 / 212 / 2, 252 / 213 / 3, 269 / 214 / 2, 198 / 215 / 2, 94 / 216 / 2, 320 / 217 / 2, 291 / 218 / 4, 138 / 219 / 2, 365 / 220 / 2, 136 / 221 / 3, 210 / 222 / 2, 137 / 223 / 3, 437 / 224 / 2, 50 / 225 / 2, 427 / 226 / 2, 116 / 227 / 2, 72 / 228 / 3, 439 / 229 / 2, 494 / 230 / 2, 151 / 231 / 4, 374 / 232 / 2, 118 / 233 / 2, 368 / 234 / 2, 26 / 235 / 2, 123 / 236 / 2, 392 / 237 / 3, 119 / 238 / 2, 400 / 239 / 2, 416 / 240 / 2, 64 / 241 / 2, 141 / 242 / 2, 379 / 243 / 2, 406 / 244 / 4, 16 / 245 / 2, 329 / 246 / 2, 324 / 247 / 4, 272 / 248 / 2, 70 / 250 / 2, 182 / 251 / 2, 284 / 252 / 2, 363 / 253 / 2, 385 / 254 / 2, 19 / 255 / 2, 405 / 256 / 2, 327 / 257 / 5, 152 / 258 / 2, 32 / 259 / 2, 9 / 260 / 3, 474 / 261 / 2, 258 / 262 / 2, 38 / 263 / 2, 296 / 264 / 2, 414 / 265 / 2, 287 / 266 / 2, 293 / 267 / 2, 206 / 268 / 2, 265 / 269 / 2, 453 / 270 / 3, 96 / 271 / 2, 449 / 272 / 2, 213 / 273 / 3, 51 / 274 / 2, 196 / 275 / 2, 260 / 276 / 3, 185 / 277 / 2, 428 / 278 / 3, 422 / 279 / 2, 207 / 280 / 3, 313 / 281 / 2, 361 / 282 / 2, 101 / 283 / 2, 189 / 284 / 2, 430 / 285 / 4, 56 / 286 / 2, 249 / 287 / 2, 493 / 288 / 2, 140 / 289 / 3, 173 / 292 / 3, 295 / 293 / 2, 245 / 294 / 3, 175 / 295 / 2, 357 / 296 / 3, 397 / 297 / 2, 274 / 298 / 3, 473 / 299 / 2, 325 / 300 / 2, 393 / 301 / 2, 492 / 302 / 4, 104 / 303 / 2, 303 / 304 / 2, 237 / 305 / 3, 171 / 306 / 2, 264 / 308 / 3, 125 / 310 / 3, 243 / 311 / 2, 322 / 312 / 3, 446 / 313 / 2, 286 / 314 / 3, 282 / 315 / 2, 36 / 316 / 2, 75 / 317 / 3, 444 / 318 / 2, 336 / 319 / 2, 409 / 320 / 2, 318 / 321 / 2, 59 / 322 / 3, 129 / 323 / 2, 216 / 324 / 2, 469 / 325 / 2, 12 / 326 / 2, 73 / 327 / 3, 333 / 328 / 2, 67 / 329 / 2, 351 / 330 / 4, 10 / 331 / 2, 491 / 332 / 2, 443 / 333 / 5, 179 / 334 / 2, 407 / 336 / 3, 359 / 337 / 2, 328 / 338 / 2, 112 / 339 / 3, 81 / 340 / 2, 5 / 341 / 3, 160 / 342 / 2, 159 / 343 / 3, 128 / 344 / 2, 4 / 345 / 2, 334 / 346 / 2, 208 / 347 / 2, 394 / 348 / 6, 230 / 351 / 4, 41 / 352 / 2, 154 / 353 / 2, 345 / 354 / 3, 60 / 355 / 2, 466 / 356 / 3, 98 / 357 / 2, 495 / 358 / 3, 200 / 360 / 2, 304 / 361 / 4, 228 / 363 / 2, 268 / 364 / 3, 44 / 365 / 2, 261 / 366 / 3, 360 / 367 / 2, 369 / 368 / 2, 311 / 369 / 2, 223 / 370 / 5, 186 / 371 / 2, 441 / 372 / 3, 317 / 373 / 2, 76 / 374 / 2, 63 / 375 / 2, 391 / 376 / 2, 323 / 377 / 2, 432 / 378 / 3, 183 / 379 / 2, 146 / 380 / 2, 460 / 381 / 4, 74 / 382 / 2, 381 / 383 / 3, 454 / 384 / 2, 431 / 385 / 3, 163 / 386 / 2, 164 / 387 / 5, 235 / 390 / 3, 217 / 391 / 2, 270 / 392 / 2, 47 / 393 / 3, 234 / 394 / 2, 205 / 395 / 2, 147 / 396 / 2, 187 / 397 / 2, 33 / 398 / 2, 340 / 399 / 2, 188 / 400 / 3, 412 / 401 / 2, 499 / 402 / 2, 314 / 403 / 3, 191 / 404 / 2, 421 / 405 / 2, 236 / 406 / 2, 20 / 407 / 3, 280 / 408 / 2, 134 / 409 / 2, 355 / 410 / 2, 436 / 411 / 2, 90 / 412 / 3, 496 / 414 / 3, 158 / 418 / 3, 386 / 419 / 2, 464 / 420 / 3, 65 / 421 / 2, 71 / 422 / 3, 174 / 424 / 3, 377 / 425 / 2, 124 / 426 / 4, 343 / 427 / 2, 388 / 428 / 2, 66 / 429 / 4, 248 / 430 / 2, 424 / 431 / 2, 2 / 432 / 4, 78 / 433 / 2, 281 / 434 / 2, 122 / 435 / 2, 192 / 436 / 2, 477 / 437 / 2, 30 / 438 / 2, 275 / 440 / 5, 396 / 441 / 2, 255 / 442 / 2, 82 / 443 / 2, 350 / 444 / 3, 321 / 445 / 2, 165 / 446 / 2, 197 / 447 / 2, 150 / 448 / 2, 278 / 449 / 3, 162 / 450 / 2, 7 / 451 / 2, 442 / 452 / 2, 87 / 453 / 2, 211 / 454 / 2, 277 / 455 / 2, 463 / 456 / 2, 181 / 457 / 2, 6 / 458 / 3, 77 / 459 / 2, 84 / 460 / 2, 489 / 461 / 2, 378 / 462 / 2, 244 / 464 / 4, 294 / 465 / 2, 3 / 466 / 2, 380 / 467 / 4, 62 / 468 / 2, 100 / 470 / 2, 157 / 471 / 2, 484 / 472 / 2, 201 / 473 / 2, 440 / 474 / 3, 371 / 475 / 2, 180 / 477 / 3, 28 / 478 / 2, 259 / 479 / 2, 487 / 480 / 3, 23 / 481 / 2, 203 / 482 / 4, 215 / 483 / 2, 467 / 484 / 2, 253 / 485 / 2, 476 / 488 / 2, 425 / 489 / 4, 307 / 493 / 3, 220 / 494 / 2, 35 / 495 / 3, 52 / 498 / 2, 306 / 499 / 4
uniform-alpha_1-100-n100.txt, 1, 1, 100, 823.479, 680, 580, 4, 98,18 / 1 / 3, 66 / 2 / 2, 27 / 3 / 2, 57 / 4 / 2, 94 / 5 / 2, 21 / 6 / 2, 56 / 7 / 2, 76 / 8 / 2, 69 / 9 / 2, 61 / 10 / 2, 5 / 11 / 2, 6 / 12 / 2, 9 / 13 / 3, 77 / 14 / 2, 2 / 15 / 3, 42 / 16 / 2, 88 / 17 / 3, 92 / 18 / 2, 28 / 19 / 2, 30 / 20 / 2, 87 / 21 / 2, 91 / 22 / 2, 20 / 23 / 2, 16 / 24 / 2, 35 / 25 / 2, 67 / 26 / 2, 3 / 27 / 2, 51 / 28 / 2, 52 / 29 / 3, 34 / 30 / 2, 13 / 31 / 2, 71 / 32 / 3, 33 / 33 / 2, 98 / 34 / 3, 29 / 35 / 2, 70 / 36 / 3, 59 / 37 / 2, 81 / 38 / 3, 38 / 39 / 2, 15 / 40 / 3, 90 / 41 / 2, 36 / 42 / 4, 65 / 43 / 2, 45 / 44 / 2, 41 / 45 / 2, 4 / 46 / 2, 58 / 47 / 4, 95 / 48 / 2, 31 / 49 / 3, 40 / 50 / 2, 89 / 51 / 3, 48 / 52 / 2, 43 / 53 / 3, 12 / 54 / 2, 73 / 55 / 3, 75 / 56 / 2, 50 / 57 / 2, 53 / 58 / 4, 85 / 59 / 2, 55 / 60 / 2, 99 / 61 / 2, 32 / 62 / 2, 7 / 63 / 2, 47 / 64 / 3, 97 / 65 / 2, 10 / 66 / 2, 84 / 67 / 3, 23 / 68 / 2, 79 / 69 / 4, 74 / 71 / 2, 25 / 72 / 4, 26 / 73 / 2, 54 / 74 / 2, 78 / 75 / 2, 62 / 76 / 2, 19 / 77 / 2, 17 / 78 / 3, 8 / 79 / 2, 1 / 80 / 3, 72 / 81 / 2, 14 / 82 / 2, 96 / 83 / 3, 44 / 84 / 2, 93 / 85 / 3, 68 / 86 / 2, 39 / 87 / 3, 37 / 88 / 2, 49 / 89 / 3, 86 / 90 / 2, 64 / 91 / 2, 83 / 92 / 4, 11 / 93 / 2, 80 / 94 / 2, 60 / 95 / 3, 46 / 96 / 2, 63 / 97 / 2, 22 / 98 / 2, 24 / 99 / 2
uniform-alpha_1-101-n175.txt, 1, 1, 175, 1130.34, 1321, 1146, 6, 171,149 / 1 / 2, 71 / 2 / 2, 9 / 3 / 4, 168 / 4 / 2, 3 / 5 / 2, 140 / 6 / 2, 75 / 7 / 3, 73 / 8 / 2, 38 / 9 / 3, 43 / 10 / 2, 35 / 11 / 2, 25 / 12 / 2, 34 / 13 / 4, 142 / 14 / 2, 124 / 15 / 2, 162 / 16 / 3, 19 / 17 / 2, 150 / 18 / 2, 61 / 19 / 2, 16 / 20 / 2, 31 / 21 / 3, 167 / 22 / 2, 42 / 23 / 2, 53 / 24 / 2, 126 / 25 / 2, 129 / 26 / 3, 106 / 27 / 2, 122 / 28 / 3, 143 / 29 / 2, 18 / 30 / 3, 24 / 31 / 2, 119 / 32 / 2, 120 / 33 / 2, 58 / 34 / 2, 116 / 35 / 4, 127 / 36 / 2, 67 / 37 / 2, 41 / 38 / 2, 163 / 39 / 3, 151 / 40 / 2, 96 / 41 / 2, 63 / 42 / 2, 133 / 43 / 2, 164 / 44 / 3, 118 / 45 / 2, 137 / 46 / 3, 29 / 47 / 2, 5 / 48 / 2, 79 / 49 / 2, 66 / 50 / 2, 103 / 51 / 4, 36 / 52 / 2, 104 / 53 / 2, 23 / 54 / 3, 148 / 55 / 2, 32 / 56 / 2, 125 / 57 / 3, 174 / 58 / 2, 80 / 59 / 2, 85 / 60 / 2, 83 / 61 / 2, 49 / 62 / 2, 98 / 63 / 2, 82 / 64 / 4, 131 / 65 / 2, 141 / 66 / 2, 54 / 67 / 3, 37 / 68 / 2, 135 / 69 / 2, 154 / 70 / 3, 47 / 71 / 2, 46 / 72 / 2, 93 / 73 / 2, 138 / 74 / 3, 15 / 75 / 2, 159 / 76 / 3, 2 / 77 / 2, 95 / 78 / 2, 110 / 79 / 2, 166 / 80 / 4, 39 / 81 / 2, 108 / 82 / 2, 70 / 83 / 3, 10 / 84 / 2, 30 / 85 / 2, 147 / 86 / 2, 145 / 87 / 2, 97 / 88 / 2, 17 / 89 / 3, 89 / 90 / 2, 11 / 93 / 3, 78 / 94 / 2, 165 / 95 / 3, 84 / 96 / 2, 55 / 97 / 3, 50 / 98 / 2, 7 / 99 / 3, 59 / 100 / 2, 87 / 101 / 2, 12 / 102 / 6, 26 / 103 / 2, 77 / 104 / 2, 100 / 105 / 2, 68 / 106 / 2, 114 / 107 / 2, 94 / 108 / 5, 123 / 109 / 2, 90 / 110 / 2, 144 / 111 / 2, 136 / 112 / 5, 132 / 113 / 2, 92 / 114 / 2, 115 / 115 / 3, 60 / 116 / 2, 105 / 117 / 2, 65 / 118 / 2, 56 / 119 / 2, 112 / 120 / 2, 52 / 121 / 3, 91 / 122 / 2, 6 / 123 / 2, 51 / 124 / 2, 161 / 125 / 4, 171 / 126 / 2, 72 / 127 / 3, 62 / 128 / 2, 1 / 129 / 3, 172 / 130 / 2, 153 / 131 / 4, 76 / 132 / 2, 57 / 133 / 2, 160 / 134 / 2, 117 / 135 / 2, 107 / 136 / 2, 44 / 137 / 2, 20 / 138 / 2, 169 / 139 / 2, 8 / 140 / 2, 170 / 141 / 3, 74 / 142 / 2, 102 / 143 / 3, 81 / 144 / 2, 99 / 145 / 2, 48 / 146 / 4, 22 / 147 / 2, 173 / 148 / 2, 113 / 149 / 3, 101 / 150 / 2, 121 / 151 / 2, 157 / 152 / 2, 28 / 153 / 3, 146 / 154 / 2, 134 / 155 / 3, 33 / 157 / 2, 155 / 158 / 4, 128 / 159 / 2, 88 / 160 / 2, 109 / 161 / 2, 45 / 162 / 3, 156 / 163 / 2, 4 / 164 / 6, 86 / 165 / 2, 130 / 166 / 2, 139 / 167 / 3, 21 / 168 / 2, 152 / 169 / 2, 13 / 170 / 4, 64 / 171 / 2, 14 / 172 / 2, 111 / 173 / 2, 40 / 174 / 5
uniform-alpha_1-102-n175.txt, 1, 1, 175, 1050.31, 1270, 1095, 5, 165,5 / 1 / 2, 132 / 2 / 3, 61 / 3 / 2, 4 / 4 / 2, 8 / 5 / 3, 24 / 7 / 4, 86 / 8 / 2, 13 / 9 / 2, 55 / 10 / 3, 116 / 11 / 2, 138 / 12 / 3, 145 / 13 / 2, 117 / 14 / 2, 109 / 15 / 3, 151 / 16 / 2, 128 / 17 / 4, 27 / 18 / 2, 58 / 19 / 3, 110 / 20 / 2, 98 / 21 / 2, 26 / 22 / 2, 75 / 23 / 3, 62 / 24 / 2, 130 / 25 / 2, 36 / 26 / 2, 78 / 27 / 2, 85 / 28 / 2, 39 / 29 / 3, 164 / 30 / 2, 68 / 31 / 2, 91 / 32 / 4, 41 / 33 / 2, 126 / 34 / 2, 119 / 35 / 3, 101 / 36 / 2, 10 / 37 / 3, 120 / 38 / 2, 72 / 39 / 3, 76 / 40 / 2, 71 / 42 / 4, 149 / 43 / 2, 96 / 44 / 2, 161 / 45 / 4, 50 / 46 / 2, 154 / 48 / 2, 148 / 49 / 3, 23 / 50 / 2, 21 / 51 / 2, 173 / 52 / 3, 3 / 53 / 2, 38 / 54 / 2, 14 / 55 / 4, 115 / 58 / 4, 159 / 59 / 2, 20 / 60 / 2, 100 / 61 / 2, 166 / 62 / 2, 1 / 63 / 2, 134 / 64 / 2, 33 / 65 / 2, 17 / 66 / 2, 7 / 67 / 4, 15 / 68 / 2, 43 / 69 / 2, 105 / 70 / 2, 150 / 71 / 2, 142 / 72 / 2, 53 / 73 / 2, 49 / 74 / 2, 163 / 75 / 4, 158 / 76 / 2, 47 / 77 / 2, 51 / 78 / 3, 144 / 79 / 2, 107 / 80 / 2, 45 / 81 / 3, 153 / 82 / 2, 52 / 83 / 2, 157 / 84 / 4, 152 / 85 / 2, 16 / 86 / 2, 97 / 87 / 3, 103 / 88 / 2, 92 / 89 / 2, 18 / 90 / 2, 70 / 91 / 3, 66 / 92 / 2, 9 / 93 / 3, 90 / 94 / 2, 135 / 95 / 2, 35 / 96 / 2, 79 / 97 / 2, 32 / 98 / 2, 6 / 99 / 2, 69 / 100 / 3, 156 / 101 / 2, 73 / 102 / 2, 63 / 103 / 2, 74 / 104 / 3, 137 / 105 / 2, 28 / 106 / 2, 165 / 107 / 2, 11 / 108 / 2, 170 / 109 / 2, 65 / 110 / 4, 136 / 111 / 2, 44 / 112 / 2, 146 / 113 / 2, 140 / 114 / 2, 172 / 115 / 2, 87 / 116 / 2, 169 / 117 / 3, 19 / 118 / 2, 48 / 119 / 4, 112 / 120 / 2, 42 / 121 / 2, 114 / 122 / 4, 29 / 123 / 2, 147 / 124 / 2, 46 / 125 / 3, 81 / 126 / 2, 22 / 127 / 4, 95 / 128 / 2, 88 / 130 / 2, 143 / 131 / 4, 118 / 132 / 2, 94 / 133 / 2, 113 / 135 / 2, 59 / 136 / 4, 122 / 137 / 2, 31 / 138 / 2, 167 / 139 / 2, 102 / 140 / 2, 125 / 141 / 2, 139 / 142 / 2, 93 / 143 / 5, 133 / 146 / 2, 124 / 147 / 3, 162 / 148 / 2, 171 / 149 / 2, 141 / 150 / 2, 111 / 151 / 4, 174 / 152 / 2, 60 / 153 / 2, 108 / 154 / 3, 155 / 155 / 2, 80 / 156 / 2, 34 / 157 / 5, 168 / 158 / 2, 12 / 159 / 3, 56 / 160 / 2, 160 / 161 / 4, 25 / 162 / 2, 123 / 163 / 2, 131 / 164 / 2, 106 / 165 / 2, 121 / 166 / 3, 2 / 167 / 2, 64 / 168 / 3, 89 / 169 / 2, 82 / 170 / 2, 84 / 171 / 3, 54 / 172 / 2, 104 / 173 / 2, 67 / 174 / 4
uniform-alpha_1-103-n175.txt, 1, 1, 175, 1021.91, 1293, 1118, 5, 170,6 / 1 / 3, 67 / 2 / 2, 93 / 3 / 2, 95 / 4 / 4, 128 / 5 / 2, 162 / 6 / 2, 160 / 7 / 3, 40 / 8 / 2, 149 / 9 / 2, 85 / 10 / 3, 123 / 11 / 2, 145 / 12 / 3, 78 / 13 / 2, 154 / 14 / 2, 61 / 15 / 2, 48 / 16 / 2, 131 / 17 / 2, 22 / 18 / 2, 100 / 19 / 4, 43 / 20 / 2, 26 / 21 / 2, 20 / 22 / 2, 143 / 23 / 2, 167 / 24 / 2, 164 / 25 / 2, 15 / 26 / 3, 86 / 29 / 3, 34 / 30 / 2, 54 / 31 / 5, 68 / 32 / 2, 47 / 33 / 2, 150 / 34 / 2, 2 / 35 / 4, 53 / 36 / 2, 110 / 37 / 2, 168 / 38 / 3, 9 / 39 / 2, 79 / 40 / 2, 55 / 41 / 3, 11 / 42 / 2, 94 / 43 / 2, 4 / 44 / 2, 151 / 45 / 2, 119 / 46 / 2, 33 / 47 / 2, 44 / 48 / 2, 152 / 49 / 2, 8 / 50 / 2, 62 / 51 / 5, 45 / 52 / 2, 129 / 53 / 2, 82 / 54 / 3, 108 / 55 / 2, 88 / 56 / 3, 83 / 57 / 2, 144 / 58 / 2, 31 / 59 / 3, 98 / 60 / 2, 147 / 61 / 5, 84 / 62 / 2, 130 / 63 / 3, 14 / 64 / 2, 32 / 65 / 2, 156 / 66 / 3, 30 / 67 / 2, 172 / 68 / 2, 113 / 69 / 2, 120 / 70 / 4, 135 / 71 / 2, 21 / 72 / 2, 148 / 73 / 2, 65 / 74 / 3, 72 / 75 / 2, 52 / 76 / 4, 49 / 77 / 2, 3 / 78 / 2, 136 / 79 / 2, 97 / 80 / 2, 35 / 81 / 5, 90 / 82 / 2, 50 / 83 / 2, 69 / 84 / 2, 165 / 85 / 2, 38 / 86 / 3, 118 / 87 / 2, 101 / 88 / 3, 106 / 89 / 2, 74 / 90 / 2, 126 / 91 / 2, 140 / 92 / 3, 99 / 93 / 2, 124 / 94 / 2, 66 / 95 / 2, 170 / 96 / 2, 23 / 97 / 2, 111 / 98 / 2, 133 / 99 / 2, 27 / 100 / 2, 56 / 101 / 3, 157 / 102 / 2, 115 / 103 / 3, 169 / 104 / 2, 10 / 105 / 2, 127 / 106 / 3, 57 / 107 / 2, 91 / 108 / 2, 13 / 109 / 2, 159 / 110 / 2, 63 / 111 / 2, 171 / 112 / 3, 116 / 113 / 2, 139 / 114 / 2, 5 / 115 / 2, 114 / 116 / 3, 141 / 117 / 2, 163 / 118 / 2, 142 / 119 / 3, 7 / 120 / 2, 105 / 121 / 3, 59 / 123 / 4, 25 / 124 / 2, 87 / 125 / 2, 92 / 126 / 2, 174 / 127 / 5, 158 / 128 / 2, 19 / 129 / 2, 153 / 130 / 2, 77 / 131 / 2, 36 / 132 / 3, 125 / 133 / 2, 138 / 134 / 3, 121 / 135 / 2, 51 / 136 / 2, 132 / 137 / 3, 42 / 138 / 2, 24 / 139 / 2, 146 / 140 / 2, 12 / 141 / 4, 117 / 142 / 2, 155 / 143 / 2, 37 / 144 / 4, 17 / 146 / 2, 103 / 147 / 2, 161 / 148 / 4, 137 / 149 / 2, 112 / 150 / 2, 71 / 151 / 4, 41 / 152 / 2, 96 / 153 / 2, 134 / 154 / 2, 80 / 155 / 2, 109 / 156 / 3, 122 / 157 / 2, 73 / 158 / 2, 102 / 159 / 2, 16 / 160 / 3, 64 / 161 / 2, 39 / 162 / 3, 29 / 163 / 2, 1 / 164 / 2, 173 / 165 / 3, 28 / 166 / 2, 107 / 167 / 2, 76 / 168 / 2, 70 / 169 / 2, 89 / 170 / 2, 60 / 171 / 3, 75 / 172 / 2, 46 / 173 / 2, 58 / 174 / 2
uniform-alpha_1-104-n175.txt, 1, 1, 175, 1144.88, 1236, 1061, 6, 169,135 / 1 / 2, 141 / 2 / 5, 111 / 3 / 2, 153 / 4 / 3, 120 / 5 / 2, 155 / 6 / 2, 160 / 7 / 2, 27 / 8 / 2, 156 / 9 / 2, 76 / 10 / 4, 151 / 11 / 2, 94 / 12 / 2, 62 / 13 / 2, 116 / 14 / 2, 56 / 15 / 2, 80 / 16 / 2, 145 / 17 / 2, 98 / 18 / 2, 92 / 19 / 3, 158 / 20 / 2, 45 / 21 / 3, 140 / 22 / 2, 85 / 24 / 2, 139 / 25 / 4, 58 / 26 / 2, 72 / 27 / 2, 146 / 28 / 3, 119 / 29 / 2, 3 / 30 / 4, 42 / 31 / 2, 38 / 32 / 2, 126 / 33 / 4, 113 / 34 / 2, 57 / 35 / 2, 127 / 36 / 3, 91 / 37 / 2, 128 / 38 / 2, 109 / 39 / 2, 132 / 40 / 4, 46 / 41 / 2, 117 / 43 / 2, 74 / 44 / 3, 134 / 45 / 2, 5 / 46 / 2, 53 / 47 / 2, 41 / 48 / 2, 172 / 49 / 3, 143 / 50 / 2, 163 / 51 / 2, 67 / 52 / 2, 105 / 53 / 2, 17 / 54 / 2, 78 / 55 / 2, 99 / 56 / 2, 16 / 57 / 2, 54 / 58 / 3, 122 / 59 / 2, 83 / 60 / 2, 87 / 61 / 3, 137 / 62 / 2, 31 / 63 / 2, 174 / 64 / 4, 95 / 65 / 2, 170 / 66 / 2, 86 / 67 / 4, 10 / 69 / 2, 24 / 70 / 2, 142 / 71 / 3, 103 / 72 / 2, 35 / 73 / 3, 6 / 74 / 2, 149 / 75 / 3, 20 / 76 / 2, 9 / 77 / 5, 97 / 78 / 2, 171 / 79 / 3, 164 / 80 / 2, 96 / 81 / 2, 147 / 82 / 2, 69 / 83 / 6, 106 / 84 / 2, 108 / 85 / 2, 167 / 86 / 2, 25 / 87 / 3, 59 / 88 / 2, 136 / 89 / 2, 101 / 90 / 2, 23 / 91 / 2, 102 / 92 / 3, 148 / 93 / 2, 48 / 94 / 3, 63 / 95 / 2, 34 / 96 / 2, 124 / 97 / 3, 71 / 98 / 2, 70 / 99 / 3, 125 / 100 / 2, 19 / 101 / 3, 55 / 102 / 2, 28 / 103 / 3, 73 / 104 / 2, 22 / 105 / 3, 75 / 106 / 2, 82 / 107 / 3, 123 / 108 / 2, 18 / 109 / 2, 12 / 110 / 4, 79 / 111 / 2, 47 / 112 / 2, 36 / 113 / 3, 112 / 114 / 2, 150 / 115 / 3, 162 / 116 / 2, 1 / 117 / 3, 93 / 118 / 2, 2 / 119 / 2, 100 / 120 / 4, 77 / 121 / 2, 43 / 122 / 2, 21 / 123 / 3, 129 / 124 / 2, 64 / 125 / 2, 138 / 126 / 2, 65 / 127 / 4, 52 / 128 / 2, 114 / 129 / 2, 90 / 130 / 4, 131 / 131 / 2, 7 / 132 / 2, 159 / 133 / 3, 161 / 134 / 2, 33 / 135 / 3, 133 / 136 / 2, 26 / 137 / 4, 81 / 138 / 2, 4 / 139 / 2, 51 / 140 / 4, 49 / 141 / 2, 32 / 142 / 2, 11 / 143 / 4, 14 / 144 / 2, 166 / 145 / 2, 8 / 146 / 2, 169 / 147 / 2, 152 / 148 / 2, 29 / 149 / 2, 157 / 150 / 3, 121 / 153 / 2, 44 / 154 / 3, 154 / 155 / 2, 60 / 156 / 3, 39 / 157 / 2, 40 / 158 / 2, 89 / 159 / 2, 61 / 160 / 2, 88 / 161 / 2, 84 / 162 / 2, 66 / 163 / 2, 168 / 164 / 4, 13 / 165 / 2, 165 / 166 / 2, 115 / 167 / 4, 173 / 168 / 2, 144 / 169 / 2, 104 / 170 / 2, 110 / 171 / 3, 15 / 172 / 2, 50 / 173 / 2, 68 / 174 / 3
uniform-alpha_1-105-n175.txt, 1, 1, 175, 1087.36, 1272, 1097, 7, 165,100 / 1 / 2, 167 / 2 / 3, 150 / 3 / 2, 20 / 4 / 3, 49 / 5 / 2, 30 / 6 / 2, 52 / 7 / 3, 149 / 8 / 2, 72 / 9 / 2, 51 / 10 / 4, 111 / 11 / 2, 143 / 12 / 2, 91 / 13 / 2, 138 / 14 / 3, 40 / 15 / 2, 135 / 16 / 2, 87 / 17 / 2, 104 / 18 / 2, 58 / 19 / 2, 148 / 20 / 3, 162 / 21 / 2, 93 / 22 / 2, 43 / 23 / 3, 79 / 24 / 2, 8 / 25 / 2, 159 / 26 / 3, 68 / 27 / 2, 171 / 28 / 6, 46 / 29 / 2, 63 / 30 / 3, 115 / 32 / 3, 151 / 33 / 2, 37 / 34 / 7, 75 / 35 / 2, 174 / 36 / 2, 88 / 37 / 2, 127 / 38 / 2, 26 / 39 / 2, 125 / 40 / 2, 120 / 41 / 2, 64 / 42 / 2, 106 / 43 / 2, 119 / 44 / 3, 156 / 47 / 2, 71 / 48 / 4, 82 / 49 / 2, 62 / 50 / 2, 66 / 51 / 3, 35 / 52 / 2, 105 / 53 / 2, 83 / 54 / 2, 145 / 55 / 2, 34 / 56 / 3, 95 / 57 / 2, 110 / 58 / 3, 103 / 59 / 2, 73 / 60 / 2, 98 / 61 / 3, 1 / 62 / 2, 39 / 63 / 3, 33 / 64 / 2, 4 / 65 / 3, 117 / 66 / 2, 128 / 67 / 3, 92 / 68 / 2, 42 / 69 / 3, 85 / 70 / 2, 70 / 71 / 2, 123 / 72 / 2, 112 / 73 / 3, 109 / 74 / 2, 14 / 75 / 3, 141 / 76 / 2, 15 / 78 / 2, 97 / 79 / 4, 78 / 80 / 2, 96 / 81 / 2, 131 / 82 / 3, 74 / 83 / 2, 3 / 84 / 3, 67 / 85 / 2, 55 / 86 / 2, 69 / 87 / 2, 166 / 88 / 3, 5 / 89 / 2, 9 / 90 / 3, 134 / 91 / 2, 76 / 92 / 2, 155 / 93 / 2, 22 / 94 / 2, 165 / 95 / 4, 94 / 96 / 2, 84 / 97 / 2, 19 / 98 / 3, 147 / 99 / 2, 99 / 100 / 2, 81 / 101 / 2, 124 / 102 / 2, 153 / 103 / 3, 170 / 104 / 2, 11 / 105 / 3, 18 / 106 / 2, 146 / 109 / 3, 107 / 110 / 2, 133 / 111 / 3, 41 / 112 / 2, 32 / 113 / 3, 173 / 114 / 2, 44 / 115 / 2, 47 / 116 / 3, 53 / 119 / 2, 29 / 120 / 2, 10 / 121 / 3, 24 / 122 / 2, 90 / 123 / 2, 38 / 124 / 4, 31 / 125 / 2, 89 / 126 / 2, 136 / 127 / 2, 2 / 128 / 2, 36 / 129 / 4, 16 / 130 / 2, 27 / 131 / 2, 102 / 132 / 4, 113 / 133 / 2, 142 / 134 / 3, 163 / 135 / 2, 77 / 136 / 2, 172 / 137 / 2, 132 / 138 / 3, 86 / 139 / 2, 114 / 140 / 3, 169 / 141 / 2, 101 / 142 / 2, 45 / 143 / 2, 158 / 144 / 2, 25 / 145 / 3, 139 / 146 / 2, 108 / 147 / 3, 126 / 148 / 2, 57 / 149 / 3, 130 / 150 / 2, 17 / 151 / 2, 61 / 152 / 2, 164 / 153 / 3, 152 / 154 / 2, 13 / 155 / 5, 59 / 156 / 2, 12 / 157 / 2, 80 / 158 / 2, 129 / 159 / 5, 60 / 160 / 2, 6 / 161 / 2, 122 / 162 / 3, 121 / 163 / 2, 118 / 164 / 2, 54 / 165 / 3, 157 / 166 / 2, 50 / 167 / 4, 168 / 169 / 2, 28 / 170 / 2, 160 / 171 / 2, 23 / 172 / 3, 144 / 173 / 2, 137 / 174 / 3
uniform-alpha_1-106-n175.txt, 1, 1, 175, 1041.38, 1227, 1052, 6, 164,163 / 1 / 2, 36 / 2 / 2, 157 / 3 / 4, 113 / 4 / 2, 37 / 5 / 2, 94 / 6 / 4, 138 / 7 / 2, 23 / 8 / 3, 117 / 9 / 2, 58 / 10 / 3, 152 / 13 / 3, 140 / 14 / 2, 125 / 15 / 2, 124 / 16 / 2, 84 / 17 / 2, 142 / 18 / 3, 171 / 19 / 2, 154 / 20 / 2, 172 / 21 / 2, 101 / 22 / 4, 100 / 23 / 2, 11 / 24 / 2, 120 / 25 / 4, 83 / 26 / 2, 108 / 27 / 2, 174 / 28 / 2, 165 / 29 / 4, 41 / 30 / 2, 62 / 31 / 2, 12 / 32 / 2, 66 / 33 / 2, 112 / 34 / 2, 110 / 35 / 3, 153 / 36 / 2, 10 / 37 / 2, 4 / 38 / 2, 151 / 39 / 2, 77 / 40 / 4, 97 / 42 / 2, 18 / 43 / 3, 116 / 45 / 3, 144 / 46 / 2, 122 / 47 / 2, 33 / 48 / 2, 133 / 49 / 2, 150 / 50 / 2, 143 / 51 / 2, 89 / 52 / 3, 79 / 53 / 2, 164 / 54 / 2, 161 / 55 / 2, 82 / 57 / 3, 25 / 58 / 2, 5 / 59 / 3, 106 / 60 / 2, 131 / 61 / 2, 156 / 62 / 3, 90 / 63 / 2, 43 / 64 / 2, 54 / 65 / 2, 132 / 66 / 2, 98 / 67 / 3, 50 / 68 / 2, 30 / 69 / 3, 45 / 70 / 2, 29 / 71 / 3, 52 / 72 / 2, 109 / 73 / 2, 114 / 74 / 3, 136 / 75 / 2, 159 / 76 / 2, 169 / 78 / 3, 105 / 79 / 2, 155 / 80 / 2, 170 / 81 / 6, 81 / 82 / 2, 26 / 83 / 3, 92 / 84 / 2, 139 / 85 / 2, 20 / 86 / 4, 168 / 87 / 2, 68 / 90 / 3, 53 / 91 / 2, 9 / 92 / 2, 73 / 93 / 3, 74 / 94 / 2, 147 / 95 / 2, 141 / 96 / 2, 135 / 97 / 2, 31 / 98 / 2, 75 / 99 / 2, 78 / 100 / 2, 1 / 101 / 2, 39 / 102 / 2, 7 / 103 / 2, 119 / 104 / 3, 38 / 105 / 2, 126 / 106 / 2, 65 / 107 / 2, 137 / 108 / 2, 72 / 109 / 3, 35 / 110 / 2, 61 / 111 / 4, 91 / 112 / 2, 167 / 113 / 3, 145 / 114 / 2, 56 / 115 / 3, 60 / 116 / 2, 3 / 117 / 3, 55 / 118 / 2, 88 / 119 / 2, 15 / 120 / 2, 2 / 121 / 2, 8 / 122 / 3, 111 / 124 / 2, 160 / 125 / 2, 123 / 126 / 3, 13 / 127 / 2, 128 / 128 / 3, 173 / 129 / 2, 71 / 130 / 2, 27 / 131 / 2, 127 / 132 / 2, 95 / 133 / 2, 129 / 134 / 2, 59 / 135 / 4, 93 / 136 / 2, 166 / 137 / 3, 103 / 138 / 2, 19 / 139 / 5, 102 / 140 / 2, 134 / 141 / 2, 87 / 142 / 2, 107 / 143 / 2, 99 / 144 / 3, 63 / 146 / 3, 130 / 147 / 2, 115 / 148 / 2, 57 / 149 / 3, 48 / 150 / 2, 69 / 151 / 4, 80 / 152 / 2, 24 / 153 / 2, 118 / 154 / 4, 148 / 155 / 2, 42 / 156 / 2, 46 / 157 / 2, 44 / 158 / 4, 85 / 159 / 2, 149 / 160 / 2, 14 / 161 / 2, 21 / 162 / 2, 162 / 163 / 3, 67 / 164 / 2, 146 / 165 / 2, 158 / 166 / 4, 17 / 167 / 2, 32 / 168 / 2, 34 / 169 / 2, 40 / 170 / 2, 16 / 171 / 2, 70 / 172 / 2, 47 / 173 / 5, 22 / 174 / 2
uniform-alpha_1-107-n175.txt, 1, 1, 175, 1043.05, 1177, 1002, 4, 172,65 / 1 / 2, 61 / 2 / 2, 1 / 3 / 2, 66 / 4 / 3, 100 / 5 / 2, 123 / 6 / 3, 13 / 7 / 2, 172 / 8 / 2, 12 / 9 / 3, 18 / 10 / 2, 130 / 11 / 3, 154 / 12 / 2, 34 / 13 / 2, 73 / 14 / 3, 171 / 15 / 2, 99 / 16 / 2, 29 / 17 / 3, 150 / 18 / 2, 82 / 19 / 3, 76 / 20 / 2, 39 / 21 / 3, 114 / 22 / 2, 70 / 23 / 2, 128 / 24 / 2, 119 / 25 / 2, 20 / 26 / 2, 27 / 27 / 4, 103 / 28 / 2, 63 / 29 / 2, 8 / 30 / 4, 156 / 32 / 3, 84 / 33 / 2, 152 / 34 / 3, 62 / 35 / 2, 9 / 36 / 2, 23 / 37 / 2, 2 / 38 / 3, 81 / 39 / 2, 140 / 40 / 2, 125 / 41 / 3, 45 / 42 / 2, 41 / 43 / 2, 95 / 44 / 2, 77 / 45 / 3, 168 / 46 / 2, 116 / 47 / 2, 4 / 48 / 3, 54 / 49 / 2, 117 / 50 / 3, 110 / 51 / 2, 92 / 52 / 3, 166 / 53 / 2, 94 / 54 / 3, 118 / 55 / 2, 87 / 56 / 2, 72 / 57 / 2, 120 / 58 / 2, 138 / 59 / 2, 165 / 60 / 2, 159 / 61 / 2, 19 / 62 / 3, 24 / 63 / 2, 46 / 64 / 2, 52 / 65 / 3, 173 / 66 / 2, 55 / 67 / 3, 17 / 68 / 2, 113 / 69 / 2, 108 / 70 / 3, 97 / 71 / 2, 112 / 72 / 3, 142 / 73 / 2, 86 / 74 / 2, 164 / 75 / 3, 144 / 76 / 2, 122 / 77 / 3, 43 / 78 / 2, 31 / 79 / 2, 83 / 80 / 2, 88 / 81 / 2, 124 / 82 / 2, 50 / 83 / 3, 79 / 84 / 2, 28 / 85 / 2, 21 / 86 / 3, 11 / 87 / 2, 167 / 88 / 3, 10 / 89 / 2, 22 / 90 / 2, 115 / 91 / 3, 64 / 92 / 2, 111 / 93 / 3, 162 / 94 / 2, 48 / 95 / 2, 59 / 96 / 3, 30 / 97 / 2, 135 / 98 / 2, 75 / 99 / 2, 85 / 100 / 2, 126 / 101 / 2, 78 / 102 / 2, 121 / 103 / 3, 60 / 104 / 2, 141 / 105 / 2, 106 / 106 / 2, 58 / 107 / 2, 74 / 108 / 3, 131 / 109 / 2, 161 / 110 / 3, 170 / 111 / 2, 6 / 112 / 2, 5 / 113 / 4, 96 / 114 / 2, 148 / 115 / 2, 157 / 116 / 2, 25 / 117 / 3, 15 / 118 / 2, 158 / 119 / 2, 132 / 120 / 2, 163 / 121 / 2, 49 / 122 / 2, 146 / 123 / 2, 32 / 124 / 2, 143 / 125 / 2, 107 / 126 / 2, 51 / 127 / 2, 44 / 128 / 3, 26 / 129 / 2, 169 / 130 / 3, 149 / 131 / 2, 89 / 132 / 2, 174 / 133 / 2, 91 / 134 / 3, 69 / 135 / 2, 71 / 136 / 3, 105 / 137 / 2, 16 / 138 / 2, 67 / 139 / 3, 36 / 140 / 2, 57 / 141 / 3, 134 / 142 / 2, 129 / 143 / 2, 47 / 144 / 2, 40 / 145 / 3, 133 / 147 / 3, 127 / 148 / 2, 151 / 149 / 3, 153 / 150 / 2, 101 / 151 / 2, 93 / 152 / 2, 104 / 153 / 2, 136 / 154 / 2, 147 / 155 / 2, 102 / 156 / 2, 145 / 157 / 2, 68 / 158 / 2, 160 / 159 / 2, 14 / 160 / 2, 155 / 161 / 2, 80 / 162 / 2, 109 / 163 / 2, 98 / 164 / 2, 37 / 165 / 2, 139 / 166 / 3, 53 / 167 / 2, 3 / 168 / 3, 137 / 169 / 2, 90 / 170 / 2, 35 / 171 / 2, 38 / 172 / 2, 56 / 173 / 2, 42 / 174 / 3
uniform-alpha_1-108-n175.txt, 1, 1, 175, 1070, 1284, 1109, 5, 172,88 / 1 / 3, 79 / 2 / 2, 59 / 3 / 5, 117 / 4 / 2, 105 / 5 / 2, 16 / 6 / 2, 51 / 7 / 2, 46 / 8 / 4, 63 / 9 / 2, 132 / 10 / 2, 19 / 11 / 2, 70 / 12 / 2, 10 / 13 / 4, 101 / 14 / 2, 28 / 15 / 2, 94 / 16 / 3, 102 / 17 / 2, 44 / 18 / 4, 153 / 19 / 2, 56 / 20 / 2, 37 / 22 / 3, 146 / 23 / 2, 36 / 24 / 2, 78 / 25 / 3, 42 / 26 / 2, 60 / 27 / 2, 98 / 28 / 2, 32 / 29 / 4, 40 / 30 / 2, 169 / 31 / 2, 110 / 32 / 3, 155 / 33 / 2, 156 / 34 / 2, 168 / 35 / 4, 82 / 36 / 2, 49 / 37 / 2, 61 / 38 / 2, 135 / 39 / 2, 164 / 40 / 3, 166 / 41 / 2, 71 / 42 / 2, 87 / 43 / 3, 66 / 44 / 2, 104 / 45 / 2, 31 / 46 / 2, 123 / 47 / 3, 8 / 48 / 2, 99 / 49 / 2, 18 / 50 / 3, 171 / 51 / 2, 75 / 53 / 2, 91 / 54 / 4, 86 / 55 / 2, 33 / 56 / 2, 38 / 57 / 2, 85 / 58 / 4, 62 / 59 / 2, 144 / 60 / 2, 29 / 61 / 4, 69 / 62 / 2, 26 / 63 / 2, 161 / 64 / 3, 4 / 65 / 2, 139 / 66 / 4, 150 / 67 / 2, 100 / 68 / 2, 7 / 69 / 2, 39 / 70 / 2, 23 / 71 / 2, 128 / 72 / 3, 113 / 73 / 2, 53 / 74 / 2, 147 / 75 / 2, 83 / 76 / 2, 14 / 77 / 2, 65 / 78 / 5, 21 / 79 / 2, 133 / 80 / 2, 84 / 81 / 3, 158 / 82 / 2, 58 / 83 / 3, 159 / 84 / 2, 45 / 85 / 3, 5 / 86 / 2, 174 / 87 / 2, 127 / 88 / 2, 143 / 89 / 3, 142 / 90 / 2, 134 / 91 / 4, 116 / 92 / 2, 106 / 93 / 2, 52 / 94 / 2, 167 / 95 / 5, 15 / 96 / 2, 149 / 97 / 3, 64 / 98 / 2, 67 / 99 / 5, 109 / 100 / 2, 55 / 101 / 2, 170 / 102 / 2, 34 / 103 / 2, 30 / 104 / 2, 9 / 105 / 2, 3 / 106 / 2, 121 / 107 / 2, 24 / 108 / 2, 72 / 109 / 2, 108 / 110 / 3, 151 / 111 / 2, 136 / 112 / 4, 137 / 113 / 2, 124 / 114 / 3, 112 / 115 / 2, 47 / 116 / 5, 11 / 117 / 2, 74 / 118 / 2, 103 / 119 / 2, 129 / 120 / 3, 50 / 121 / 2, 125 / 122 / 3, 126 / 123 / 2, 145 / 124 / 3, 154 / 125 / 2, 54 / 126 / 3, 141 / 127 / 2, 120 / 128 / 3, 41 / 129 / 2, 1 / 130 / 3, 96 / 131 / 2, 73 / 132 / 2, 81 / 133 / 3, 97 / 134 / 2, 25 / 135 / 2, 130 / 136 / 2, 111 / 137 / 2, 152 / 138 / 2, 27 / 139 / 2, 12 / 140 / 3, 35 / 141 / 2, 165 / 142 / 2, 114 / 143 / 3, 13 / 144 / 2, 115 / 145 / 3, 163 / 146 / 2, 140 / 147 / 2, 90 / 148 / 2, 76 / 149 / 2, 172 / 150 / 2, 93 / 151 / 3, 107 / 152 / 2, 131 / 153 / 3, 43 / 154 / 2, 77 / 155 / 3, 17 / 156 / 2, 22 / 157 / 3, 119 / 158 / 2, 138 / 159 / 3, 162 / 160 / 2, 148 / 161 / 3, 2 / 162 / 2, 80 / 163 / 2, 157 / 164 / 3, 173 / 165 / 2, 48 / 166 / 3, 68 / 167 / 2, 92 / 168 / 5, 118 / 169 / 2, 95 / 170 / 2, 57 / 171 / 3, 6 / 172 / 2, 160 / 173 / 3, 122 / 174 / 2
uniform-alpha_1-109-n175.txt, 1, 1, 175, 1112.05, 1186, 1011, 7, 167,17 / 1 / 7, 116 / 2 / 2, 74 / 3 / 2, 121 / 4 / 2, 54 / 5 / 3, 21 / 6 / 2, 88 / 7 / 3, 34 / 8 / 2, 76 / 9 / 2, 98 / 10 / 3, 159 / 11 / 2, 136 / 12 / 3, 151 / 13 / 2, 10 / 14 / 3, 67 / 15 / 2, 45 / 16 / 2, 129 / 17 / 2, 170 / 18 / 2, 124 / 19 / 3, 4 / 22 / 3, 60 / 23 / 2, 91 / 24 / 2, 149 / 25 / 2, 130 / 26 / 2, 92 / 27 / 2, 90 / 28 / 2, 102 / 29 / 3, 80 / 30 / 2, 112 / 31 / 3, 113 / 32 / 2, 157 / 33 / 3, 137 / 34 / 2, 57 / 35 / 2, 162 / 36 / 3, 153 / 37 / 2, 115 / 38 / 3, 36 / 41 / 2, 62 / 42 / 5, 20 / 43 / 2, 13 / 44 / 2, 37 / 45 / 2, 40 / 46 / 2, 150 / 47 / 4, 167 / 48 / 2, 25 / 49 / 2, 46 / 50 / 2, 103 / 51 / 3, 101 / 52 / 2, 27 / 53 / 2, 172 / 54 / 2, 108 / 55 / 2, 110 / 56 / 3, 147 / 57 / 2, 63 / 58 / 2, 132 / 59 / 2, 161 / 60 / 2, 111 / 61 / 2, 160 / 62 / 2, 106 / 63 / 3, 120 / 64 / 2, 82 / 65 / 3, 38 / 66 / 2, 58 / 67 / 2, 100 / 68 / 2, 109 / 69 / 2, 32 / 70 / 2, 30 / 71 / 2, 145 / 72 / 2, 138 / 73 / 2, 3 / 74 / 2, 18 / 75 / 2, 152 / 76 / 2, 96 / 77 / 2, 42 / 78 / 2, 141 / 79 / 2, 79 / 80 / 2, 8 / 81 / 2, 144 / 82 / 3, 77 / 83 / 2, 14 / 84 / 4, 29 / 85 / 2, 118 / 86 / 2, 139 / 87 / 2, 117 / 88 / 3, 24 / 89 / 2, 61 / 90 / 2, 83 / 91 / 2, 104 / 92 / 2, 68 / 93 / 2, 51 / 94 / 2, 119 / 95 / 2, 125 / 96 / 2, 75 / 97 / 2, 56 / 98 / 2, 33 / 99 / 3, 9 / 100 / 2, 148 / 101 / 3, 169 / 102 / 2, 52 / 103 / 2, 41 / 104 / 3, 95 / 105 / 2, 86 / 106 / 2, 105 / 107 / 2, 66 / 108 / 2, 154 / 109 / 3, 48 / 110 / 2, 174 / 111 / 2, 166 / 112 / 2, 123 / 113 / 4, 43 / 114 / 2, 78 / 115 / 2, 1 / 116 / 2, 84 / 117 / 2, 94 / 118 / 2, 173 / 119 / 2, 6 / 120 / 2, 72 / 121 / 2, 71 / 122 / 3, 133 / 123 / 2, 89 / 124 / 5, 97 / 125 / 2, 53 / 126 / 2, 47 / 127 / 2, 163 / 128 / 3, 142 / 129 / 2, 171 / 130 / 2, 143 / 131 / 2, 44 / 132 / 3, 99 / 133 / 2, 49 / 134 / 2, 7 / 135 / 2, 16 / 136 / 2, 164 / 137 / 2, 146 / 138 / 2, 155 / 141 / 3, 26 / 142 / 2, 81 / 143 / 3, 131 / 144 / 2, 64 / 145 / 2, 135 / 146 / 2, 12 / 147 / 2, 39 / 148 / 2, 114 / 149 / 2, 140 / 150 / 2, 69 / 151 / 3, 23 / 152 / 2, 65 / 153 / 4, 122 / 155 / 3, 22 / 156 / 2, 107 / 157 / 3, 50 / 158 / 2, 73 / 159 / 3, 28 / 160 / 2, 2 / 161 / 2, 156 / 162 / 2, 59 / 163 / 3, 11 / 164 / 2, 93 / 165 / 3, 35 / 166 / 2, 168 / 167 / 2, 55 / 168 / 2, 70 / 169 / 2, 15 / 170 / 4, 85 / 171 / 2, 128 / 172 / 3, 127 / 173 / 2, 134 / 174 / 3
uniform-alpha_1-11-n375.txt, 1, 1, 375, 1536.82, 2754, 2379, 7, 353,280 / 1 / 4, 350 / 2 / 2, 164 / 4 / 2, 372 / 5 / 3, 146 / 6 / 2, 126 / 7 / 2, 178 / 8 / 2, 369 / 9 / 3, 279 / 10 / 2, 171 / 11 / 3, 30 / 12 / 2, 347 / 14 / 2, 331 / 15 / 3, 76 / 16 / 2, 26 / 17 / 4, 96 / 18 / 2, 162 / 19 / 2, 250 / 20 / 2, 270 / 21 / 3, 251 / 24 / 2, 363 / 25 / 2, 116 / 26 / 5, 77 / 27 / 2, 54 / 28 / 2, 306 / 29 / 2, 319 / 30 / 3, 158 / 31 / 2, 284 / 32 / 2, 64 / 33 / 4, 224 / 34 / 2, 90 / 35 / 2, 172 / 36 / 2, 219 / 37 / 5, 258 / 38 / 2, 300 / 39 / 2, 298 / 40 / 4, 55 / 41 / 2, 155 / 42 / 2, 144 / 43 / 4, 103 / 44 / 2, 124 / 45 / 2, 15 / 46 / 2, 329 / 47 / 2, 349 / 48 / 4, 267 / 49 / 2, 212 / 50 / 2, 14 / 51 / 2, 238 / 52 / 2, 80 / 53 / 2, 165 / 54 / 2, 353 / 55 / 2, 316 / 56 / 2, 236 / 57 / 6, 206 / 59 / 3, 169 / 60 / 2, 101 / 61 / 3, 74 / 62 / 2, 29 / 63 / 3, 12 / 64 / 2, 71 / 65 / 2, 234 / 66 / 2, 247 / 67 / 3, 163 / 68 / 2, 18 / 69 / 3, 39 / 70 / 2, 130 / 71 / 2, 56 / 72 / 2, 22 / 73 / 2, 275 / 74 / 3, 322 / 77 / 2, 167 / 78 / 2, 45 / 79 / 2, 325 / 80 / 2, 211 / 81 / 2, 334 / 82 / 4, 292 / 83 / 2, 249 / 84 / 3, 24 / 85 / 2, 192 / 86 / 2, 23 / 87 / 3, 98 / 88 / 2, 69 / 89 / 2, 286 / 90 / 4, 7 / 91 / 2, 131 / 92 / 2, 114 / 93 / 4, 67 / 94 / 2, 282 / 95 / 2, 141 / 96 / 3, 138 / 97 / 2, 9 / 98 / 2, 244 / 99 / 4, 271 / 100 / 2, 72 / 101 / 2, 367 / 102 / 4, 214 / 103 / 2, 311 / 105 / 3, 127 / 106 / 2, 199 / 107 / 2, 110 / 108 / 2, 189 / 109 / 2, 85 / 110 / 2, 233 / 111 / 2, 160 / 113 / 4, 209 / 114 / 2, 310 / 115 / 2, 37 / 116 / 2, 184 / 117 / 4, 182 / 118 / 2, 100 / 119 / 2, 68 / 120 / 2, 42 / 121 / 2, 357 / 122 / 2, 217 / 123 / 2, 148 / 124 / 2, 170 / 125 / 2, 145 / 126 / 3, 291 / 127 / 2, 314 / 128 / 2, 60 / 129 / 2, 339 / 130 / 2, 149 / 131 / 2, 11 / 132 / 2, 198 / 133 / 3, 57 / 134 / 2, 248 / 135 / 3, 342 / 136 / 2, 221 / 138 / 3, 332 / 139 / 2, 312 / 140 / 2, 20 / 141 / 2, 105 / 142 / 3, 43 / 143 / 2, 371 / 144 / 2, 216 / 145 / 3, 47 / 146 / 2, 79 / 147 / 2, 136 / 148 / 3, 129 / 149 / 2, 65 / 150 / 2, 48 / 151 / 2, 186 / 152 / 4, 330 / 153 / 2, 296 / 154 / 2, 348 / 155 / 3, 83 / 156 / 2, 241 / 157 / 2, 82 / 158 / 3, 288 / 159 / 2, 324 / 160 / 3, 154 / 161 / 2, 262 / 162 / 2, 210 / 163 / 2, 370 / 164 / 2, 174 / 165 / 5, 13 / 168 / 3, 19 / 169 / 2, 346 / 170 / 2, 133 / 171 / 2, 157 / 172 / 3, 317 / 173 / 2, 183 / 174 / 3, 5 / 175 / 2, 305 / 176 / 3, 223 / 177 / 2, 373 / 178 / 3, 200 / 180 / 2, 201 / 181 / 3, 107 / 182 / 2, 4 / 183 / 3, 113 / 184 / 2, 194 / 185 / 2, 226 / 186 / 2, 32 / 187 / 2, 208 / 188 / 3, 301 / 189 / 2, 257 / 190 / 2, 344 / 191 / 3, 239 / 192 / 2, 88 / 193 / 3, 40 / 194 / 2, 326 / 195 / 2, 321 / 196 / 2, 177 / 197 / 2, 253 / 198 / 3, 343 / 199 / 2, 274 / 200 / 2, 168 / 201 / 3, 269 / 202 / 2, 225 / 203 / 2, 63 / 204 / 2, 53 / 205 / 3, 285 / 206 / 2, 308 / 207 / 3, 41 / 208 / 2, 366 / 209 / 2, 44 / 210 / 2, 266 / 211 / 3, 218 / 212 / 2, 59 / 213 / 3, 213 / 214 / 2, 340 / 215 / 3, 202 / 216 / 2, 1 / 217 / 3, 35 / 218 / 2, 197 / 219 / 2, 8 / 220 / 3, 135 / 221 / 2, 78 / 222 / 2, 86 / 223 / 2, 293 / 224 / 2, 365 / 225 / 5, 58 / 226 / 2, 359 / 227 / 2, 323 / 228 / 2, 38 / 229 / 2, 309 / 230 / 2, 111 / 231 / 2, 152 / 232 / 2, 240 / 233 / 2, 125 / 234 / 2, 118 / 235 / 2, 75 / 236 / 2, 278 / 237 / 4, 176 / 238 / 2, 263 / 239 / 2, 243 / 240 / 2, 31 / 241 / 3, 153 / 242 / 2, 318 / 243 / 3, 115 / 244 / 2, 294 / 245 / 2, 109 / 246 / 2, 10 / 247 / 3, 137 / 250 / 2, 179 / 251 / 3, 289 / 252 / 2, 336 / 253 / 2, 255 / 254 / 2, 84 / 255 / 3, 364 / 256 / 2, 99 / 257 / 3, 207 / 258 / 2, 338 / 259 / 3, 106 / 260 / 2, 108 / 261 / 2, 315 / 262 / 6, 333 / 263 / 2, 3 / 264 / 2, 232 / 265 / 2, 362 / 266 / 2, 335 / 267 / 3, 92 / 269 / 2, 120 / 270 / 3, 203 / 271 / 2, 264 / 272 / 3, 299 / 273 / 2, 173 / 274 / 2, 2 / 277 / 7, 328 / 278 / 2, 242 / 279 / 2, 122 / 280 / 2, 256 / 281 / 2, 151 / 282 / 2, 358 / 283 / 3, 260 / 284 / 2, 297 / 285 / 2, 215 / 286 / 3, 307 / 287 / 2, 345 / 288 / 2, 187 / 289 / 2, 87 / 290 / 2, 276 / 291 / 2, 128 / 292 / 2, 231 / 293 / 3, 368 / 294 / 2, 283 / 295 / 2, 61 / 296 / 2, 123 / 297 / 2, 303 / 298 / 2, 33 / 299 / 2, 6 / 300 / 2, 361 / 301 / 2, 91 / 302 / 3, 50 / 303 / 2, 139 / 304 / 3, 341 / 305 / 2, 273 / 306 / 2, 351 / 307 / 2, 195 / 308 / 2, 237 / 309 / 2, 97 / 310 / 2, 355 / 311 / 2, 228 / 312 / 2, 94 / 313 / 2, 254 / 314 / 2, 117 / 315 / 2, 220 / 316 / 2, 25 / 317 / 2, 252 / 318 / 2, 259 / 319 / 2, 268 / 320 / 2, 304 / 321 / 3, 89 / 323 / 2, 112 / 324 / 2, 327 / 325 / 2, 245 / 326 / 2, 142 / 327 / 2, 295 / 328 / 3, 190 / 329 / 2, 188 / 330 / 3, 95 / 331 / 2, 70 / 332 / 3, 121 / 333 / 2, 352 / 334 / 4, 222 / 335 / 2, 27 / 336 / 3, 246 / 337 / 2, 181 / 338 / 2, 51 / 339 / 2, 287 / 340 / 2, 229 / 341 / 2, 166 / 342 / 2, 354 / 343 / 4, 230 / 344 / 2, 193 / 345 / 3, 52 / 346 / 2, 119 / 347 / 7, 17 / 348 / 2, 374 / 350 / 2, 290 / 351 / 3, 265 / 352 / 2, 140 / 353 / 3, 147 / 354 / 2, 235 / 355 / 2, 175 / 356 / 5, 337 / 357 / 2, 204 / 358 / 3, 261 / 359 / 2, 180 / 360 / 5, 93 / 361 / 2, 272 / 362 / 2, 104 / 363 / 3, 46 / 364 / 2, 156 / 365 / 2, 143 / 366 / 3, 62 / 367 / 2, 161 / 368 / 2, 356 / 369 / 3, 227 / 370 / 2, 302 / 371 / 3, 281 / 373 / 2, 102 / 374 / 4
uniform-alpha_1-11-n500.txt, 1, 1, 500, 1745.46, 3545, 3045, 6, 467,469 / 1 / 2, 4 / 2 / 3, 402 / 3 / 2, 38 / 4 / 2, 111 / 5 / 2, 210 / 6 / 2, 228 / 7 / 2, 168 / 8 / 2, 221 / 9 / 3, 215 / 10 / 2, 148 / 11 / 2, 311 / 12 / 2, 33 / 15 / 2, 76 / 16 / 4, 278 / 17 / 2, 326 / 18 / 2, 330 / 19 / 2, 409 / 20 / 2, 368 / 21 / 3, 128 / 22 / 2, 365 / 23 / 2, 182 / 24 / 2, 115 / 25 / 3, 48 / 26 / 2, 222 / 27 / 2, 179 / 28 / 2, 164 / 29 / 2, 109 / 30 / 4, 435 / 31 / 2, 34 / 32 / 2, 488 / 33 / 2, 170 / 34 / 2, 11 / 35 / 2, 475 / 36 / 2, 487 / 37 / 2, 192 / 38 / 2, 404 / 39 / 2, 89 / 40 / 2, 253 / 41 / 2, 333 / 42 / 2, 245 / 43 / 2, 486 / 44 / 2, 494 / 45 / 2, 104 / 46 / 2, 8 / 47 / 2, 310 / 48 / 2, 453 / 49 / 3, 303 / 53 / 3, 139 / 54 / 2, 358 / 55 / 3, 230 / 58 / 2, 392 / 59 / 3, 280 / 60 / 2, 73 / 61 / 3, 289 / 62 / 2, 304 / 63 / 2, 315 / 64 / 2, 454 / 65 / 4, 307 / 66 / 2, 359 / 67 / 2, 382 / 68 / 2, 399 / 69 / 2, 273 / 70 / 2, 30 / 71 / 2, 114 / 72 / 2, 301 / 73 / 4, 272 / 74 / 2, 107 / 75 / 2, 282 / 76 / 3, 81 / 77 / 2, 401 / 78 / 2, 323 / 79 / 2, 131 / 80 / 2, 134 / 81 / 2, 466 / 82 / 2, 369 / 83 / 2, 244 / 84 / 2, 68 / 85 / 2, 27 / 86 / 2, 261 / 87 / 2, 46 / 88 / 2, 480 / 89 / 2, 13 / 90 / 3, 354 / 91 / 2, 489 / 92 / 2, 12 / 93 / 2, 415 / 94 / 4, 284 / 95 / 2, 331 / 96 / 2, 209 / 97 / 3, 473 / 98 / 2, 57 / 99 / 5, 151 / 102 / 3, 231 / 103 / 2, 251 / 104 / 2, 414 / 105 / 6, 70 / 106 / 2, 61 / 107 / 2, 197 / 108 / 3, 353 / 109 / 2, 119 / 110 / 5, 140 / 111 / 2, 477 / 112 / 3, 329 / 113 / 2, 41 / 114 / 3, 482 / 115 / 2, 42 / 116 / 3, 195 / 117 / 2, 121 / 118 / 2, 266 / 119 / 3, 204 / 120 / 2, 202 / 121 / 2, 241 / 122 / 2, 157 / 123 / 2, 226 / 124 / 2, 338 / 125 / 2, 493 / 126 / 4, 200 / 127 / 2, 37 / 128 / 2, 214 / 129 / 4, 458 / 130 / 2, 254 / 131 / 3, 205 / 132 / 2, 283 / 133 / 2, 405 / 134 / 4, 381 / 135 / 2, 421 / 136 / 3, 308 / 137 / 2, 86 / 138 / 2, 320 / 139 / 5, 176 / 140 / 2, 429 / 141 / 2, 203 / 142 / 2, 126 / 143 / 5, 25 / 144 / 2, 194 / 145 / 3, 391 / 146 / 2, 370 / 147 / 3, 124 / 148 / 2, 425 / 149 / 2, 496 / 150 / 3, 479 / 151 / 2, 294 / 152 / 2, 361 / 153 / 3, 239 / 154 / 2, 83 / 155 / 2, 232 / 156 / 2, 97 / 157 / 5, 246 / 158 / 2, 20 / 159 / 3, 91 / 160 / 2, 190 / 161 / 2, 136 / 162 / 3, 291 / 163 / 2, 436 / 164 / 2, 437 / 165 / 2, 162 / 166 / 3, 374 / 167 / 2, 352 / 168 / 2, 485 / 170 / 3, 378 / 171 / 2, 288 / 172 / 2, 498 / 173 / 2, 112 / 174 / 3, 442 / 175 / 2, 39 / 176 / 3, 457 / 177 / 2, 393 / 178 / 3, 271 / 181 / 2, 269 / 182 / 2, 65 / 183 / 3, 152 / 184 / 2, 132 / 185 / 3, 108 / 186 / 2, 348 / 187 / 3, 22 / 189 / 3, 32 / 190 / 2, 287 / 191 / 2, 406 / 192 / 2, 235 / 193 / 4, 15 / 194 / 2, 341 / 195 / 2, 171 / 196 / 3, 441 / 197 / 2, 233 / 198 / 4, 387 / 201 / 3, 238 / 202 / 2, 173 / 203 / 3, 102 / 204 / 2, 450 / 205 / 3, 211 / 206 / 2, 118 / 207 / 3, 495 / 208 / 2, 443 / 209 / 2, 433 / 210 / 2, 318 / 211 / 2, 155 / 212 / 2, 43 / 213 / 2, 59 / 214 / 3, 58 / 215 / 2, 366 / 216 / 2, 403 / 217 / 2, 212 / 218 / 3, 123 / 219 / 2, 50 / 220 / 3, 372 / 221 / 2, 424 / 222 / 4, 364 / 223 / 2, 478 / 224 / 2, 325 / 225 / 2, 389 / 226 / 2, 52 / 227 / 3, 67 / 228 / 2, 24 / 229 / 4, 45 / 230 / 2, 255 / 231 / 2, 343 / 232 / 2, 459 / 233 / 2, 19 / 234 / 3, 339 / 236 / 4, 207 / 237 / 2, 206 / 238 / 2, 53 / 239 / 2, 174 / 240 / 3, 40 / 241 / 2, 196 / 242 / 2, 224 / 243 / 2, 390 / 244 / 4, 243 / 245 / 2, 90 / 246 / 2, 418 / 247 / 3, 177 / 248 / 2, 444 / 249 / 2, 347 / 250 / 5, 145 / 251 / 2, 2 / 252 / 2, 7 / 253 / 3, 324 / 254 / 2, 213 / 255 / 3, 335 / 256 / 2, 296 / 257 / 3, 169 / 258 / 2, 219 / 259 / 2, 452 / 260 / 2, 127 / 261 / 3, 150 / 262 / 2, 55 / 263 / 3, 448 / 264 / 2, 268 / 265 / 3, 142 / 266 / 2, 293 / 267 / 2, 180 / 270 / 5, 199 / 271 / 2, 160 / 272 / 2, 471 / 273 / 2, 285 / 274 / 4, 103 / 275 / 2, 455 / 276 / 3, 322 / 277 / 2, 461 / 278 / 3, 316 / 279 / 2, 75 / 280 / 5, 242 / 281 / 2, 299 / 282 / 3, 47 / 283 / 2, 23 / 284 / 2, 9 / 285 / 4, 218 / 286 / 2, 281 / 287 / 2, 376 / 288 / 2, 468 / 289 / 3, 185 / 290 / 2, 154 / 291 / 3, 186 / 292 / 2, 28 / 294 / 4, 451 / 295 / 2, 98 / 296 / 3, 492 / 299 / 2, 256 / 300 / 4, 396 / 301 / 2, 247 / 302 / 2, 484 / 303 / 3, 377 / 304 / 2, 88 / 305 / 4, 346 / 306 / 2, 276 / 307 / 2, 6 / 308 / 3, 363 / 309 / 2, 56 / 310 / 2, 36 / 311 / 3, 476 / 312 / 2, 130 / 313 / 2, 79 / 314 / 2, 31 / 315 / 3, 388 / 316 / 2, 345 / 317 / 2, 156 / 318 / 2, 64 / 319 / 2, 223 / 320 / 3, 78 / 321 / 2, 54 / 322 / 2, 35 / 323 / 2, 438 / 324 / 4, 279 / 325 / 2, 264 / 326 / 2, 491 / 327 / 2, 408 / 328 / 2, 434 / 329 / 2, 263 / 330 / 2, 146 / 331 / 3, 74 / 332 / 2, 135 / 333 / 2, 49 / 334 / 2, 431 / 335 / 2, 189 / 336 / 4, 483 / 337 / 2, 423 / 338 / 2, 63 / 339 / 3, 29 / 340 / 2, 260 / 341 / 3, 16 / 342 / 2, 319 / 343 / 2, 66 / 344 / 3, 297 / 345 / 2, 410 / 346 / 3, 153 / 347 / 2, 428 / 348 / 2, 412 / 349 / 3, 250 / 350 / 2, 327 / 351 / 3, 447 / 352 / 2, 96 / 353 / 3, 77 / 354 / 2, 312 / 355 / 3, 422 / 356 / 2, 277 / 358 / 3, 1 / 359 / 2, 481 / 360 / 3, 144 / 361 / 2, 116 / 362 / 3, 3 / 364 / 2, 432 / 365 / 2, 216 / 366 / 3, 80 / 367 / 2, 163 / 368 / 2, 383 / 369 / 3, 306 / 372 / 3, 117 / 373 / 2, 82 / 374 / 2, 181 / 375 / 2, 305 / 376 / 3, 60 / 377 / 2, 159 / 378 / 2, 350 / 379 / 2, 122 / 380 / 2, 427 / 381 / 2, 411 / 382 / 2, 439 / 383 / 2, 105 / 384 / 2, 94 / 385 / 2, 85 / 386 / 2, 71 / 387 / 2, 394 / 388 / 2, 240 / 389 / 5, 26 / 392 / 2, 249 / 393 / 5, 120 / 394 / 2, 463 / 395 / 3, 72 / 396 / 2, 413 / 397 / 3, 158 / 398 / 2, 225 / 399 / 3, 499 / 400 / 2, 229 / 402 / 2, 51 / 403 / 2, 234 / 404 / 3, 449 / 405 / 2, 290 / 406 / 2, 379 / 407 / 3, 208 / 409 / 3, 106 / 410 / 2, 295 / 411 / 2, 84 / 412 / 3, 375 / 413 / 2, 93 / 414 / 3, 445 / 415 / 2, 397 / 416 / 3, 407 / 417 / 2, 110 / 418 / 2, 62 / 419 / 2, 143 / 420 / 2, 101 / 421 / 2, 380 / 422 / 2, 342 / 423 / 2, 373 / 424 / 3, 258 / 425 / 2, 187 / 426 / 3, 456 / 427 / 2, 292 / 428 / 3, 14 / 429 / 2, 344 / 430 / 2, 328 / 431 / 2, 465 / 432 / 4, 217 / 433 / 2, 351 / 434 / 2, 257 / 435 / 3, 314 / 436 / 2, 340 / 437 / 3, 336 / 438 / 2, 440 / 439 / 2, 384 / 441 / 4, 497 / 442 / 2, 18 / 443 / 3, 470 / 444 / 2, 236 / 445 / 5, 69 / 446 / 2, 265 / 447 / 3, 355 / 448 / 2, 5 / 449 / 3, 446 / 450 / 2, 193 / 451 / 2, 332 / 452 / 2, 10 / 453 / 2, 460 / 454 / 2, 138 / 455 / 2, 417 / 456 / 2, 183 / 457 / 2, 360 / 458 / 2, 191 / 461 / 2, 385 / 462 / 3, 147 / 463 / 2, 141 / 464 / 2, 367 / 465 / 2, 137 / 466 / 3, 309 / 467 / 2, 172 / 468 / 4, 270 / 469 / 2, 44 / 470 / 2, 371 / 471 / 2, 298 / 472 / 2, 386 / 473 / 2, 426 / 474 / 4, 95 / 475 / 2, 472 / 476 / 2, 274 / 477 / 2, 129 / 478 / 2, 149 / 479 / 5, 262 / 480 / 2, 462 / 481 / 2, 178 / 482 / 3, 337 / 483 / 2, 420 / 484 / 2, 395 / 485 / 2, 165 / 486 / 2, 490 / 487 / 2, 362 / 488 / 2, 166 / 489 / 2, 92 / 490 / 3, 334 / 491 / 2, 275 / 492 / 2, 188 / 493 / 3, 267 / 494 / 2, 464 / 495 / 2, 100 / 496 / 2, 416 / 497 / 2, 356 / 498 / 2, 313 / 499 / 2
uniform-alpha_1-11-n6.txt, 1, 1, 6, 310.546, 24, 18, 3, 5,2 / 1 / 2, 3 / 2 / 2, 4 / 3 / 2, 5 / 4 / 2, 1 / 5 / 3
uniform-alpha_1-110-n175.txt, 1, 1, 175, 1049.61, 1221, 1046, 6, 171,41 / 1 / 2, 84 / 2 / 2, 144 / 3 / 2, 62 / 4 / 2, 3 / 5 / 2, 65 / 6 / 3, 148 / 7 / 2, 113 / 8 / 3, 123 / 9 / 2, 90 / 10 / 3, 88 / 11 / 2, 145 / 12 / 3, 60 / 13 / 2, 174 / 14 / 2, 83 / 15 / 2, 112 / 16 / 2, 168 / 17 / 2, 64 / 18 / 2, 68 / 19 / 3, 42 / 20 / 2, 79 / 21 / 6, 37 / 22 / 2, 95 / 23 / 2, 99 / 24 / 3, 26 / 25 / 2, 114 / 26 / 2, 154 / 27 / 2, 2 / 28 / 2, 159 / 29 / 2, 151 / 30 / 2, 44 / 31 / 2, 13 / 32 / 2, 21 / 33 / 2, 85 / 34 / 3, 47 / 35 / 2, 25 / 36 / 2, 138 / 37 / 3, 56 / 38 / 2, 72 / 39 / 3, 20 / 40 / 2, 108 / 41 / 3, 70 / 42 / 2, 101 / 43 / 3, 135 / 44 / 2, 125 / 45 / 3, 173 / 46 / 2, 103 / 47 / 2, 23 / 48 / 2, 107 / 49 / 2, 18 / 50 / 4, 128 / 51 / 2, 141 / 52 / 2, 122 / 53 / 3, 167 / 54 / 2, 139 / 55 / 2, 155 / 56 / 3, 140 / 57 / 2, 156 / 58 / 2, 55 / 59 / 2, 24 / 60 / 3, 40 / 61 / 2, 150 / 62 / 3, 165 / 63 / 2, 164 / 64 / 3, 102 / 65 / 2, 80 / 66 / 2, 75 / 67 / 2, 172 / 68 / 3, 52 / 69 / 2, 63 / 70 / 3, 152 / 71 / 2, 92 / 72 / 2, 100 / 73 / 3, 53 / 74 / 2, 71 / 75 / 3, 117 / 76 / 2, 66 / 77 / 3, 11 / 78 / 2, 133 / 79 / 3, 109 / 80 / 2, 149 / 81 / 3, 36 / 82 / 2, 48 / 83 / 3, 157 / 84 / 2, 119 / 85 / 2, 98 / 86 / 2, 153 / 87 / 2, 22 / 88 / 3, 89 / 89 / 2, 30 / 90 / 3, 121 / 91 / 2, 170 / 92 / 2, 160 / 93 / 2, 111 / 94 / 3, 14 / 95 / 2, 34 / 96 / 2, 33 / 97 / 2, 78 / 98 / 3, 5 / 99 / 2, 19 / 100 / 2, 106 / 101 / 3, 16 / 102 / 2, 134 / 103 / 2, 15 / 104 / 3, 69 / 105 / 2, 169 / 106 / 3, 76 / 107 / 2, 158 / 108 / 3, 126 / 109 / 2, 115 / 110 / 2, 131 / 111 / 2, 94 / 112 / 3, 171 / 113 / 2, 46 / 114 / 3, 161 / 115 / 2, 118 / 116 / 3, 146 / 117 / 2, 50 / 118 / 3, 104 / 119 / 2, 9 / 120 / 3, 27 / 121 / 2, 162 / 122 / 2, 136 / 123 / 2, 7 / 124 / 2, 166 / 125 / 2, 91 / 126 / 4, 4 / 127 / 2, 74 / 128 / 2, 105 / 129 / 2, 124 / 130 / 2, 147 / 131 / 3, 67 / 132 / 2, 142 / 133 / 2, 57 / 134 / 3, 81 / 135 / 2, 82 / 136 / 2, 59 / 137 / 3, 12 / 138 / 2, 143 / 139 / 2, 129 / 140 / 2, 97 / 141 / 5, 51 / 142 / 2, 10 / 143 / 2, 29 / 144 / 3, 127 / 145 / 2, 110 / 146 / 2, 87 / 147 / 3, 1 / 148 / 2, 116 / 149 / 3, 73 / 150 / 2, 35 / 151 / 3, 43 / 152 / 2, 32 / 153 / 5, 17 / 154 / 2, 8 / 155 / 2, 120 / 156 / 2, 132 / 157 / 3, 61 / 158 / 2, 31 / 159 / 2, 49 / 160 / 2, 86 / 161 / 2, 38 / 164 / 3, 163 / 165 / 2, 93 / 166 / 3, 137 / 167 / 2, 58 / 168 / 3, 96 / 169 / 2, 45 / 170 / 2, 54 / 172 / 4, 6 / 173 / 2, 130 / 174 / 2
uniform-alpha_1-111-n250.txt, 1, 1, 250, 1280.32, 1814, 1564, 7, 236,19 / 1 / 2, 102 / 2 / 3, 157 / 5 / 3, 166 / 6 / 2, 72 / 7 / 3, 59 / 8 / 2, 192 / 9 / 3, 44 / 10 / 2, 91 / 11 / 2, 36 / 12 / 2, 38 / 13 / 2, 25 / 14 / 2, 243 / 15 / 3, 37 / 16 / 2, 65 / 17 / 2, 121 / 18 / 2, 148 / 19 / 2, 151 / 20 / 2, 239 / 21 / 3, 24 / 22 / 2, 115 / 23 / 2, 3 / 24 / 2, 194 / 25 / 4, 179 / 26 / 2, 67 / 27 / 3, 145 / 28 / 2, 212 / 29 / 3, 223 / 30 / 2, 21 / 31 / 2, 142 / 32 / 4, 15 / 35 / 3, 149 / 36 / 2, 203 / 37 / 2, 220 / 38 / 3, 103 / 39 / 2, 61 / 40 / 2, 55 / 41 / 4, 158 / 42 / 2, 53 / 43 / 3, 187 / 44 / 2, 94 / 45 / 2, 2 / 47 / 2, 80 / 48 / 3, 219 / 49 / 2, 128 / 50 / 2, 153 / 51 / 3, 5 / 52 / 2, 215 / 53 / 2, 11 / 54 / 2, 237 / 55 / 2, 76 / 56 / 2, 69 / 57 / 2, 198 / 58 / 2, 174 / 59 / 2, 4 / 60 / 2, 101 / 61 / 4, 163 / 62 / 2, 56 / 63 / 2, 26 / 64 / 3, 152 / 65 / 2, 206 / 66 / 3, 75 / 67 / 2, 228 / 68 / 3, 116 / 69 / 2, 41 / 70 / 3, 136 / 71 / 2, 210 / 72 / 3, 105 / 73 / 2, 227 / 74 / 2, 207 / 75 / 3, 249 / 76 / 2, 34 / 77 / 2, 88 / 78 / 2, 232 / 79 / 3, 137 / 80 / 2, 23 / 81 / 3, 39 / 82 / 2, 107 / 83 / 2, 190 / 84 / 3, 16 / 85 / 2, 134 / 86 / 2, 183 / 87 / 4, 66 / 88 / 2, 233 / 89 / 2, 196 / 90 / 2, 30 / 91 / 3, 173 / 92 / 2, 27 / 93 / 2, 32 / 94 / 2, 197 / 95 / 2, 81 / 96 / 3, 124 / 97 / 2, 135 / 98 / 2, 131 / 99 / 2, 226 / 100 / 2, 42 / 101 / 3, 235 / 102 / 2, 229 / 103 / 2, 74 / 104 / 4, 1 / 105 / 2, 165 / 106 / 2, 125 / 107 / 3, 214 / 108 / 2, 162 / 109 / 4, 52 / 110 / 2, 130 / 112 / 4, 9 / 113 / 2, 111 / 114 / 2, 143 / 115 / 2, 156 / 116 / 4, 140 / 117 / 2, 43 / 118 / 2, 221 / 119 / 3, 8 / 120 / 2, 217 / 121 / 3, 213 / 122 / 2, 100 / 123 / 2, 133 / 124 / 3, 28 / 125 / 2, 95 / 126 / 2, 161 / 127 / 2, 150 / 128 / 2, 51 / 129 / 3, 169 / 130 / 2, 191 / 131 / 2, 230 / 132 / 3, 146 / 133 / 2, 236 / 134 / 2, 97 / 135 / 2, 248 / 136 / 3, 127 / 137 / 2, 93 / 138 / 2, 139 / 139 / 4, 17 / 140 / 2, 60 / 141 / 2, 193 / 142 / 3, 175 / 144 / 5, 46 / 145 / 2, 186 / 146 / 2, 29 / 147 / 2, 178 / 148 / 2, 180 / 149 / 4, 48 / 152 / 3, 70 / 153 / 2, 238 / 154 / 2, 132 / 155 / 2, 201 / 156 / 2, 58 / 157 / 3, 45 / 160 / 2, 98 / 161 / 2, 112 / 162 / 4, 120 / 163 / 2, 68 / 164 / 2, 18 / 165 / 7, 241 / 166 / 2, 247 / 167 / 2, 185 / 168 / 3, 240 / 171 / 3, 35 / 172 / 2, 106 / 173 / 2, 62 / 174 / 4, 155 / 175 / 2, 31 / 176 / 2, 160 / 177 / 2, 85 / 178 / 2, 225 / 179 / 2, 216 / 180 / 2, 117 / 181 / 2, 73 / 182 / 3, 168 / 183 / 2, 242 / 184 / 2, 49 / 185 / 3, 222 / 186 / 2, 147 / 187 / 2, 159 / 188 / 3, 77 / 189 / 2, 104 / 190 / 2, 189 / 191 / 3, 13 / 192 / 2, 167 / 193 / 2, 113 / 194 / 3, 57 / 195 / 2, 170 / 196 / 3, 110 / 197 / 2, 84 / 198 / 2, 79 / 199 / 2, 64 / 200 / 4, 144 / 201 / 2, 208 / 202 / 2, 224 / 203 / 3, 6 / 204 / 2, 204 / 205 / 3, 90 / 206 / 2, 195 / 207 / 4, 154 / 208 / 2, 164 / 209 / 2, 99 / 210 / 3, 129 / 211 / 2, 122 / 212 / 3, 184 / 213 / 2, 10 / 214 / 2, 50 / 215 / 4, 47 / 216 / 2, 211 / 217 / 3, 108 / 218 / 2, 20 / 219 / 2, 114 / 220 / 4, 182 / 221 / 2, 246 / 222 / 2, 181 / 223 / 2, 234 / 224 / 2, 87 / 225 / 5, 40 / 226 / 2, 92 / 227 / 2, 141 / 228 / 3, 176 / 229 / 2, 199 / 230 / 2, 126 / 231 / 2, 109 / 232 / 2, 14 / 233 / 2, 188 / 234 / 2, 63 / 235 / 2, 245 / 236 / 2, 83 / 237 / 2, 231 / 238 / 3, 244 / 239 / 2, 33 / 240 / 4, 119 / 241 / 2, 82 / 242 / 2, 22 / 243 / 2, 12 / 244 / 2, 172 / 245 / 2, 118 / 246 / 2, 54 / 247 / 2, 171 / 248 / 2, 71 / 249 / 2
uniform-alpha_1-112-n250.txt, 1, 1, 250, 1227.43, 1747, 1497, 6, 237,71 / 1 / 6, 72 / 2 / 2, 131 / 3 / 2, 207 / 4 / 2, 10 / 5 / 2, 112 / 6 / 2, 151 / 7 / 2, 45 / 8 / 2, 14 / 9 / 4, 213 / 10 / 2, 208 / 11 / 2, 145 / 12 / 4, 114 / 13 / 2, 41 / 14 / 2, 20 / 15 / 2, 155 / 16 / 2, 85 / 17 / 2, 105 / 18 / 3, 206 / 19 / 2, 66 / 20 / 2, 44 / 21 / 3, 221 / 22 / 2, 182 / 23 / 2, 81 / 24 / 4, 123 / 25 / 2, 58 / 26 / 2, 51 / 27 / 3, 199 / 28 / 2, 149 / 29 / 2, 212 / 30 / 3, 163 / 31 / 2, 126 / 32 / 2, 186 / 33 / 4, 218 / 34 / 2, 239 / 35 / 2, 160 / 36 / 2, 122 / 37 / 2, 42 / 38 / 3, 161 / 39 / 2, 5 / 40 / 2, 32 / 41 / 5, 119 / 42 / 2, 170 / 43 / 3, 89 / 44 / 2, 83 / 45 / 2, 232 / 46 / 3, 153 / 48 / 3, 63 / 49 / 2, 175 / 50 / 2, 224 / 51 / 3, 54 / 52 / 2, 67 / 53 / 2, 242 / 54 / 2, 165 / 55 / 2, 220 / 56 / 3, 196 / 57 / 2, 228 / 58 / 2, 76 / 59 / 2, 106 / 60 / 6, 171 / 63 / 2, 216 / 64 / 2, 189 / 65 / 3, 245 / 66 / 2, 91 / 67 / 2, 117 / 68 / 3, 146 / 69 / 2, 34 / 70 / 2, 96 / 71 / 2, 82 / 72 / 3, 33 / 76 / 2, 92 / 77 / 3, 49 / 79 / 3, 222 / 80 / 2, 167 / 81 / 2, 28 / 82 / 3, 69 / 83 / 2, 59 / 84 / 5, 107 / 85 / 2, 50 / 86 / 2, 192 / 89 / 2, 139 / 90 / 3, 13 / 91 / 2, 243 / 92 / 2, 200 / 93 / 2, 226 / 94 / 2, 3 / 95 / 2, 172 / 96 / 2, 62 / 97 / 4, 48 / 98 / 2, 129 / 99 / 2, 99 / 100 / 2, 35 / 101 / 4, 158 / 102 / 2, 174 / 103 / 2, 55 / 104 / 3, 68 / 105 / 2, 47 / 106 / 3, 78 / 107 / 2, 7 / 108 / 2, 121 / 109 / 3, 223 / 110 / 2, 141 / 111 / 2, 188 / 112 / 3, 181 / 113 / 2, 118 / 114 / 2, 53 / 115 / 2, 138 / 116 / 2, 246 / 117 / 2, 193 / 118 / 3, 25 / 119 / 2, 22 / 120 / 2, 150 / 121 / 2, 19 / 122 / 2, 237 / 123 / 3, 130 / 124 / 2, 31 / 125 / 2, 235 / 126 / 2, 217 / 127 / 3, 236 / 128 / 2, 214 / 129 / 2, 202 / 130 / 2, 77 / 131 / 2, 148 / 132 / 2, 185 / 133 / 3, 61 / 134 / 2, 88 / 135 / 2, 97 / 136 / 3, 204 / 137 / 2, 244 / 138 / 2, 24 / 139 / 3, 43 / 140 / 2, 177 / 141 / 3, 162 / 142 / 2, 74 / 143 / 3, 248 / 144 / 2, 225 / 145 / 3, 9 / 146 / 2, 84 / 147 / 3, 46 / 148 / 2, 73 / 149 / 2, 116 / 150 / 2, 231 / 151 / 3, 203 / 152 / 2, 111 / 153 / 2, 240 / 154 / 2, 65 / 155 / 2, 144 / 156 / 2, 94 / 157 / 2, 194 / 158 / 3, 6 / 159 / 2, 15 / 160 / 3, 179 / 161 / 2, 195 / 162 / 2, 70 / 163 / 2, 184 / 164 / 2, 209 / 165 / 2, 230 / 166 / 2, 133 / 167 / 2, 190 / 168 / 4, 127 / 169 / 2, 143 / 170 / 2, 102 / 171 / 2, 180 / 172 / 2, 115 / 173 / 2, 75 / 174 / 2, 27 / 175 / 3, 26 / 176 / 2, 87 / 177 / 3, 109 / 178 / 2, 173 / 179 / 2, 101 / 180 / 2, 30 / 181 / 2, 125 / 182 / 2, 17 / 183 / 3, 95 / 184 / 2, 140 / 185 / 5, 201 / 186 / 2, 132 / 187 / 2, 4 / 188 / 4, 233 / 189 / 2, 135 / 190 / 2, 157 / 191 / 4, 159 / 192 / 2, 64 / 193 / 2, 52 / 194 / 3, 29 / 195 / 2, 8 / 196 / 2, 120 / 197 / 3, 156 / 198 / 2, 238 / 199 / 2, 142 / 200 / 4, 247 / 201 / 2, 16 / 202 / 2, 134 / 203 / 2, 187 / 204 / 2, 110 / 205 / 2, 11 / 206 / 2, 169 / 207 / 5, 103 / 208 / 2, 40 / 209 / 3, 197 / 210 / 2, 21 / 211 / 4, 39 / 212 / 2, 136 / 213 / 2, 137 / 214 / 3, 164 / 215 / 2, 60 / 216 / 3, 12 / 217 / 2, 37 / 218 / 2, 57 / 219 / 3, 23 / 220 / 2, 79 / 221 / 3, 104 / 223 / 2, 205 / 224 / 2, 36 / 225 / 2, 241 / 226 / 2, 2 / 227 / 3, 198 / 230 / 3, 168 / 231 / 2, 166 / 232 / 6, 234 / 233 / 2, 90 / 234 / 2, 183 / 235 / 2, 93 / 236 / 2, 100 / 237 / 4, 86 / 238 / 2, 219 / 239 / 2, 229 / 240 / 2, 227 / 241 / 3, 113 / 242 / 2, 249 / 243 / 2, 1 / 244 / 3, 38 / 245 / 2, 98 / 246 / 2, 215 / 247 / 2, 80 / 248 / 2, 147 / 249 / 2
uniform-alpha_1-113-n250.txt, 1, 1, 250, 1326.18, 1821, 1571, 6, 240,232 / 1 / 3, 35 / 2 / 2, 243 / 3 / 3, 59 / 4 / 2, 138 / 5 / 3, 51 / 6 / 2, 180 / 7 / 2, 63 / 8 / 2, 164 / 9 / 2, 16 / 10 / 3, 136 / 11 / 2, 111 / 12 / 4, 214 / 13 / 2, 80 / 14 / 2, 215 / 15 / 2, 240 / 16 / 2, 48 / 17 / 2, 131 / 18 / 2, 37 / 19 / 2, 204 / 20 / 2, 223 / 21 / 2, 166 / 22 / 2, 135 / 23 / 2, 247 / 24 / 2, 19 / 25 / 2, 231 / 26 / 3, 91 / 27 / 2, 116 / 29 / 3, 52 / 30 / 2, 1 / 31 / 4, 205 / 32 / 2, 239 / 33 / 2, 210 / 34 / 3, 219 / 35 / 2, 24 / 36 / 2, 143 / 37 / 2, 68 / 38 / 2, 201 / 39 / 2, 236 / 40 / 2, 144 / 41 / 2, 132 / 42 / 5, 93 / 43 / 2, 221 / 44 / 3, 165 / 45 / 2, 122 / 46 / 5, 101 / 47 / 2, 57 / 48 / 3, 189 / 50 / 2, 175 / 51 / 2, 83 / 52 / 2, 75 / 53 / 2, 58 / 54 / 3, 157 / 55 / 2, 44 / 56 / 3, 212 / 57 / 2, 141 / 58 / 2, 28 / 59 / 2, 137 / 60 / 3, 15 / 61 / 2, 167 / 62 / 3, 222 / 63 / 2, 241 / 64 / 2, 33 / 65 / 2, 124 / 66 / 2, 217 / 67 / 2, 191 / 68 / 2, 237 / 69 / 2, 179 / 70 / 3, 152 / 71 / 2, 108 / 72 / 2, 229 / 73 / 2, 115 / 74 / 4, 211 / 75 / 2, 22 / 76 / 2, 188 / 77 / 4, 90 / 78 / 2, 192 / 79 / 2, 106 / 80 / 2, 61 / 81 / 2, 74 / 82 / 2, 76 / 83 / 2, 139 / 84 / 2, 146 / 85 / 2, 55 / 86 / 2, 112 / 87 / 2, 102 / 88 / 3, 134 / 89 / 2, 94 / 90 / 2, 81 / 91 / 4, 190 / 92 / 2, 181 / 93 / 2, 23 / 94 / 3, 107 / 95 / 2, 196 / 96 / 2, 145 / 97 / 2, 174 / 98 / 2, 123 / 99 / 2, 234 / 100 / 2, 20 / 101 / 2, 31 / 102 / 2, 69 / 103 / 3, 8 / 104 / 2, 96 / 105 / 3, 198 / 106 / 2, 194 / 107 / 3, 29 / 108 / 2, 208 / 109 / 5, 120 / 110 / 2, 158 / 111 / 2, 50 / 112 / 2, 14 / 113 / 2, 248 / 114 / 2, 163 / 115 / 3, 13 / 118 / 3, 226 / 119 / 2, 114 / 120 / 2, 169 / 121 / 2, 117 / 122 / 2, 34 / 123 / 2, 27 / 124 / 2, 17 / 125 / 2, 110 / 126 / 2, 209 / 127 / 2, 182 / 128 / 2, 187 / 129 / 2, 100 / 130 / 3, 26 / 133 / 3, 2 / 134 / 2, 18 / 135 / 4, 85 / 136 / 2, 47 / 137 / 2, 130 / 138 / 2, 176 / 139 / 3, 154 / 140 / 2, 40 / 141 / 3, 67 / 142 / 2, 228 / 143 / 2, 41 / 144 / 4, 171 / 145 / 2, 246 / 146 / 3, 95 / 147 / 2, 193 / 148 / 3, 6 / 149 / 2, 72 / 150 / 2, 149 / 151 / 3, 245 / 152 / 2, 98 / 153 / 2, 53 / 154 / 3, 155 / 155 / 2, 177 / 156 / 3, 125 / 157 / 2, 30 / 158 / 3, 78 / 159 / 2, 186 / 160 / 2, 60 / 161 / 2, 62 / 162 / 3, 82 / 163 / 2, 172 / 164 / 2, 203 / 165 / 2, 92 / 166 / 2, 249 / 167 / 3, 71 / 168 / 2, 156 / 169 / 3, 10 / 170 / 2, 220 / 171 / 2, 7 / 172 / 2, 147 / 173 / 6, 46 / 174 / 2, 142 / 175 / 2, 206 / 178 / 3, 126 / 179 / 2, 129 / 180 / 2, 42 / 181 / 2, 89 / 182 / 5, 213 / 183 / 2, 66 / 184 / 2, 87 / 185 / 3, 70 / 186 / 2, 200 / 187 / 2, 64 / 188 / 2, 4 / 189 / 3, 178 / 190 / 2, 104 / 191 / 3, 121 / 192 / 2, 49 / 193 / 2, 21 / 194 / 2, 32 / 195 / 2, 127 / 196 / 2, 11 / 197 / 3, 150 / 198 / 2, 109 / 199 / 3, 25 / 200 / 2, 77 / 201 / 2, 56 / 202 / 2, 199 / 203 / 2, 140 / 204 / 2, 225 / 205 / 4, 97 / 206 / 2, 153 / 208 / 2, 162 / 209 / 6, 5 / 210 / 2, 197 / 211 / 3, 161 / 212 / 2, 183 / 213 / 2, 9 / 214 / 2, 73 / 215 / 3, 65 / 216 / 2, 218 / 217 / 2, 84 / 218 / 3, 235 / 219 / 2, 233 / 220 / 2, 159 / 221 / 3, 170 / 222 / 2, 207 / 223 / 3, 128 / 224 / 2, 185 / 225 / 2, 238 / 226 / 2, 36 / 227 / 3, 230 / 228 / 2, 54 / 229 / 4, 119 / 230 / 2, 148 / 231 / 2, 88 / 232 / 2, 202 / 233 / 4, 43 / 234 / 2, 103 / 235 / 2, 244 / 236 / 2, 105 / 237 / 2, 12 / 238 / 3, 227 / 239 / 2, 39 / 240 / 2, 38 / 241 / 2, 216 / 242 / 2, 3 / 243 / 4, 133 / 244 / 2, 151 / 245 / 2, 195 / 246 / 2, 160 / 247 / 2, 86 / 248 / 2, 45 / 249 / 2
uniform-alpha_1-114-n250.txt, 1, 1, 250, 1230.87, 1745, 1495, 6, 231,171 / 1 / 2, 36 / 2 / 2, 178 / 3 / 2, 62 / 4 / 2, 211 / 5 / 2, 179 / 6 / 2, 215 / 7 / 2, 228 / 8 / 2, 83 / 9 / 2, 239 / 10 / 2, 249 / 11 / 2, 232 / 12 / 3, 103 / 13 / 2, 98 / 14 / 3, 196 / 15 / 2, 34 / 16 / 3, 180 / 17 / 2, 41 / 18 / 2, 130 / 19 / 5, 123 / 20 / 2, 137 / 21 / 2, 219 / 22 / 2, 78 / 23 / 5, 116 / 24 / 2, 110 / 25 / 2, 121 / 26 / 2, 27 / 27 / 4, 85 / 28 / 2, 165 / 29 / 2, 94 / 30 / 2, 64 / 31 / 4, 140 / 32 / 2, 75 / 33 / 2, 126 / 34 / 4, 189 / 37 / 2, 183 / 38 / 3, 162 / 39 / 2, 246 / 40 / 3, 151 / 41 / 2, 198 / 42 / 2, 89 / 43 / 2, 104 / 44 / 2, 128 / 45 / 4, 12 / 46 / 2, 124 / 47 / 2, 81 / 48 / 4, 237 / 49 / 2, 29 / 50 / 2, 161 / 51 / 2, 125 / 52 / 3, 7 / 53 / 2, 20 / 54 / 2, 226 / 55 / 2, 241 / 56 / 3, 133 / 57 / 2, 148 / 58 / 3, 191 / 59 / 2, 15 / 60 / 2, 245 / 61 / 2, 202 / 62 / 3, 48 / 63 / 2, 102 / 64 / 2, 35 / 65 / 2, 52 / 66 / 2, 229 / 67 / 4, 59 / 68 / 2, 240 / 69 / 2, 19 / 70 / 3, 197 / 71 / 2, 220 / 72 / 2, 60 / 73 / 2, 30 / 74 / 2, 53 / 75 / 2, 224 / 76 / 2, 203 / 77 / 2, 95 / 78 / 4, 16 / 79 / 2, 99 / 80 / 2, 132 / 81 / 2, 22 / 82 / 2, 68 / 83 / 2, 8 / 84 / 2, 221 / 85 / 2, 50 / 86 / 2, 233 / 87 / 2, 214 / 88 / 2, 9 / 89 / 2, 28 / 90 / 3, 11 / 91 / 2, 222 / 92 / 3, 111 / 93 / 2, 47 / 94 / 2, 113 / 95 / 2, 173 / 96 / 4, 40 / 97 / 2, 45 / 98 / 2, 69 / 99 / 3, 118 / 100 / 2, 186 / 101 / 2, 149 / 102 / 2, 142 / 103 / 2, 74 / 104 / 2, 194 / 105 / 2, 54 / 106 / 3, 153 / 107 / 2, 129 / 108 / 2, 43 / 109 / 2, 213 / 110 / 3, 93 / 111 / 2, 51 / 112 / 2, 193 / 113 / 3, 164 / 114 / 2, 206 / 115 / 2, 212 / 116 / 3, 73 / 117 / 2, 115 / 118 / 2, 25 / 119 / 2, 242 / 120 / 5, 32 / 121 / 2, 70 / 122 / 2, 131 / 123 / 2, 107 / 126 / 3, 71 / 127 / 2, 88 / 128 / 3, 157 / 129 / 2, 172 / 130 / 4, 187 / 131 / 2, 150 / 134 / 3, 160 / 135 / 2, 1 / 136 / 3, 80 / 137 / 2, 76 / 138 / 3, 87 / 139 / 2, 105 / 140 / 3, 190 / 141 / 2, 210 / 142 / 2, 230 / 143 / 2, 42 / 144 / 2, 108 / 145 / 2, 127 / 146 / 2, 90 / 147 / 3, 109 / 148 / 2, 31 / 149 / 2, 114 / 150 / 2, 185 / 151 / 2, 23 / 152 / 2, 33 / 153 / 3, 138 / 154 / 2, 177 / 155 / 3, 44 / 156 / 2, 236 / 157 / 2, 24 / 158 / 3, 144 / 162 / 2, 14 / 163 / 4, 65 / 164 / 2, 176 / 165 / 3, 139 / 166 / 2, 248 / 167 / 2, 167 / 168 / 2, 154 / 169 / 3, 136 / 170 / 2, 207 / 171 / 2, 58 / 172 / 2, 37 / 173 / 3, 208 / 175 / 3, 159 / 176 / 2, 46 / 177 / 2, 4 / 178 / 5, 235 / 179 / 2, 195 / 180 / 3, 217 / 181 / 2, 66 / 182 / 2, 155 / 183 / 2, 188 / 184 / 3, 61 / 185 / 2, 6 / 186 / 2, 204 / 187 / 4, 201 / 190 / 2, 13 / 191 / 2, 218 / 192 / 3, 147 / 193 / 2, 181 / 194 / 3, 156 / 195 / 2, 174 / 196 / 2, 106 / 197 / 2, 166 / 198 / 3, 56 / 199 / 2, 169 / 200 / 3, 112 / 202 / 3, 82 / 204 / 2, 168 / 205 / 4, 17 / 206 / 2, 101 / 208 / 2, 205 / 209 / 5, 243 / 210 / 2, 49 / 211 / 2, 225 / 212 / 2, 244 / 213 / 2, 247 / 214 / 3, 227 / 215 / 2, 152 / 216 / 2, 199 / 217 / 3, 63 / 218 / 2, 3 / 219 / 3, 231 / 220 / 2, 122 / 221 / 3, 158 / 222 / 2, 184 / 224 / 3, 18 / 225 / 2, 135 / 226 / 2, 91 / 227 / 2, 2 / 228 / 2, 97 / 229 / 2, 57 / 230 / 3, 79 / 231 / 2, 77 / 232 / 2, 192 / 233 / 3, 163 / 234 / 2, 38 / 236 / 2, 5 / 237 / 4, 96 / 238 / 2, 145 / 239 / 2, 120 / 240 / 6, 216 / 242 / 2, 234 / 243 / 2, 84 / 244 / 2, 72 / 245 / 3, 200 / 246 / 2, 39 / 247 / 2, 141 / 248 / 5, 119 / 249 / 2
uniform-alpha_1-115-n250.txt, 1, 1, 250, 1307.15, 1770, 1520, 9, 231,153 / 1 / 2, 159 / 2 / 2, 220 / 3 / 3, 74 / 4 / 2, 100 / 5 / 2, 91 / 6 / 3, 223 / 7 / 2, 31 / 8 / 2, 149 / 9 / 2, 123 / 10 / 3, 108 / 11 / 2, 55 / 12 / 3, 32 / 13 / 2, 172 / 14 / 3, 219 / 15 / 2, 194 / 16 / 3, 214 / 17 / 2, 239 / 18 / 5, 114 / 19 / 2, 139 / 20 / 3, 176 / 22 / 2, 7 / 23 / 3, 188 / 24 / 2, 73 / 25 / 3, 198 / 26 / 2, 1 / 27 / 2, 22 / 28 / 4, 136 / 29 / 2, 228 / 30 / 3, 246 / 31 / 2, 191 / 32 / 3, 195 / 33 / 2, 92 / 36 / 3, 179 / 37 / 2, 47 / 38 / 2, 102 / 39 / 4, 56 / 40 / 2, 131 / 41 / 2, 128 / 42 / 4, 81 / 43 / 2, 140 / 44 / 3, 76 / 45 / 2, 166 / 46 / 2, 103 / 47 / 4, 112 / 48 / 2, 57 / 49 / 2, 161 / 50 / 4, 70 / 51 / 2, 175 / 52 / 3, 111 / 53 / 2, 232 / 54 / 3, 35 / 55 / 2, 64 / 56 / 2, 237 / 57 / 2, 71 / 58 / 4, 89 / 59 / 2, 133 / 60 / 2, 41 / 63 / 3, 23 / 64 / 2, 145 / 65 / 2, 53 / 66 / 2, 67 / 67 / 3, 209 / 68 / 2, 34 / 69 / 2, 192 / 70 / 2, 19 / 71 / 2, 90 / 72 / 2, 93 / 73 / 2, 147 / 74 / 2, 33 / 75 / 2, 151 / 76 / 2, 155 / 77 / 2, 244 / 78 / 2, 14 / 79 / 3, 77 / 81 / 3, 101 / 82 / 2, 215 / 83 / 3, 216 / 84 / 2, 26 / 85 / 2, 29 / 86 / 3, 248 / 87 / 2, 249 / 88 / 2, 162 / 89 / 4, 107 / 90 / 2, 15 / 91 / 3, 222 / 92 / 2, 235 / 93 / 5, 174 / 94 / 2, 96 / 95 / 2, 83 / 96 / 3, 120 / 97 / 2, 156 / 98 / 3, 186 / 99 / 2, 94 / 100 / 2, 116 / 101 / 3, 243 / 102 / 2, 233 / 103 / 3, 117 / 104 / 2, 63 / 105 / 2, 187 / 106 / 2, 241 / 107 / 2, 24 / 108 / 2, 129 / 109 / 2, 240 / 110 / 2, 104 / 111 / 3, 86 / 112 / 2, 137 / 113 / 3, 201 / 114 / 2, 115 / 115 / 2, 127 / 116 / 4, 66 / 117 / 2, 178 / 118 / 2, 46 / 119 / 4, 58 / 120 / 2, 181 / 121 / 2, 98 / 122 / 2, 229 / 123 / 2, 48 / 124 / 3, 210 / 125 / 2, 236 / 126 / 2, 69 / 127 / 2, 4 / 128 / 3, 148 / 129 / 2, 213 / 130 / 2, 242 / 131 / 3, 234 / 132 / 2, 171 / 133 / 2, 38 / 134 / 3, 3 / 135 / 2, 78 / 136 / 3, 65 / 137 / 2, 2 / 138 / 2, 169 / 139 / 2, 105 / 140 / 4, 10 / 142 / 2, 39 / 143 / 4, 59 / 144 / 2, 61 / 145 / 2, 202 / 146 / 2, 20 / 147 / 3, 110 / 148 / 2, 119 / 149 / 3, 13 / 150 / 2, 5 / 151 / 3, 121 / 152 / 2, 12 / 153 / 3, 97 / 154 / 2, 221 / 155 / 2, 160 / 156 / 4, 163 / 157 / 2, 75 / 158 / 2, 36 / 159 / 4, 208 / 160 / 2, 182 / 161 / 3, 245 / 163 / 3, 52 / 164 / 2, 207 / 165 / 2, 142 / 166 / 2, 72 / 167 / 2, 197 / 168 / 3, 177 / 169 / 2, 135 / 170 / 2, 183 / 171 / 2, 45 / 172 / 2, 189 / 173 / 2, 144 / 174 / 2, 50 / 175 / 2, 196 / 176 / 2, 51 / 177 / 2, 165 / 178 / 2, 109 / 179 / 4, 247 / 180 / 2, 106 / 181 / 2, 42 / 182 / 2, 168 / 183 / 2, 17 / 184 / 6, 212 / 185 / 2, 184 / 186 / 2, 185 / 188 / 2, 11 / 189 / 5, 40 / 190 / 2, 180 / 192 / 2, 200 / 193 / 2, 150 / 194 / 2, 193 / 195 / 2, 84 / 196 / 2, 164 / 197 / 2, 113 / 198 / 3, 218 / 199 / 2, 143 / 200 / 2, 30 / 201 / 3, 125 / 202 / 2, 224 / 203 / 3, 211 / 204 / 2, 226 / 205 / 2, 6 / 206 / 2, 37 / 207 / 2, 85 / 210 / 3, 205 / 212 / 3, 9 / 213 / 2, 199 / 214 / 3, 157 / 217 / 3, 238 / 218 / 2, 79 / 219 / 3, 206 / 220 / 2, 68 / 221 / 2, 225 / 222 / 2, 130 / 223 / 4, 227 / 225 / 2, 124 / 226 / 3, 95 / 227 / 2, 18 / 228 / 3, 82 / 229 / 2, 158 / 230 / 3, 27 / 231 / 2, 204 / 232 / 2, 203 / 233 / 2, 152 / 234 / 2, 141 / 235 / 3, 126 / 236 / 2, 28 / 237 / 3, 134 / 238 / 2, 217 / 239 / 2, 54 / 240 / 2, 132 / 241 / 2, 43 / 242 / 2, 87 / 243 / 3, 88 / 244 / 2, 60 / 247 / 2, 170 / 248 / 2, 44 / 249 / 9
uniform-alpha_1-116-n250.txt, 1, 1, 250, 1233.17, 1744, 1494, 5, 229,14 / 1 / 2, 140 / 2 / 2, 187 / 3 / 3, 190 / 5 / 3, 27 / 6 / 2, 62 / 7 / 2, 185 / 8 / 2, 66 / 9 / 2, 64 / 10 / 5, 85 / 11 / 2, 154 / 13 / 2, 206 / 14 / 2, 142 / 15 / 3, 76 / 16 / 2, 245 / 18 / 3, 192 / 19 / 2, 158 / 20 / 2, 90 / 21 / 2, 97 / 22 / 2, 209 / 23 / 3, 53 / 24 / 2, 170 / 25 / 3, 130 / 26 / 2, 23 / 27 / 2, 28 / 28 / 3, 153 / 29 / 2, 235 / 30 / 2, 169 / 31 / 2, 88 / 32 / 4, 174 / 33 / 2, 175 / 34 / 2, 246 / 35 / 4, 74 / 37 / 2, 63 / 38 / 2, 101 / 39 / 2, 35 / 40 / 4, 13 / 41 / 2, 220 / 42 / 2, 33 / 43 / 3, 4 / 44 / 2, 241 / 45 / 3, 69 / 46 / 2, 151 / 47 / 2, 243 / 48 / 2, 184 / 49 / 4, 234 / 50 / 2, 46 / 51 / 2, 204 / 52 / 2, 2 / 53 / 4, 109 / 54 / 2, 173 / 55 / 3, 31 / 56 / 2, 40 / 57 / 2, 127 / 58 / 2, 207 / 59 / 3, 81 / 60 / 2, 60 / 61 / 3, 228 / 62 / 2, 172 / 63 / 2, 242 / 64 / 2, 50 / 65 / 2, 83 / 66 / 2, 233 / 67 / 2, 21 / 68 / 2, 183 / 69 / 2, 48 / 70 / 3, 166 / 71 / 2, 116 / 74 / 3, 99 / 75 / 2, 121 / 76 / 2, 98 / 77 / 2, 19 / 78 / 2, 211 / 79 / 3, 43 / 80 / 2, 191 / 81 / 3, 138 / 82 / 2, 124 / 83 / 2, 111 / 84 / 2, 203 / 85 / 2, 137 / 86 / 2, 238 / 87 / 2, 58 / 88 / 3, 123 / 89 / 2, 237 / 90 / 2, 224 / 91 / 3, 201 / 93 / 2, 145 / 94 / 2, 110 / 95 / 3, 15 / 96 / 2, 171 / 97 / 3, 38 / 98 / 2, 222 / 99 / 2, 122 / 100 / 3, 77 / 101 / 2, 156 / 102 / 2, 212 / 103 / 2, 161 / 104 / 3, 177 / 105 / 2, 30 / 107 / 2, 195 / 108 / 3, 216 / 109 / 2, 11 / 110 / 2, 54 / 112 / 2, 95 / 113 / 2, 92 / 114 / 2, 22 / 115 / 3, 37 / 116 / 2, 68 / 117 / 3, 131 / 118 / 2, 29 / 119 / 2, 114 / 120 / 2, 219 / 121 / 2, 107 / 122 / 3, 55 / 123 / 2, 230 / 124 / 2, 86 / 125 / 4, 89 / 128 / 3, 71 / 131 / 3, 100 / 132 / 2, 152 / 133 / 3, 159 / 134 / 2, 117 / 135 / 2, 147 / 136 / 4, 213 / 137 / 2, 45 / 139 / 2, 108 / 140 / 4, 226 / 141 / 2, 229 / 142 / 2, 240 / 143 / 3, 51 / 144 / 2, 160 / 145 / 2, 165 / 146 / 2, 208 / 147 / 5, 188 / 148 / 2, 196 / 149 / 3, 102 / 150 / 2, 118 / 151 / 2, 120 / 152 / 2, 104 / 153 / 3, 67 / 154 / 2, 80 / 155 / 2, 210 / 156 / 2, 8 / 157 / 2, 12 / 158 / 2, 44 / 159 / 3, 180 / 160 / 2, 231 / 161 / 2, 194 / 162 / 2, 9 / 163 / 2, 168 / 167 / 3, 79 / 168 / 2, 103 / 169 / 2, 244 / 170 / 4, 134 / 171 / 2, 214 / 172 / 2, 225 / 173 / 2, 133 / 174 / 2, 91 / 175 / 4, 20 / 176 / 2, 94 / 177 / 2, 106 / 178 / 3, 167 / 179 / 2, 3 / 180 / 2, 149 / 181 / 2, 70 / 182 / 2, 202 / 183 / 2, 26 / 184 / 2, 157 / 185 / 3, 223 / 186 / 2, 143 / 187 / 3, 193 / 188 / 2, 41 / 189 / 2, 128 / 190 / 2, 182 / 191 / 3, 25 / 192 / 2, 57 / 193 / 2, 5 / 194 / 4, 52 / 195 / 2, 179 / 196 / 2, 17 / 197 / 3, 6 / 198 / 2, 236 / 199 / 2, 65 / 200 / 3, 200 / 201 / 2, 119 / 202 / 3, 146 / 203 / 2, 112 / 204 / 3, 73 / 205 / 2, 10 / 207 / 3, 176 / 208 / 2, 113 / 209 / 2, 129 / 210 / 2, 198 / 211 / 2, 163 / 212 / 2, 42 / 213 / 3, 178 / 214 / 2, 47 / 215 / 2, 144 / 216 / 2, 36 / 217 / 2, 82 / 218 / 5, 136 / 219 / 2, 16 / 220 / 2, 125 / 221 / 3, 248 / 222 / 2, 197 / 223 / 4, 78 / 224 / 2, 162 / 225 / 3, 221 / 226 / 2, 49 / 227 / 2, 186 / 230 / 2, 227 / 231 / 3, 61 / 232 / 2, 199 / 233 / 3, 218 / 234 / 2, 32 / 235 / 3, 247 / 236 / 2, 132 / 237 / 4, 135 / 238 / 2, 96 / 239 / 3, 189 / 240 / 2, 148 / 241 / 3, 87 / 242 / 2, 155 / 243 / 5, 84 / 244 / 2, 232 / 245 / 2, 139 / 246 / 3, 56 / 247 / 2, 39 / 248 / 2, 75 / 249 / 3
uniform-alpha_1-117-n250.txt, 1, 1, 250, 1293.67, 1734, 1484, 6, 237,122 / 1 / 3, 219 / 2 / 2, 135 / 3 / 3, 134 / 4 / 2, 65 / 5 / 2, 160 / 6 / 2, 165 / 7 / 2, 150 / 8 / 2, 38 / 9 / 2, 222 / 10 / 2, 132 / 11 / 3, 68 / 12 / 2, 192 / 13 / 3, 166 / 14 / 2, 213 / 15 / 2, 57 / 16 / 4, 226 / 17 / 2, 235 / 18 / 2, 218 / 19 / 2, 10 / 20 / 2, 46 / 21 / 2, 197 / 22 / 4, 147 / 23 / 2, 91 / 24 / 2, 22 / 25 / 3, 142 / 26 / 2, 7 / 27 / 2, 231 / 28 / 2, 151 / 29 / 2, 211 / 30 / 3, 206 / 31 / 2, 3 / 32 / 2, 67 / 33 / 3, 53 / 34 / 2, 96 / 35 / 2, 129 / 36 / 3, 195 / 37 / 2, 169 / 38 / 3, 228 / 40 / 2, 136 / 41 / 4, 179 / 42 / 2, 85 / 45 / 2, 221 / 46 / 3, 77 / 47 / 2, 123 / 48 / 2, 25 / 49 / 2, 153 / 50 / 3, 246 / 51 / 2, 223 / 52 / 2, 209 / 53 / 4, 61 / 54 / 2, 35 / 55 / 2, 107 / 56 / 2, 172 / 57 / 2, 229 / 58 / 3, 27 / 59 / 2, 239 / 60 / 2, 24 / 61 / 2, 124 / 62 / 2, 110 / 63 / 2, 95 / 64 / 6, 43 / 65 / 2, 36 / 66 / 3, 207 / 67 / 2, 79 / 68 / 2, 191 / 69 / 2, 139 / 70 / 2, 193 / 71 / 2, 245 / 72 / 4, 130 / 73 / 2, 174 / 74 / 2, 184 / 75 / 2, 98 / 76 / 3, 137 / 77 / 2, 55 / 78 / 2, 171 / 79 / 3, 234 / 80 / 2, 74 / 81 / 2, 187 / 82 / 2, 111 / 83 / 2, 154 / 84 / 4, 117 / 85 / 2, 183 / 86 / 2, 227 / 87 / 2, 16 / 88 / 2, 108 / 90 / 2, 72 / 91 / 2, 71 / 92 / 4, 161 / 93 / 2, 186 / 94 / 2, 212 / 95 / 2, 54 / 96 / 2, 113 / 97 / 2, 185 / 98 / 3, 47 / 99 / 2, 133 / 100 / 2, 18 / 101 / 3, 37 / 102 / 2, 158 / 103 / 2, 248 / 104 / 3, 189 / 105 / 2, 203 / 106 / 3, 204 / 107 / 2, 146 / 108 / 2, 42 / 109 / 5, 236 / 110 / 2, 101 / 111 / 2, 230 / 112 / 2, 23 / 113 / 2, 156 / 114 / 2, 105 / 115 / 2, 210 / 116 / 3, 32 / 117 / 2, 118 / 118 / 3, 30 / 119 / 2, 242 / 120 / 2, 2 / 121 / 2, 159 / 122 / 2, 168 / 123 / 3, 237 / 125 / 3, 224 / 126 / 2, 28 / 127 / 3, 13 / 128 / 2, 9 / 129 / 3, 76 / 130 / 2, 19 / 131 / 3, 126 / 132 / 2, 17 / 133 / 2, 190 / 134 / 2, 112 / 135 / 2, 8 / 136 / 2, 60 / 137 / 2, 97 / 138 / 3, 34 / 139 / 2, 116 / 140 / 3, 144 / 141 / 2, 173 / 142 / 2, 15 / 143 / 2, 75 / 144 / 2, 181 / 145 / 2, 56 / 146 / 4, 106 / 147 / 2, 94 / 148 / 2, 31 / 149 / 2, 14 / 150 / 3, 180 / 151 / 2, 88 / 152 / 2, 64 / 153 / 2, 140 / 154 / 2, 196 / 155 / 4, 93 / 156 / 2, 103 / 157 / 3, 162 / 158 / 2, 176 / 159 / 3, 45 / 160 / 2, 92 / 161 / 2, 100 / 162 / 2, 157 / 163 / 2, 62 / 164 / 2, 40 / 165 / 2, 200 / 168 / 3, 83 / 169 / 2, 205 / 170 / 3, 87 / 171 / 2, 240 / 172 / 3, 84 / 173 / 2, 145 / 174 / 2, 249 / 175 / 2, 155 / 176 / 2, 175 / 177 / 4, 202 / 178 / 2, 90 / 179 / 2, 114 / 180 / 2, 78 / 181 / 3, 4 / 182 / 2, 164 / 183 / 2, 194 / 184 / 4, 121 / 185 / 2, 127 / 186 / 2, 66 / 189 / 3, 182 / 192 / 4, 82 / 193 / 2, 232 / 194 / 2, 26 / 195 / 3, 48 / 196 / 2, 138 / 197 / 2, 33 / 198 / 4, 141 / 199 / 2, 86 / 200 / 2, 58 / 201 / 2, 44 / 202 / 3, 70 / 203 / 2, 178 / 204 / 3, 89 / 205 / 2, 131 / 206 / 2, 188 / 207 / 2, 20 / 208 / 2, 152 / 209 / 2, 215 / 211 / 2, 233 / 212 / 2, 149 / 213 / 3, 11 / 214 / 2, 241 / 215 / 3, 163 / 216 / 2, 80 / 217 / 2, 128 / 218 / 2, 73 / 219 / 3, 99 / 220 / 2, 21 / 221 / 2, 115 / 222 / 4, 109 / 223 / 2, 29 / 224 / 2, 238 / 225 / 4, 52 / 226 / 2, 69 / 227 / 2, 41 / 228 / 2, 143 / 229 / 3, 102 / 230 / 2, 39 / 231 / 3, 12 / 232 / 2, 243 / 233 / 3, 217 / 234 / 2, 201 / 235 / 3, 198 / 236 / 2, 6 / 237 / 2, 81 / 238 / 2, 49 / 239 / 4, 59 / 240 / 2, 220 / 241 / 2, 177 / 242 / 2, 50 / 243 / 3, 51 / 244 / 2, 5 / 245 / 2, 214 / 246 / 2, 216 / 247 / 2, 104 / 248 / 2, 119 / 249 / 3
uniform-alpha_1-118-n250.txt, 1, 1, 250, 1165.09, 1811, 1561, 7, 240,79 / 1 / 2, 126 / 2 / 7, 97 / 4 / 3, 177 / 6 / 2, 111 / 7 / 2, 219 / 8 / 3, 67 / 9 / 2, 232 / 10 / 3, 154 / 11 / 2, 229 / 12 / 3, 178 / 13 / 2, 123 / 14 / 3, 196 / 15 / 2, 99 / 16 / 2, 213 / 17 / 2, 96 / 18 / 2, 173 / 19 / 2, 20 / 20 / 3, 71 / 21 / 2, 45 / 22 / 3, 143 / 23 / 2, 142 / 24 / 2, 92 / 25 / 2, 102 / 26 / 5, 233 / 27 / 2, 65 / 28 / 2, 211 / 29 / 3, 200 / 30 / 2, 46 / 31 / 2, 33 / 32 / 2, 47 / 33 / 4, 18 / 34 / 2, 151 / 35 / 3, 39 / 36 / 2, 190 / 37 / 3, 197 / 38 / 2, 193 / 39 / 4, 73 / 40 / 2, 169 / 41 / 2, 35 / 42 / 2, 182 / 43 / 3, 225 / 44 / 2, 239 / 45 / 3, 82 / 46 / 2, 4 / 47 / 3, 19 / 48 / 2, 1 / 49 / 3, 44 / 50 / 2, 140 / 51 / 2, 181 / 52 / 2, 87 / 53 / 2, 42 / 54 / 2, 70 / 55 / 2, 109 / 56 / 2, 245 / 57 / 2, 166 / 58 / 3, 16 / 59 / 2, 147 / 60 / 2, 189 / 61 / 2, 63 / 62 / 5, 114 / 63 / 2, 108 / 64 / 2, 24 / 65 / 2, 131 / 66 / 4, 194 / 67 / 2, 21 / 68 / 2, 199 / 69 / 3, 68 / 70 / 2, 141 / 71 / 2, 81 / 72 / 6, 103 / 73 / 2, 240 / 74 / 3, 198 / 75 / 2, 132 / 76 / 2, 54 / 77 / 3, 78 / 78 / 2, 180 / 79 / 2, 137 / 80 / 3, 9 / 81 / 2, 226 / 82 / 2, 62 / 83 / 2, 228 / 84 / 2, 164 / 85 / 3, 236 / 87 / 2, 110 / 88 / 2, 52 / 89 / 2, 136 / 90 / 2, 55 / 91 / 2, 208 / 92 / 2, 84 / 93 / 4, 248 / 94 / 2, 201 / 95 / 2, 36 / 96 / 3, 183 / 97 / 2, 152 / 98 / 2, 185 / 99 / 3, 133 / 100 / 2, 26 / 101 / 2, 235 / 102 / 2, 85 / 103 / 2, 159 / 104 / 2, 170 / 105 / 2, 48 / 106 / 3, 156 / 107 / 2, 8 / 108 / 2, 112 / 109 / 3, 116 / 110 / 2, 168 / 111 / 2, 75 / 112 / 2, 209 / 113 / 2, 223 / 114 / 5, 217 / 115 / 2, 139 / 116 / 2, 135 / 117 / 2, 51 / 118 / 4, 134 / 122 / 3, 27 / 123 / 2, 11 / 124 / 4, 222 / 125 / 2, 10 / 126 / 2, 122 / 127 / 3, 157 / 128 / 2, 207 / 129 / 2, 31 / 130 / 2, 148 / 131 / 2, 242 / 132 / 4, 179 / 133 / 2, 2 / 134 / 3, 214 / 135 / 2, 53 / 136 / 3, 187 / 137 / 2, 176 / 138 / 2, 172 / 139 / 3, 171 / 140 / 2, 138 / 141 / 2, 234 / 142 / 5, 72 / 143 / 2, 127 / 144 / 2, 41 / 145 / 4, 113 / 146 / 2, 243 / 147 / 3, 93 / 148 / 2, 162 / 149 / 5, 227 / 150 / 2, 56 / 151 / 2, 206 / 152 / 2, 224 / 153 / 2, 212 / 154 / 2, 202 / 155 / 2, 100 / 156 / 2, 69 / 157 / 4, 57 / 158 / 2, 129 / 159 / 2, 221 / 160 / 2, 88 / 161 / 3, 244 / 162 / 2, 238 / 163 / 2, 94 / 164 / 3, 83 / 165 / 2, 184 / 166 / 2, 91 / 167 / 2, 174 / 168 / 2, 104 / 169 / 2, 124 / 170 / 2, 40 / 171 / 3, 37 / 172 / 2, 128 / 174 / 2, 220 / 175 / 2, 13 / 176 / 2, 3 / 177 / 3, 23 / 178 / 2, 30 / 179 / 2, 74 / 180 / 4, 105 / 181 / 2, 66 / 182 / 2, 160 / 183 / 3, 95 / 184 / 2, 115 / 185 / 3, 146 / 186 / 2, 230 / 187 / 2, 117 / 188 / 3, 64 / 189 / 2, 186 / 190 / 2, 205 / 191 / 2, 237 / 192 / 2, 158 / 193 / 3, 17 / 194 / 2, 130 / 195 / 3, 118 / 196 / 2, 86 / 197 / 3, 7 / 198 / 2, 247 / 199 / 3, 76 / 201 / 2, 153 / 202 / 2, 218 / 203 / 3, 155 / 204 / 2, 89 / 205 / 2, 34 / 206 / 2, 175 / 207 / 3, 195 / 208 / 2, 188 / 209 / 2, 167 / 210 / 3, 15 / 211 / 2, 106 / 212 / 2, 98 / 213 / 2, 203 / 214 / 3, 163 / 216 / 3, 231 / 217 / 2, 43 / 218 / 3, 12 / 219 / 2, 101 / 220 / 2, 107 / 221 / 2, 60 / 222 / 3, 50 / 223 / 2, 246 / 224 / 3, 192 / 225 / 2, 5 / 226 / 3, 80 / 227 / 2, 22 / 228 / 2, 191 / 229 / 4, 77 / 230 / 2, 120 / 231 / 2, 32 / 232 / 3, 49 / 233 / 2, 161 / 234 / 2, 249 / 235 / 4, 216 / 236 / 2, 215 / 237 / 2, 204 / 238 / 3, 6 / 239 / 2, 210 / 240 / 3, 149 / 241 / 2, 165 / 242 / 2, 121 / 243 / 2, 28 / 244 / 2, 25 / 245 / 3, 145 / 246 / 2, 144 / 247 / 5, 59 / 248 / 2, 119 / 249 / 3
uniform-alpha_1-119-n250.txt, 1, 1, 250, 1330.93, 1873, 1623, 6, 243,30 / 1 / 2, 171 / 2 / 3, 67 / 3 / 2, 225 / 4 / 2, 147 / 5 / 2, 215 / 6 / 2, 27 / 7 / 2, 35 / 8 / 2, 223 / 9 / 2, 121 / 10 / 4, 245 / 11 / 2, 115 / 12 / 2, 59 / 13 / 3, 18 / 14 / 2, 160 / 15 / 2, 152 / 16 / 3, 37 / 17 / 2, 233 / 18 / 3, 235 / 19 / 2, 104 / 20 / 2, 224 / 21 / 2, 34 / 22 / 2, 105 / 23 / 2, 119 / 24 / 2, 120 / 25 / 3, 177 / 26 / 2, 110 / 27 / 3, 75 / 28 / 2, 218 / 29 / 3, 187 / 30 / 2, 42 / 31 / 3, 140 / 32 / 2, 157 / 33 / 3, 11 / 34 / 2, 216 / 35 / 2, 139 / 36 / 2, 183 / 37 / 3, 122 / 38 / 2, 219 / 39 / 3, 237 / 40 / 2, 242 / 41 / 2, 58 / 42 / 3, 24 / 45 / 3, 124 / 46 / 2, 179 / 47 / 2, 153 / 48 / 3, 70 / 50 / 2, 170 / 51 / 2, 41 / 52 / 3, 116 / 53 / 2, 164 / 54 / 3, 108 / 55 / 2, 130 / 56 / 3, 186 / 57 / 2, 143 / 58 / 2, 79 / 59 / 3, 204 / 60 / 2, 243 / 61 / 2, 210 / 62 / 2, 132 / 63 / 3, 103 / 64 / 2, 239 / 65 / 3, 191 / 66 / 2, 96 / 67 / 3, 107 / 68 / 2, 145 / 69 / 3, 73 / 70 / 2, 188 / 71 / 4, 163 / 72 / 2, 202 / 73 / 2, 33 / 74 / 4, 43 / 75 / 2, 249 / 76 / 2, 29 / 77 / 3, 118 / 78 / 2, 141 / 79 / 3, 158 / 80 / 2, 60 / 81 / 2, 133 / 82 / 5, 142 / 84 / 2, 144 / 85 / 2, 137 / 86 / 3, 229 / 87 / 2, 87 / 88 / 2, 54 / 89 / 4, 91 / 90 / 2, 86 / 91 / 3, 226 / 92 / 2, 236 / 93 / 5, 209 / 94 / 2, 7 / 95 / 2, 38 / 96 / 3, 156 / 97 / 2, 16 / 98 / 3, 165 / 99 / 2, 221 / 100 / 2, 80 / 101 / 5, 227 / 102 / 2, 78 / 103 / 2, 178 / 104 / 2, 134 / 105 / 2, 40 / 106 / 3, 231 / 107 / 2, 232 / 108 / 3, 64 / 109 / 2, 82 / 110 / 2, 6 / 111 / 4, 88 / 112 / 2, 71 / 113 / 2, 49 / 114 / 2, 246 / 115 / 3, 51 / 116 / 2, 95 / 117 / 3, 93 / 118 / 2, 217 / 119 / 2, 94 / 120 / 2, 205 / 121 / 2, 149 / 122 / 3, 150 / 123 / 2, 14 / 124 / 3, 112 / 125 / 2, 240 / 126 / 2, 81 / 127 / 2, 198 / 128 / 2, 8 / 129 / 2, 174 / 130 / 2, 146 / 131 / 2, 166 / 132 / 2, 211 / 133 / 3, 76 / 134 / 2, 63 / 135 / 2, 172 / 136 / 3, 28 / 137 / 2, 192 / 138 / 2, 162 / 139 / 2, 98 / 140 / 2, 167 / 141 / 4, 47 / 142 / 2, 1 / 143 / 2, 25 / 144 / 4, 50 / 145 / 2, 39 / 146 / 3, 45 / 147 / 2, 62 / 148 / 2, 32 / 149 / 3, 212 / 150 / 2, 241 / 151 / 2, 23 / 152 / 2, 207 / 153 / 2, 56 / 154 / 2, 109 / 155 / 6, 200 / 156 / 2, 22 / 157 / 2, 31 / 158 / 2, 26 / 159 / 2, 97 / 160 / 2, 201 / 161 / 4, 90 / 162 / 2, 247 / 163 / 2, 10 / 164 / 5, 92 / 165 / 2, 69 / 166 / 2, 12 / 167 / 2, 36 / 168 / 4, 5 / 169 / 2, 185 / 170 / 2, 9 / 171 / 2, 136 / 172 / 3, 182 / 173 / 2, 228 / 174 / 2, 193 / 175 / 3, 102 / 176 / 2, 46 / 177 / 3, 148 / 178 / 2, 84 / 179 / 3, 68 / 180 / 2, 135 / 181 / 2, 128 / 182 / 3, 230 / 183 / 2, 238 / 184 / 3, 72 / 185 / 2, 248 / 186 / 2, 195 / 187 / 2, 66 / 188 / 3, 111 / 189 / 2, 85 / 190 / 2, 101 / 192 / 3, 89 / 194 / 3, 168 / 195 / 2, 161 / 196 / 4, 151 / 197 / 2, 203 / 198 / 2, 220 / 199 / 2, 48 / 200 / 2, 131 / 201 / 2, 83 / 202 / 2, 100 / 203 / 2, 189 / 204 / 3, 3 / 205 / 2, 13 / 206 / 2, 159 / 207 / 4, 176 / 208 / 2, 53 / 209 / 2, 214 / 210 / 2, 21 / 211 / 3, 57 / 212 / 2, 213 / 213 / 2, 173 / 214 / 3, 190 / 215 / 2, 74 / 216 / 3, 61 / 217 / 2, 4 / 218 / 2, 181 / 219 / 6, 125 / 220 / 2, 138 / 221 / 2, 106 / 222 / 3, 222 / 223 / 2, 184 / 224 / 5, 234 / 225 / 2, 199 / 226 / 3, 65 / 227 / 2, 169 / 228 / 2, 55 / 229 / 3, 77 / 230 / 2, 113 / 231 / 2, 114 / 232 / 4, 197 / 233 / 2, 44 / 234 / 2, 52 / 235 / 3, 206 / 236 / 2, 99 / 237 / 2, 196 / 238 / 2, 154 / 239 / 2, 244 / 240 / 4, 155 / 241 / 2, 20 / 242 / 3, 180 / 243 / 2, 194 / 244 / 2, 123 / 245 / 4, 175 / 246 / 2, 126 / 247 / 2, 127 / 248 / 3, 117 / 249 / 2
uniform-alpha_1-12-n375.txt, 1, 1, 375, 1608.68, 2714, 2339, 6, 352,37 / 1 / 2, 173 / 2 / 3, 91 / 5 / 2, 175 / 6 / 4, 29 / 7 / 2, 367 / 8 / 2, 365 / 9 / 3, 235 / 10 / 2, 295 / 11 / 3, 43 / 12 / 2, 335 / 13 / 2, 200 / 14 / 3, 53 / 15 / 2, 26 / 16 / 2, 272 / 17 / 3, 330 / 18 / 2, 131 / 19 / 2, 77 / 20 / 2, 269 / 21 / 2, 86 / 22 / 2, 249 / 23 / 2, 15 / 24 / 2, 127 / 25 / 2, 27 / 26 / 3, 207 / 27 / 2, 124 / 28 / 4, 306 / 29 / 2, 356 / 30 / 2, 305 / 31 / 2, 255 / 32 / 2, 138 / 33 / 3, 313 / 34 / 2, 97 / 35 / 3, 116 / 36 / 2, 216 / 37 / 2, 296 / 38 / 3, 340 / 39 / 2, 154 / 40 / 2, 74 / 41 / 4, 373 / 42 / 2, 18 / 44 / 4, 2 / 45 / 2, 245 / 46 / 3, 112 / 47 / 2, 133 / 48 / 2, 64 / 49 / 3, 145 / 50 / 2, 300 / 51 / 3, 366 / 52 / 2, 265 / 53 / 2, 44 / 54 / 2, 258 / 55 / 2, 10 / 56 / 2, 16 / 57 / 3, 250 / 58 / 2, 194 / 59 / 2, 283 / 60 / 4, 195 / 61 / 2, 31 / 62 / 2, 40 / 63 / 4, 100 / 64 / 2, 219 / 65 / 2, 66 / 66 / 3, 132 / 67 / 2, 217 / 68 / 3, 123 / 69 / 2, 23 / 70 / 2, 198 / 71 / 2, 349 / 72 / 4, 125 / 73 / 2, 293 / 74 / 2, 67 / 75 / 2, 336 / 76 / 2, 312 / 77 / 4, 5 / 78 / 2, 364 / 79 / 2, 59 / 80 / 4, 231 / 81 / 2, 130 / 82 / 3, 354 / 83 / 2, 191 / 84 / 4, 266 / 85 / 2, 121 / 86 / 2, 47 / 87 / 2, 368 / 88 / 2, 19 / 89 / 4, 281 / 90 / 2, 277 / 91 / 3, 51 / 92 / 2, 7 / 93 / 2, 183 / 94 / 4, 171 / 95 / 2, 370 / 96 / 3, 240 / 97 / 2, 241 / 98 / 2, 94 / 99 / 2, 169 / 100 / 3, 101 / 101 / 2, 352 / 102 / 3, 70 / 103 / 2, 42 / 104 / 3, 46 / 105 / 2, 9 / 106 / 2, 56 / 107 / 2, 260 / 108 / 2, 222 / 109 / 2, 202 / 110 / 5, 84 / 111 / 2, 136 / 112 / 3, 351 / 113 / 2, 248 / 114 / 2, 270 / 115 / 3, 227 / 116 / 2, 204 / 117 / 3, 157 / 118 / 2, 39 / 119 / 3, 122 / 120 / 2, 153 / 121 / 3, 232 / 122 / 2, 237 / 123 / 2, 155 / 124 / 2, 52 / 125 / 2, 20 / 126 / 3, 297 / 127 / 2, 371 / 128 / 3, 358 / 129 / 2, 179 / 130 / 2, 328 / 131 / 2, 48 / 132 / 2, 268 / 133 / 3, 99 / 134 / 2, 17 / 135 / 3, 193 / 138 / 2, 321 / 139 / 3, 230 / 140 / 2, 234 / 141 / 2, 57 / 142 / 2, 174 / 143 / 2, 254 / 144 / 2, 158 / 145 / 2, 333 / 146 / 3, 163 / 147 / 2, 359 / 148 / 2, 225 / 149 / 3, 279 / 150 / 2, 4 / 151 / 2, 369 / 152 / 2, 318 / 153 / 2, 156 / 154 / 2, 150 / 155 / 2, 304 / 156 / 4, 38 / 157 / 2, 162 / 158 / 2, 147 / 159 / 2, 259 / 160 / 2, 102 / 161 / 3, 360 / 162 / 2, 25 / 163 / 3, 21 / 164 / 2, 218 / 165 / 3, 357 / 166 / 2, 348 / 167 / 2, 118 / 168 / 6, 80 / 169 / 2, 287 / 170 / 3, 344 / 171 / 2, 90 / 172 / 2, 186 / 173 / 4, 298 / 174 / 2, 343 / 175 / 2, 160 / 176 / 2, 75 / 177 / 2, 223 / 178 / 2, 342 / 179 / 2, 299 / 180 / 3, 201 / 181 / 2, 82 / 182 / 2, 347 / 183 / 3, 60 / 184 / 2, 185 / 186 / 2, 110 / 187 / 2, 289 / 188 / 2, 13 / 189 / 2, 177 / 190 / 2, 322 / 191 / 2, 103 / 192 / 2, 1 / 193 / 2, 264 / 194 / 2, 262 / 195 / 4, 192 / 196 / 2, 361 / 197 / 3, 115 / 198 / 2, 303 / 199 / 3, 104 / 200 / 2, 182 / 201 / 2, 140 / 202 / 4, 276 / 203 / 2, 11 / 204 / 2, 54 / 205 / 2, 117 / 206 / 2, 314 / 207 / 2, 181 / 208 / 6, 165 / 212 / 2, 280 / 213 / 4, 68 / 214 / 2, 209 / 215 / 2, 137 / 216 / 2, 30 / 217 / 2, 134 / 218 / 3, 337 / 219 / 2, 205 / 220 / 3, 73 / 222 / 3, 143 / 223 / 2, 167 / 224 / 2, 224 / 227 / 3, 320 / 228 / 2, 180 / 229 / 2, 12 / 230 / 2, 319 / 231 / 2, 325 / 232 / 3, 106 / 233 / 2, 142 / 234 / 2, 326 / 235 / 3, 187 / 236 / 2, 290 / 237 / 2, 275 / 238 / 3, 238 / 239 / 2, 88 / 240 / 3, 96 / 241 / 2, 311 / 242 / 2, 226 / 243 / 3, 129 / 244 / 2, 33 / 245 / 2, 35 / 246 / 3, 327 / 247 / 2, 24 / 248 / 2, 317 / 249 / 3, 253 / 250 / 2, 89 / 251 / 3, 119 / 253 / 3, 274 / 254 / 2, 302 / 255 / 3, 362 / 257 / 3, 239 / 258 / 2, 309 / 259 / 3, 14 / 260 / 2, 178 / 261 / 3, 108 / 262 / 2, 331 / 263 / 2, 189 / 264 / 4, 242 / 265 / 2, 307 / 267 / 4, 294 / 268 / 2, 22 / 269 / 2, 206 / 270 / 3, 168 / 271 / 2, 128 / 274 / 2, 176 / 275 / 2, 63 / 276 / 2, 135 / 277 / 2, 50 / 278 / 2, 284 / 279 / 3, 278 / 280 / 2, 350 / 281 / 2, 72 / 282 / 4, 229 / 283 / 2, 188 / 284 / 2, 220 / 285 / 2, 316 / 286 / 3, 310 / 287 / 2, 288 / 288 / 2, 164 / 289 / 3, 49 / 290 / 2, 152 / 291 / 3, 170 / 293 / 2, 126 / 294 / 4, 34 / 295 / 2, 98 / 296 / 2, 199 / 297 / 4, 286 / 298 / 2, 236 / 300 / 3, 374 / 301 / 2, 144 / 302 / 2, 208 / 303 / 2, 346 / 304 / 2, 69 / 305 / 2, 6 / 306 / 2, 341 / 308 / 2, 93 / 309 / 4, 159 / 310 / 2, 273 / 311 / 2, 139 / 312 / 2, 71 / 313 / 2, 212 / 314 / 3, 107 / 315 / 2, 271 / 316 / 3, 324 / 317 / 2, 81 / 318 / 3, 215 / 319 / 2, 45 / 320 / 2, 263 / 321 / 2, 315 / 322 / 3, 214 / 323 / 2, 3 / 324 / 3, 172 / 325 / 2, 372 / 326 / 2, 148 / 327 / 2, 166 / 328 / 2, 184 / 329 / 2, 267 / 330 / 2, 87 / 331 / 3, 251 / 332 / 2, 291 / 333 / 2, 190 / 334 / 3, 79 / 335 / 2, 329 / 336 / 3, 197 / 337 / 2, 338 / 338 / 2, 149 / 339 / 4, 109 / 340 / 2, 105 / 341 / 2, 339 / 342 / 3, 292 / 343 / 2, 28 / 344 / 3, 92 / 347 / 2, 8 / 348 / 2, 261 / 349 / 2, 203 / 350 / 2, 285 / 351 / 3, 233 / 352 / 2, 111 / 353 / 3, 282 / 354 / 2, 62 / 355 / 3, 345 / 356 / 2, 257 / 357 / 2, 334 / 358 / 2, 323 / 359 / 5, 83 / 360 / 2, 78 / 361 / 3, 95 / 362 / 2, 252 / 363 / 3, 308 / 364 / 2, 228 / 365 / 2, 353 / 366 / 2, 61 / 367 / 2, 120 / 368 / 3, 301 / 369 / 2, 211 / 370 / 2, 161 / 371 / 2, 363 / 372 / 3, 213 / 373 / 2, 141 / 374 / 2
uniform-alpha_1-12-n500.txt, 1, 1, 500, 1826.91, 3676, 3176, 7, 448,498 / 1 / 2, 271 / 2 / 6, 49 / 3 / 2, 272 / 4 / 3, 331 / 5 / 2, 104 / 8 / 4, 407 / 9 / 2, 488 / 10 / 3, 151 / 11 / 2, 37 / 12 / 2, 366 / 13 / 2, 111 / 14 / 4, 101 / 15 / 2, 497 / 16 / 2, 142 / 17 / 3, 61 / 18 / 2, 447 / 19 / 2, 229 / 20 / 2, 208 / 21 / 2, 191 / 22 / 5, 178 / 23 / 2, 30 / 24 / 2, 320 / 25 / 3, 356 / 26 / 2, 129 / 27 / 3, 438 / 28 / 2, 193 / 30 / 2, 128 / 31 / 5, 286 / 32 / 2, 419 / 33 / 3, 192 / 34 / 2, 429 / 35 / 3, 468 / 36 / 2, 313 / 37 / 3, 427 / 39 / 5, 10 / 40 / 2, 123 / 41 / 2, 88 / 42 / 2, 449 / 43 / 2, 486 / 44 / 2, 39 / 45 / 2, 34 / 46 / 5, 300 / 47 / 2, 181 / 48 / 2, 293 / 49 / 2, 383 / 50 / 2, 342 / 51 / 2, 55 / 52 / 2, 158 / 53 / 2, 290 / 54 / 3, 197 / 55 / 2, 434 / 56 / 3, 131 / 57 / 2, 69 / 58 / 4, 398 / 59 / 2, 368 / 60 / 2, 46 / 61 / 4, 76 / 62 / 2, 475 / 65 / 3, 202 / 66 / 2, 441 / 67 / 2, 236 / 68 / 4, 221 / 71 / 2, 397 / 72 / 2, 136 / 73 / 3, 482 / 74 / 2, 60 / 75 / 2, 303 / 76 / 3, 369 / 77 / 2, 26 / 78 / 2, 11 / 79 / 3, 211 / 80 / 2, 310 / 81 / 2, 155 / 83 / 2, 171 / 84 / 3, 387 / 85 / 2, 216 / 86 / 2, 334 / 87 / 2, 167 / 88 / 2, 8 / 89 / 4, 50 / 90 / 2, 335 / 94 / 2, 357 / 95 / 5, 359 / 96 / 2, 264 / 97 / 2, 252 / 98 / 2, 422 / 99 / 3, 66 / 100 / 2, 29 / 101 / 3, 249 / 102 / 2, 292 / 104 / 3, 119 / 105 / 2, 233 / 106 / 2, 218 / 109 / 2, 139 / 110 / 4, 296 / 111 / 2, 141 / 112 / 3, 282 / 113 / 2, 490 / 114 / 2, 234 / 115 / 2, 346 / 116 / 2, 317 / 117 / 3, 291 / 118 / 2, 184 / 119 / 2, 445 / 120 / 2, 389 / 121 / 4, 16 / 122 / 2, 416 / 123 / 2, 145 / 124 / 2, 371 / 125 / 3, 121 / 128 / 2, 496 / 129 / 3, 153 / 130 / 2, 276 / 131 / 3, 428 / 132 / 2, 489 / 133 / 3, 396 / 134 / 2, 22 / 135 / 2, 175 / 136 / 5, 63 / 137 / 2, 454 / 138 / 2, 420 / 139 / 2, 23 / 141 / 5, 442 / 142 / 2, 267 / 143 / 2, 199 / 144 / 2, 126 / 145 / 2, 14 / 146 / 2, 259 / 147 / 4, 92 / 148 / 2, 269 / 149 / 2, 228 / 150 / 2, 367 / 151 / 2, 200 / 152 / 3, 472 / 153 / 2, 159 / 154 / 2, 170 / 155 / 3, 250 / 156 / 2, 307 / 157 / 2, 162 / 158 / 3, 235 / 159 / 2, 132 / 160 / 2, 400 / 161 / 2, 188 / 162 / 2, 194 / 163 / 2, 499 / 164 / 2, 426 / 165 / 2, 15 / 166 / 3, 203 / 167 / 2, 372 / 168 / 3, 67 / 169 / 2, 59 / 170 / 2, 45 / 171 / 2, 463 / 172 / 2, 253 / 173 / 4, 262 / 174 / 2, 248 / 175 / 2, 329 / 176 / 2, 299 / 177 / 2, 460 / 178 / 5, 476 / 181 / 3, 374 / 183 / 2, 134 / 184 / 4, 41 / 185 / 2, 85 / 186 / 2, 27 / 187 / 3, 100 / 190 / 7, 75 / 191 / 2, 213 / 192 / 2, 89 / 193 / 2, 339 / 194 / 3, 392 / 197 / 3, 340 / 200 / 3, 332 / 201 / 2, 401 / 202 / 2, 204 / 203 / 2, 255 / 204 / 4, 105 / 205 / 2, 2 / 206 / 2, 473 / 207 / 3, 484 / 208 / 2, 295 / 209 / 2, 31 / 210 / 2, 217 / 211 / 2, 57 / 212 / 2, 117 / 213 / 3, 4 / 214 / 2, 240 / 215 / 3, 260 / 216 / 2, 114 / 217 / 2, 364 / 218 / 2, 336 / 219 / 3, 337 / 220 / 2, 24 / 221 / 2, 405 / 222 / 3, 304 / 223 / 2, 279 / 225 / 2, 223 / 226 / 3, 467 / 227 / 2, 106 / 228 / 3, 94 / 229 / 2, 169 / 230 / 2, 257 / 231 / 2, 237 / 232 / 4, 466 / 233 / 2, 212 / 234 / 2, 189 / 235 / 2, 115 / 236 / 2, 450 / 237 / 2, 470 / 238 / 2, 20 / 239 / 2, 325 / 240 / 2, 107 / 241 / 2, 461 / 242 / 2, 247 / 243 / 2, 268 / 244 / 2, 278 / 245 / 2, 102 / 246 / 3, 9 / 247 / 2, 53 / 248 / 2, 207 / 249 / 2, 187 / 250 / 4, 321 / 251 / 2, 79 / 252 / 3, 148 / 253 / 2, 5 / 254 / 4, 318 / 257 / 3, 185 / 258 / 2, 388 / 259 / 3, 381 / 260 / 2, 471 / 261 / 2, 409 / 262 / 5, 17 / 263 / 2, 341 / 264 / 2, 423 / 265 / 2, 455 / 266 / 2, 479 / 267 / 3, 315 / 268 / 2, 380 / 269 / 5, 275 / 270 / 2, 227 / 271 / 2, 226 / 272 / 2, 287 / 273 / 2, 301 / 274 / 3, 451 / 275 / 2, 487 / 276 / 2, 480 / 277 / 2, 230 / 278 / 5, 64 / 279 / 2, 373 / 280 / 3, 309 / 281 / 2, 163 / 282 / 2, 172 / 283 / 3, 32 / 284 / 2, 302 / 285 / 2, 343 / 286 / 2, 70 / 287 / 5, 327 / 288 / 2, 125 / 289 / 2, 127 / 290 / 2, 493 / 291 / 2, 133 / 292 / 5, 140 / 293 / 2, 390 / 294 / 2, 7 / 295 / 2, 333 / 296 / 2, 86 / 297 / 2, 40 / 298 / 2, 430 / 299 / 3, 384 / 300 / 2, 270 / 301 / 3, 74 / 302 / 2, 395 / 303 / 2, 195 / 304 / 3, 108 / 307 / 2, 338 / 308 / 4, 446 / 309 / 2, 42 / 310 / 2, 225 / 311 / 4, 160 / 313 / 2, 316 / 314 / 4, 440 / 316 / 2, 311 / 317 / 4, 344 / 318 / 2, 265 / 319 / 2, 116 / 320 / 3, 379 / 321 / 2, 44 / 322 / 2, 459 / 323 / 2, 183 / 324 / 2, 494 / 325 / 2, 147 / 326 / 3, 122 / 327 / 2, 215 / 328 / 6, 206 / 329 / 2, 394 / 330 / 2, 294 / 331 / 2, 93 / 332 / 2, 483 / 335 / 3, 431 / 336 / 2, 164 / 337 / 2, 168 / 338 / 2, 273 / 339 / 2, 47 / 340 / 2, 246 / 341 / 2, 284 / 342 / 2, 209 / 343 / 4, 80 / 344 / 2, 417 / 345 / 3, 436 / 346 / 2, 414 / 347 / 3, 90 / 348 / 2, 87 / 349 / 3, 103 / 350 / 2, 274 / 351 / 2, 448 / 352 / 2, 425 / 353 / 6, 362 / 354 / 2, 243 / 357 / 3, 144 / 358 / 2, 457 / 359 / 2, 402 / 360 / 2, 58 / 361 / 2, 348 / 362 / 3, 277 / 363 / 2, 124 / 364 / 2, 435 / 365 / 4, 231 / 366 / 2, 222 / 367 / 3, 350 / 368 / 2, 219 / 369 / 3, 109 / 370 / 2, 437 / 372 / 2, 161 / 373 / 2, 72 / 374 / 2, 112 / 375 / 3, 385 / 376 / 2, 77 / 377 / 3, 261 / 378 / 2, 78 / 379 / 2, 495 / 380 / 3, 198 / 382 / 2, 432 / 383 / 4, 176 / 384 / 2, 182 / 385 / 3, 289 / 386 / 2, 370 / 387 / 2, 174 / 388 / 3, 52 / 389 / 2, 375 / 390 / 2, 263 / 391 / 2, 477 / 394 / 2, 328 / 395 / 2, 353 / 396 / 2, 424 / 397 / 2, 157 / 398 / 2, 83 / 399 / 2, 254 / 400 / 7, 297 / 401 / 2, 154 / 402 / 3, 288 / 403 / 2, 71 / 404 / 2, 485 / 405 / 2, 82 / 406 / 2, 474 / 407 / 3, 224 / 408 / 2, 120 / 409 / 2, 464 / 410 / 3, 143 / 411 / 2, 180 / 412 / 3, 363 / 413 / 2, 81 / 414 / 2, 130 / 415 / 3, 13 / 416 / 2, 326 / 417 / 2, 386 / 418 / 2, 478 / 419 / 4, 418 / 422 / 3, 412 / 423 / 2, 349 / 424 / 3, 137 / 425 / 2, 399 / 426 / 3, 251 / 427 / 2, 244 / 428 / 5, 421 / 429 / 2, 382 / 430 / 2, 258 / 431 / 2, 458 / 432 / 2, 323 / 433 / 2, 462 / 434 / 2, 360 / 435 / 3, 322 / 436 / 2, 242 / 437 / 3, 444 / 438 / 2, 404 / 439 / 2, 84 / 440 / 3, 361 / 441 / 2, 196 / 442 / 2, 35 / 443 / 2, 205 / 444 / 2, 319 / 445 / 3, 232 / 446 / 2, 179 / 447 / 3, 281 / 448 / 2, 99 / 449 / 2, 3 / 450 / 2, 110 / 451 / 2, 48 / 452 / 2, 306 / 453 / 3, 266 / 454 / 2, 406 / 455 / 2, 98 / 458 / 2, 186 / 459 / 4, 285 / 460 / 2, 355 / 461 / 2, 62 / 462 / 2, 38 / 463 / 2, 241 / 464 / 2, 12 / 467 / 3, 465 / 468 / 2, 314 / 469 / 3, 190 / 470 / 2, 408 / 471 / 3, 492 / 472 / 2, 491 / 473 / 2, 214 / 474 / 2, 456 / 475 / 4, 113 / 476 / 2, 19 / 477 / 2, 413 / 478 / 2, 6 / 479 / 2, 345 / 480 / 2, 469 / 481 / 4, 453 / 482 / 2, 65 / 483 / 3, 1 / 485 / 4, 351 / 486 / 2, 118 / 487 / 2, 312 / 488 / 2, 210 / 489 / 2, 56 / 490 / 2, 73 / 491 / 2, 146 / 492 / 2, 298 / 493 / 2, 238 / 494 / 2, 201 / 495 / 2, 415 / 496 / 3, 280 / 497 / 2
uniform-alpha_1-12-n6.txt, 1, 1, 6, 332.319, 24, 18, 3, 5,3 / 1 / 2, 5 / 2 / 3, 2 / 3 / 2, 1 / 4 / 2, 4 / 5 / 3
uniform-alpha_1-120-n250.txt, 1, 1, 250, 1241.23, 1818, 1568, 6, 244,20 / 1 / 4, 161 / 2 / 2, 186 / 3 / 2, 33 / 4 / 3, 38 / 5 / 2, 166 / 6 / 3, 107 / 7 / 2, 185 / 8 / 3, 132 / 9 / 2, 74 / 10 / 3, 226 / 11 / 2, 229 / 12 / 2, 158 / 13 / 2, 116 / 14 / 4, 225 / 15 / 2, 112 / 16 / 2, 163 / 17 / 4, 142 / 18 / 2, 27 / 19 / 2, 244 / 20 / 3, 131 / 21 / 2, 187 / 22 / 2, 181 / 23 / 4, 179 / 24 / 2, 100 / 25 / 3, 150 / 26 / 2, 120 / 27 / 2, 147 / 28 / 3, 174 / 29 / 2, 7 / 30 / 4, 137 / 31 / 2, 65 / 32 / 3, 206 / 33 / 2, 208 / 34 / 2, 127 / 35 / 2, 154 / 36 / 2, 80 / 37 / 3, 224 / 38 / 2, 40 / 39 / 3, 8 / 40 / 2, 246 / 41 / 3, 53 / 42 / 2, 139 / 43 / 2, 202 / 44 / 4, 234 / 45 / 2, 21 / 46 / 2, 152 / 47 / 2, 113 / 48 / 2, 236 / 49 / 2, 141 / 50 / 2, 136 / 51 / 2, 209 / 52 / 2, 19 / 53 / 2, 235 / 54 / 3, 51 / 55 / 2, 103 / 56 / 2, 49 / 57 / 3, 69 / 58 / 2, 110 / 59 / 2, 173 / 60 / 2, 248 / 61 / 2, 156 / 62 / 2, 115 / 63 / 3, 242 / 66 / 2, 88 / 67 / 2, 1 / 68 / 3, 200 / 69 / 2, 118 / 70 / 2, 63 / 71 / 2, 50 / 72 / 2, 196 / 73 / 2, 180 / 74 / 2, 43 / 75 / 3, 45 / 76 / 2, 5 / 77 / 2, 92 / 78 / 3, 34 / 79 / 2, 44 / 80 / 3, 172 / 81 / 2, 18 / 82 / 2, 114 / 83 / 2, 178 / 84 / 3, 26 / 85 / 2, 198 / 86 / 2, 215 / 87 / 3, 84 / 88 / 2, 155 / 89 / 2, 90 / 90 / 2, 2 / 91 / 2, 71 / 92 / 2, 72 / 93 / 2, 175 / 94 / 3, 16 / 95 / 2, 12 / 96 / 5, 111 / 97 / 2, 193 / 98 / 3, 219 / 99 / 2, 241 / 100 / 2, 82 / 101 / 2, 52 / 102 / 2, 221 / 103 / 2, 134 / 104 / 2, 192 / 105 / 4, 170 / 106 / 2, 87 / 107 / 2, 6 / 108 / 3, 232 / 109 / 2, 210 / 110 / 3, 214 / 111 / 2, 117 / 112 / 2, 223 / 113 / 2, 125 / 114 / 4, 60 / 115 / 2, 85 / 116 / 2, 218 / 117 / 2, 39 / 118 / 3, 148 / 119 / 2, 184 / 120 / 2, 62 / 121 / 5, 243 / 122 / 2, 212 / 123 / 2, 159 / 124 / 2, 48 / 125 / 2, 55 / 126 / 2, 104 / 127 / 4, 102 / 128 / 2, 57 / 129 / 2, 171 / 130 / 4, 176 / 131 / 2, 122 / 132 / 2, 133 / 133 / 2, 17 / 134 / 2, 151 / 135 / 2, 240 / 136 / 2, 23 / 137 / 2, 46 / 138 / 2, 106 / 139 / 3, 30 / 140 / 2, 124 / 141 / 2, 164 / 142 / 4, 67 / 143 / 2, 56 / 144 / 3, 42 / 145 / 2, 231 / 146 / 3, 77 / 147 / 2, 121 / 148 / 4, 123 / 149 / 2, 37 / 150 / 2, 220 / 151 / 2, 59 / 152 / 3, 195 / 153 / 2, 194 / 154 / 3, 109 / 155 / 2, 4 / 156 / 3, 61 / 157 / 2, 162 / 158 / 2, 205 / 159 / 2, 237 / 160 / 2, 101 / 161 / 3, 83 / 164 / 3, 169 / 165 / 2, 58 / 166 / 2, 157 / 167 / 4, 160 / 168 / 2, 73 / 169 / 2, 15 / 170 / 2, 66 / 171 / 2, 189 / 172 / 2, 9 / 173 / 4, 165 / 174 / 2, 13 / 175 / 2, 233 / 176 / 4, 28 / 177 / 2, 99 / 178 / 2, 201 / 179 / 3, 96 / 180 / 2, 197 / 181 / 3, 239 / 182 / 2, 31 / 183 / 3, 191 / 184 / 2, 140 / 185 / 2, 177 / 186 / 2, 247 / 187 / 2, 97 / 188 / 2, 149 / 189 / 3, 32 / 190 / 2, 249 / 191 / 2, 138 / 192 / 2, 29 / 193 / 4, 14 / 194 / 2, 128 / 195 / 3, 126 / 196 / 2, 95 / 197 / 2, 130 / 198 / 2, 25 / 199 / 4, 89 / 200 / 2, 93 / 201 / 2, 70 / 202 / 3, 76 / 203 / 2, 79 / 204 / 3, 54 / 205 / 2, 207 / 206 / 2, 238 / 207 / 2, 144 / 208 / 2, 64 / 209 / 3, 91 / 210 / 2, 41 / 211 / 5, 35 / 212 / 2, 217 / 213 / 2, 36 / 214 / 2, 3 / 215 / 5, 146 / 216 / 2, 183 / 217 / 3, 135 / 218 / 2, 94 / 219 / 2, 105 / 220 / 2, 145 / 221 / 2, 75 / 222 / 2, 245 / 223 / 2, 119 / 224 / 2, 213 / 225 / 2, 204 / 226 / 2, 47 / 227 / 2, 190 / 228 / 4, 153 / 230 / 2, 143 / 231 / 2, 227 / 232 / 5, 203 / 233 / 2, 228 / 234 / 3, 108 / 235 / 2, 81 / 236 / 2, 216 / 237 / 2, 199 / 238 / 6, 98 / 239 / 2, 211 / 240 / 2, 188 / 241 / 2, 167 / 242 / 2, 78 / 243 / 3, 11 / 244 / 2, 222 / 245 / 3, 10 / 246 / 2, 230 / 247 / 3, 182 / 248 / 2, 129 / 249 / 3
uniform-alpha_1-13-n375.txt, 1, 1, 375, 1599.57, 2679, 2304, 7, 358,328 / 1 / 5, 63 / 2 / 2, 159 / 3 / 2, 92 / 4 / 2, 181 / 5 / 3, 174 / 6 / 2, 196 / 7 / 2, 146 / 8 / 2, 82 / 9 / 3, 176 / 10 / 2, 116 / 11 / 3, 276 / 12 / 2, 337 / 13 / 2, 132 / 14 / 3, 54 / 15 / 2, 178 / 16 / 2, 105 / 17 / 2, 147 / 18 / 3, 208 / 19 / 2, 230 / 20 / 3, 237 / 21 / 2, 209 / 22 / 3, 331 / 23 / 2, 318 / 24 / 2, 56 / 25 / 4, 201 / 26 / 2, 355 / 27 / 2, 154 / 28 / 4, 310 / 29 / 2, 167 / 30 / 3, 348 / 31 / 2, 118 / 32 / 2, 190 / 33 / 3, 313 / 34 / 2, 269 / 35 / 6, 292 / 36 / 2, 69 / 37 / 2, 243 / 38 / 2, 263 / 39 / 2, 233 / 40 / 2, 80 / 41 / 2, 38 / 42 / 2, 298 / 43 / 2, 203 / 44 / 3, 76 / 45 / 2, 198 / 46 / 2, 213 / 47 / 2, 64 / 48 / 5, 316 / 49 / 2, 94 / 50 / 2, 156 / 51 / 3, 223 / 53 / 2, 40 / 54 / 7, 340 / 56 / 2, 215 / 57 / 2, 81 / 58 / 2, 117 / 59 / 2, 252 / 60 / 5, 148 / 62 / 2, 359 / 63 / 3, 104 / 64 / 2, 68 / 65 / 2, 260 / 66 / 2, 49 / 67 / 2, 126 / 68 / 3, 321 / 69 / 2, 12 / 70 / 2, 45 / 71 / 2, 172 / 72 / 2, 55 / 73 / 2, 247 / 74 / 3, 200 / 75 / 2, 312 / 76 / 4, 294 / 77 / 2, 282 / 80 / 2, 52 / 81 / 4, 266 / 82 / 2, 73 / 83 / 2, 351 / 84 / 2, 287 / 85 / 2, 206 / 86 / 2, 121 / 87 / 2, 24 / 88 / 3, 9 / 89 / 2, 307 / 90 / 2, 91 / 91 / 2, 271 / 92 / 2, 185 / 93 / 3, 299 / 94 / 2, 138 / 95 / 2, 239 / 96 / 2, 57 / 97 / 2, 134 / 98 / 2, 373 / 99 / 3, 204 / 100 / 2, 311 / 101 / 3, 341 / 102 / 2, 329 / 103 / 3, 157 / 104 / 2, 43 / 105 / 2, 20 / 106 / 2, 90 / 107 / 4, 262 / 108 / 2, 228 / 109 / 3, 277 / 110 / 2, 140 / 111 / 2, 111 / 112 / 2, 261 / 113 / 5, 179 / 114 / 2, 295 / 115 / 2, 62 / 116 / 2, 357 / 117 / 3, 264 / 118 / 2, 347 / 119 / 2, 306 / 120 / 3, 88 / 121 / 2, 39 / 122 / 2, 289 / 123 / 2, 362 / 124 / 4, 232 / 125 / 2, 238 / 126 / 2, 18 / 127 / 2, 136 / 128 / 2, 17 / 129 / 2, 275 / 130 / 3, 47 / 131 / 2, 103 / 132 / 2, 333 / 133 / 3, 32 / 134 / 2, 78 / 135 / 3, 249 / 136 / 2, 51 / 137 / 3, 344 / 138 / 2, 205 / 139 / 3, 371 / 140 / 2, 219 / 141 / 2, 186 / 142 / 2, 210 / 143 / 3, 36 / 144 / 2, 366 / 145 / 3, 235 / 146 / 2, 180 / 147 / 2, 169 / 148 / 2, 350 / 149 / 3, 89 / 150 / 2, 187 / 151 / 2, 173 / 152 / 2, 33 / 153 / 4, 114 / 154 / 2, 343 / 155 / 2, 123 / 156 / 2, 34 / 157 / 2, 308 / 158 / 4, 372 / 159 / 2, 214 / 160 / 3, 61 / 161 / 2, 259 / 162 / 2, 194 / 163 / 4, 334 / 164 / 2, 217 / 165 / 2, 309 / 166 / 3, 231 / 167 / 2, 22 / 168 / 2, 225 / 171 / 2, 216 / 172 / 4, 254 / 173 / 2, 60 / 176 / 4, 119 / 177 / 2, 42 / 178 / 3, 202 / 180 / 3, 2 / 181 / 2, 23 / 182 / 5, 150 / 183 / 2, 221 / 184 / 2, 268 / 185 / 2, 324 / 186 / 2, 3 / 187 / 4, 163 / 188 / 2, 241 / 189 / 2, 188 / 190 / 2, 338 / 191 / 2, 317 / 192 / 3, 253 / 193 / 2, 305 / 194 / 2, 255 / 195 / 2, 250 / 196 / 2, 79 / 197 / 2, 360 / 198 / 2, 11 / 199 / 4, 59 / 200 / 2, 286 / 201 / 2, 151 / 202 / 3, 320 / 203 / 2, 139 / 204 / 2, 339 / 205 / 3, 143 / 206 / 2, 236 / 207 / 2, 199 / 208 / 2, 137 / 209 / 3, 245 / 210 / 2, 369 / 211 / 2, 144 / 212 / 2, 244 / 213 / 2, 283 / 214 / 2, 77 / 215 / 2, 257 / 216 / 3, 10 / 217 / 2, 65 / 218 / 2, 361 / 219 / 3, 41 / 220 / 2, 120 / 221 / 3, 229 / 222 / 2, 166 / 223 / 4, 30 / 224 / 2, 327 / 225 / 2, 155 / 226 / 2, 165 / 227 / 3, 326 / 228 / 2, 1 / 229 / 2, 8 / 230 / 3, 227 / 231 / 2, 19 / 232 / 3, 322 / 233 / 2, 26 / 235 / 2, 342 / 236 / 2, 335 / 237 / 2, 99 / 238 / 2, 291 / 239 / 2, 109 / 240 / 2, 125 / 241 / 3, 273 / 242 / 2, 101 / 243 / 2, 182 / 244 / 2, 29 / 245 / 4, 6 / 246 / 2, 46 / 247 / 2, 158 / 248 / 3, 50 / 249 / 2, 293 / 250 / 2, 58 / 251 / 2, 297 / 252 / 4, 4 / 253 / 2, 37 / 254 / 2, 28 / 255 / 2, 127 / 256 / 4, 171 / 257 / 2, 14 / 258 / 2, 248 / 259 / 4, 280 / 260 / 2, 124 / 261 / 2, 98 / 262 / 2, 161 / 263 / 2, 108 / 264 / 3, 189 / 265 / 2, 336 / 266 / 2, 195 / 267 / 2, 184 / 268 / 2, 110 / 269 / 2, 5 / 270 / 4, 162 / 271 / 2, 367 / 272 / 3, 141 / 273 / 2, 75 / 275 / 2, 272 / 276 / 2, 197 / 277 / 4, 323 / 278 / 2, 234 / 279 / 2, 85 / 280 / 3, 242 / 281 / 2, 74 / 282 / 3, 107 / 283 / 2, 279 / 284 / 3, 349 / 285 / 2, 135 / 286 / 3, 325 / 287 / 2, 67 / 288 / 2, 265 / 289 / 2, 274 / 290 / 5, 281 / 291 / 2, 364 / 292 / 2, 130 / 294 / 4, 301 / 295 / 2, 93 / 296 / 2, 354 / 297 / 4, 226 / 298 / 2, 21 / 299 / 2, 86 / 300 / 2, 300 / 301 / 5, 31 / 302 / 2, 302 / 303 / 2, 284 / 304 / 2, 84 / 305 / 3, 192 / 306 / 2, 258 / 307 / 4, 112 / 308 / 2, 368 / 309 / 2, 83 / 310 / 4, 106 / 311 / 2, 16 / 312 / 2, 149 / 313 / 2, 270 / 314 / 2, 207 / 315 / 2, 251 / 316 / 2, 13 / 317 / 2, 352 / 318 / 2, 122 / 319 / 2, 87 / 320 / 2, 353 / 321 / 2, 27 / 322 / 2, 358 / 323 / 2, 15 / 324 / 2, 193 / 325 / 3, 211 / 326 / 2, 278 / 327 / 3, 218 / 328 / 2, 314 / 329 / 2, 303 / 330 / 3, 35 / 331 / 2, 212 / 332 / 2, 102 / 333 / 3, 240 / 334 / 2, 115 / 335 / 2, 113 / 336 / 2, 246 / 337 / 2, 129 / 338 / 2, 304 / 339 / 3, 142 / 340 / 2, 356 / 341 / 2, 72 / 342 / 2, 168 / 343 / 3, 164 / 346 / 3, 285 / 347 / 2, 71 / 348 / 2, 296 / 349 / 4, 290 / 350 / 2, 70 / 351 / 2, 267 / 352 / 2, 183 / 353 / 3, 160 / 354 / 2, 256 / 355 / 2, 133 / 356 / 2, 315 / 357 / 4, 131 / 358 / 2, 170 / 360 / 3, 332 / 361 / 2, 44 / 362 / 3, 53 / 363 / 2, 128 / 364 / 3, 66 / 365 / 2, 222 / 366 / 2, 100 / 367 / 4, 96 / 368 / 2, 153 / 369 / 2, 365 / 370 / 3, 363 / 371 / 2, 224 / 372 / 2, 25 / 373 / 3, 97 / 374 / 2
uniform-alpha_1-13-n500.txt, 1, 1, 500, 1694.6, 3537, 3037, 7, 449,374 / 1 / 2, 239 / 2 / 2, 381 / 3 / 2, 265 / 4 / 2, 193 / 5 / 2, 414 / 6 / 2, 382 / 7 / 2, 418 / 8 / 3, 9 / 9 / 2, 88 / 10 / 2, 487 / 11 / 2, 191 / 12 / 2, 172 / 13 / 2, 306 / 14 / 4, 301 / 16 / 2, 399 / 17 / 3, 86 / 18 / 2, 366 / 19 / 3, 395 / 20 / 2, 190 / 21 / 3, 165 / 22 / 2, 30 / 23 / 2, 422 / 24 / 3, 164 / 25 / 2, 319 / 26 / 2, 61 / 27 / 2, 281 / 28 / 5, 313 / 29 / 2, 324 / 30 / 2, 197 / 31 / 2, 230 / 32 / 3, 41 / 33 / 2, 49 / 34 / 3, 85 / 35 / 2, 116 / 36 / 3, 173 / 37 / 2, 154 / 38 / 2, 340 / 39 / 2, 237 / 40 / 2, 383 / 41 / 2, 244 / 42 / 2, 333 / 43 / 5, 201 / 46 / 2, 478 / 47 / 2, 217 / 48 / 3, 457 / 49 / 2, 66 / 50 / 3, 227 / 51 / 2, 439 / 52 / 2, 463 / 53 / 2, 181 / 54 / 2, 288 / 55 / 2, 51 / 56 / 5, 43 / 57 / 2, 171 / 58 / 3, 115 / 59 / 2, 72 / 60 / 2, 284 / 61 / 3, 440 / 62 / 2, 232 / 63 / 3, 87 / 64 / 2, 364 / 65 / 2, 488 / 66 / 2, 452 / 68 / 2, 74 / 69 / 6, 167 / 70 / 2, 442 / 71 / 2, 141 / 72 / 3, 187 / 75 / 3, 210 / 79 / 2, 91 / 80 / 4, 328 / 81 / 2, 162 / 82 / 2, 429 / 83 / 3, 58 / 84 / 2, 102 / 85 / 3, 484 / 86 / 2, 351 / 87 / 2, 179 / 88 / 2, 336 / 89 / 2, 444 / 90 / 4, 65 / 91 / 2, 474 / 92 / 2, 331 / 93 / 2, 11 / 94 / 2, 56 / 95 / 4, 401 / 96 / 2, 292 / 97 / 2, 24 / 98 / 3, 307 / 99 / 2, 215 / 100 / 3, 327 / 101 / 2, 107 / 102 / 2, 8 / 103 / 4, 25 / 104 / 2, 493 / 105 / 2, 329 / 106 / 3, 89 / 107 / 2, 26 / 108 / 4, 477 / 109 / 2, 96 / 110 / 2, 278 / 111 / 3, 125 / 112 / 2, 139 / 113 / 2, 33 / 114 / 3, 68 / 115 / 2, 7 / 116 / 3, 462 / 117 / 2, 297 / 118 / 2, 82 / 119 / 2, 368 / 120 / 2, 94 / 121 / 2, 343 / 122 / 3, 267 / 123 / 2, 97 / 124 / 2, 248 / 125 / 2, 352 / 126 / 2, 345 / 127 / 2, 62 / 128 / 2, 5 / 129 / 3, 277 / 130 / 2, 140 / 131 / 2, 397 / 132 / 2, 131 / 133 / 3, 257 / 134 / 2, 356 / 135 / 2, 31 / 136 / 2, 332 / 137 / 4, 459 / 138 / 2, 494 / 139 / 2, 425 / 140 / 2, 417 / 142 / 4, 46 / 143 / 2, 212 / 144 / 2, 148 / 145 / 2, 144 / 146 / 2, 231 / 147 / 2, 214 / 148 / 3, 314 / 149 / 2, 250 / 151 / 2, 73 / 152 / 2, 124 / 153 / 2, 95 / 154 / 2, 57 / 155 / 4, 146 / 156 / 2, 243 / 157 / 2, 376 / 158 / 4, 316 / 159 / 2, 184 / 160 / 2, 386 / 161 / 2, 365 / 162 / 4, 455 / 163 / 2, 453 / 166 / 3, 392 / 167 / 2, 449 / 168 / 4, 354 / 169 / 2, 465 / 170 / 2, 238 / 171 / 3, 142 / 172 / 2, 305 / 173 / 2, 472 / 174 / 4, 40 / 175 / 2, 448 / 176 / 2, 218 / 177 / 2, 394 / 178 / 2, 483 / 179 / 2, 161 / 180 / 2, 405 / 181 / 2, 138 / 182 / 2, 158 / 183 / 2, 251 / 184 / 2, 200 / 185 / 2, 255 / 186 / 2, 432 / 187 / 3, 262 / 188 / 2, 70 / 189 / 2, 443 / 190 / 2, 222 / 191 / 2, 400 / 192 / 2, 423 / 193 / 3, 198 / 194 / 2, 473 / 195 / 3, 263 / 196 / 2, 427 / 197 / 2, 233 / 198 / 2, 113 / 199 / 2, 498 / 200 / 4, 256 / 201 / 2, 64 / 204 / 2, 176 / 205 / 3, 406 / 206 / 2, 108 / 207 / 3, 481 / 208 / 2, 298 / 209 / 2, 496 / 210 / 3, 467 / 211 / 2, 219 / 212 / 3, 302 / 213 / 2, 335 / 214 / 2, 60 / 215 / 2, 225 / 216 / 2, 271 / 217 / 2, 67 / 218 / 3, 211 / 219 / 2, 119 / 220 / 3, 132 / 221 / 2, 159 / 222 / 4, 137 / 223 / 2, 424 / 224 / 2, 50 / 225 / 4, 253 / 226 / 2, 246 / 229 / 2, 416 / 230 / 4, 296 / 231 / 2, 44 / 232 / 3, 254 / 233 / 2, 396 / 234 / 4, 276 / 235 / 2, 318 / 236 / 2, 228 / 237 / 2, 445 / 238 / 5, 273 / 241 / 3, 334 / 242 / 2, 80 / 245 / 3, 17 / 246 / 2, 310 / 247 / 2, 492 / 248 / 2, 274 / 249 / 2, 178 / 250 / 2, 454 / 251 / 2, 104 / 252 / 4, 126 / 253 / 2, 456 / 254 / 3, 45 / 255 / 2, 204 / 256 / 2, 196 / 257 / 2, 458 / 258 / 3, 283 / 259 / 2, 466 / 260 / 3, 495 / 261 / 2, 143 / 262 / 2, 121 / 263 / 3, 291 / 264 / 2, 390 / 267 / 2, 195 / 268 / 2, 202 / 269 / 2, 99 / 270 / 2, 375 / 271 / 2, 22 / 272 / 2, 48 / 273 / 3, 360 / 274 / 2, 3 / 275 / 2, 105 / 276 / 2, 353 / 277 / 2, 461 / 278 / 3, 363 / 279 / 2, 127 / 280 / 2, 469 / 281 / 3, 75 / 282 / 2, 468 / 283 / 3, 28 / 284 / 2, 259 / 285 / 3, 369 / 286 / 2, 136 / 287 / 3, 153 / 289 / 2, 122 / 290 / 2, 32 / 291 / 2, 309 / 292 / 2, 12 / 293 / 2, 285 / 294 / 2, 315 / 296 / 3, 372 / 298 / 3, 14 / 299 / 2, 150 / 300 / 2, 476 / 301 / 2, 76 / 302 / 2, 156 / 303 / 3, 293 / 304 / 2, 93 / 305 / 3, 330 / 306 / 2, 245 / 309 / 4, 486 / 312 / 2, 272 / 313 / 3, 321 / 314 / 2, 389 / 315 / 3, 170 / 316 / 2, 84 / 317 / 3, 52 / 318 / 2, 409 / 319 / 2, 367 / 320 / 2, 415 / 321 / 2, 290 / 322 / 2, 279 / 323 / 4, 106 / 324 / 2, 377 / 327 / 2, 42 / 328 / 3, 359 / 329 / 2, 199 / 330 / 3, 350 / 331 / 2, 413 / 332 / 2, 393 / 333 / 2, 308 / 334 / 2, 460 / 335 / 3, 433 / 336 / 2, 421 / 337 / 2, 216 / 338 / 2, 371 / 339 / 3, 37 / 340 / 2, 20 / 341 / 2, 220 / 342 / 2, 16 / 343 / 2, 404 / 344 / 3, 79 / 347 / 2, 407 / 348 / 3, 163 / 349 / 2, 39 / 350 / 2, 270 / 351 / 2, 304 / 352 / 2, 408 / 353 / 2, 54 / 354 / 3, 128 / 355 / 2, 71 / 356 / 3, 446 / 357 / 2, 480 / 358 / 2, 252 / 359 / 3, 428 / 360 / 2, 77 / 361 / 3, 497 / 362 / 2, 479 / 363 / 2, 168 / 364 / 3, 450 / 365 / 2, 447 / 366 / 3, 430 / 367 / 2, 100 / 368 / 3, 355 / 369 / 2, 59 / 370 / 2, 27 / 371 / 2, 6 / 372 / 2, 266 / 373 / 2, 149 / 374 / 2, 90 / 375 / 2, 206 / 376 / 6, 47 / 377 / 2, 175 / 378 / 2, 402 / 379 / 2, 203 / 380 / 2, 147 / 381 / 4, 111 / 382 / 2, 133 / 383 / 2, 103 / 384 / 2, 192 / 385 / 3, 434 / 386 / 2, 112 / 387 / 2, 325 / 388 / 3, 361 / 389 / 2, 387 / 391 / 2, 4 / 392 / 3, 69 / 393 / 2, 205 / 394 / 7, 294 / 395 / 2, 221 / 398 / 2, 482 / 399 / 2, 485 / 400 / 4, 157 / 401 / 2, 471 / 402 / 3, 120 / 403 / 2, 362 / 404 / 3, 398 / 405 / 2, 438 / 406 / 3, 249 / 407 / 2, 109 / 408 / 3, 23 / 409 / 2, 207 / 410 / 2, 15 / 411 / 4, 183 / 412 / 2, 420 / 413 / 2, 185 / 414 / 2, 269 / 415 / 2, 209 / 418 / 6, 264 / 419 / 2, 169 / 420 / 2, 391 / 421 / 3, 491 / 422 / 2, 189 / 423 / 3, 317 / 424 / 2, 234 / 425 / 2, 18 / 428 / 4, 226 / 429 / 2, 236 / 430 / 2, 186 / 431 / 3, 151 / 432 / 2, 341 / 433 / 2, 247 / 434 / 3, 380 / 435 / 2, 388 / 436 / 3, 385 / 439 / 3, 2 / 440 / 2, 268 / 441 / 3, 347 / 442 / 2, 155 / 443 / 3, 379 / 444 / 2, 342 / 445 / 2, 490 / 446 / 2, 188 / 447 / 3, 411 / 448 / 2, 135 / 449 / 2, 78 / 450 / 3, 180 / 451 / 2, 320 / 452 / 2, 240 / 453 / 2, 370 / 454 / 2, 451 / 455 / 2, 475 / 456 / 2, 152 / 457 / 2, 357 / 458 / 4, 489 / 459 / 2, 38 / 460 / 2, 261 / 461 / 2, 53 / 462 / 2, 410 / 463 / 2, 339 / 464 / 2, 194 / 466 / 2, 470 / 467 / 5, 282 / 470 / 2, 280 / 471 / 2, 300 / 472 / 3, 177 / 473 / 2, 208 / 474 / 2, 241 / 475 / 2, 412 / 476 / 4, 114 / 477 / 2, 299 / 478 / 2, 13 / 479 / 2, 166 / 480 / 3, 83 / 481 / 2, 344 / 482 / 3, 145 / 484 / 3, 101 / 485 / 2, 348 / 486 / 3, 403 / 488 / 2, 275 / 489 / 3, 287 / 490 / 2, 437 / 491 / 2, 419 / 492 / 2, 323 / 495 / 2, 242 / 496 / 2, 36 / 497 / 2, 322 / 498 / 3, 182 / 499 / 2
uniform-alpha_1-13-n6.txt, 1, 1, 6, 240.425, 27, 21, 6, 5,4 / 1 / 2, 5 / 2 / 6, 1 / 3 / 2, 3 / 4 / 2, 2 / 5 / 4
uniform-alpha_1-14-n375.txt, 1, 1, 375, 1500.72, 2581, 2206, 6, 354,348 / 1 / 3, 268 / 2 / 2, 226 / 3 / 2, 300 / 4 / 2, 230 / 5 / 2, 97 / 6 / 2, 297 / 7 / 3, 278 / 8 / 2, 190 / 9 / 3, 225 / 10 / 2, 320 / 11 / 2, 299 / 12 / 3, 146 / 13 / 2, 67 / 14 / 3, 359 / 15 / 2, 221 / 16 / 2, 68 / 17 / 2, 164 / 18 / 2, 132 / 19 / 3, 70 / 20 / 2, 186 / 21 / 2, 288 / 22 / 3, 126 / 23 / 2, 339 / 24 / 3, 150 / 25 / 2, 331 / 26 / 2, 353 / 27 / 2, 283 / 28 / 2, 314 / 29 / 4, 116 / 30 / 2, 310 / 31 / 2, 47 / 32 / 4, 200 / 33 / 2, 187 / 34 / 2, 144 / 35 / 4, 249 / 36 / 2, 287 / 37 / 2, 204 / 38 / 4, 75 / 39 / 2, 123 / 40 / 2, 330 / 41 / 2, 319 / 42 / 3, 111 / 43 / 2, 1 / 44 / 2, 14 / 45 / 2, 242 / 46 / 3, 313 / 47 / 2, 170 / 48 / 3, 72 / 49 / 2, 163 / 50 / 3, 71 / 51 / 2, 360 / 52 / 3, 357 / 53 / 2, 262 / 54 / 3, 76 / 55 / 2, 270 / 56 / 2, 206 / 57 / 4, 105 / 58 / 2, 173 / 59 / 2, 57 / 60 / 3, 212 / 61 / 2, 269 / 62 / 3, 94 / 63 / 2, 322 / 64 / 2, 171 / 65 / 3, 344 / 66 / 2, 326 / 67 / 2, 345 / 68 / 2, 32 / 69 / 3, 80 / 72 / 2, 100 / 73 / 2, 10 / 74 / 3, 197 / 75 / 2, 127 / 76 / 3, 29 / 77 / 2, 4 / 78 / 2, 316 / 79 / 3, 294 / 80 / 2, 73 / 81 / 3, 58 / 82 / 2, 112 / 83 / 2, 189 / 84 / 2, 108 / 85 / 4, 311 / 87 / 3, 363 / 89 / 3, 142 / 90 / 2, 45 / 91 / 2, 17 / 92 / 3, 196 / 93 / 2, 183 / 94 / 3, 115 / 95 / 2, 13 / 96 / 3, 327 / 97 / 2, 256 / 98 / 2, 53 / 99 / 3, 352 / 101 / 2, 198 / 102 / 4, 179 / 103 / 2, 202 / 104 / 2, 9 / 105 / 2, 38 / 106 / 2, 215 / 107 / 2, 168 / 108 / 2, 335 / 109 / 2, 306 / 110 / 2, 228 / 111 / 2, 162 / 112 / 2, 341 / 113 / 2, 24 / 114 / 2, 291 / 115 / 2, 210 / 116 / 2, 30 / 117 / 2, 177 / 118 / 2, 285 / 120 / 2, 66 / 121 / 2, 209 / 122 / 2, 50 / 123 / 3, 128 / 124 / 2, 323 / 125 / 3, 33 / 126 / 2, 169 / 128 / 2, 34 / 129 / 2, 148 / 130 / 2, 87 / 131 / 3, 175 / 132 / 2, 6 / 133 / 3, 86 / 134 / 2, 336 / 135 / 2, 274 / 136 / 3, 373 / 137 / 2, 124 / 138 / 3, 63 / 139 / 2, 192 / 140 / 2, 31 / 141 / 2, 137 / 142 / 2, 233 / 143 / 2, 312 / 144 / 2, 213 / 145 / 4, 26 / 146 / 2, 354 / 147 / 3, 367 / 148 / 2, 156 / 149 / 3, 240 / 150 / 2, 165 / 151 / 3, 153 / 153 / 2, 8 / 154 / 4, 157 / 155 / 2, 368 / 156 / 2, 101 / 157 / 3, 244 / 158 / 2, 315 / 160 / 2, 303 / 161 / 2, 317 / 162 / 2, 172 / 163 / 2, 218 / 164 / 2, 257 / 165 / 2, 253 / 166 / 3, 118 / 167 / 2, 251 / 168 / 3, 93 / 169 / 2, 16 / 170 / 3, 324 / 171 / 2, 133 / 172 / 3, 104 / 173 / 2, 69 / 174 / 3, 194 / 175 / 2, 267 / 176 / 2, 49 / 177 / 2, 304 / 178 / 3, 141 / 179 / 2, 7 / 180 / 2, 140 / 181 / 3, 195 / 182 / 2, 329 / 184 / 2, 347 / 185 / 3, 98 / 186 / 2, 125 / 187 / 2, 89 / 190 / 2, 259 / 191 / 6, 92 / 192 / 2, 61 / 193 / 3, 266 / 194 / 2, 145 / 195 / 2, 25 / 196 / 2, 3 / 197 / 2, 178 / 198 / 3, 176 / 199 / 2, 139 / 200 / 5, 217 / 201 / 2, 166 / 202 / 3, 237 / 204 / 2, 332 / 205 / 5, 342 / 206 / 2, 62 / 207 / 2, 95 / 208 / 2, 129 / 209 / 2, 234 / 210 / 2, 241 / 211 / 2, 28 / 212 / 2, 167 / 213 / 2, 219 / 214 / 4, 292 / 215 / 2, 90 / 216 / 2, 295 / 217 / 2, 364 / 218 / 3, 79 / 219 / 2, 42 / 220 / 2, 280 / 221 / 2, 289 / 222 / 2, 117 / 223 / 4, 2 / 224 / 2, 60 / 225 / 2, 152 / 226 / 2, 88 / 227 / 4, 193 / 228 / 2, 40 / 229 / 2, 149 / 230 / 2, 27 / 231 / 2, 82 / 232 / 3, 12 / 233 / 2, 264 / 234 / 3, 64 / 235 / 2, 5 / 236 / 2, 275 / 237 / 2, 350 / 238 / 3, 361 / 239 / 2, 248 / 240 / 4, 325 / 241 / 2, 48 / 242 / 2, 235 / 243 / 2, 83 / 244 / 3, 250 / 245 / 2, 284 / 246 / 3, 238 / 247 / 2, 136 / 248 / 3, 36 / 249 / 2, 337 / 250 / 2, 334 / 253 / 3, 362 / 254 / 2, 180 / 255 / 2, 349 / 256 / 2, 293 / 257 / 3, 39 / 258 / 2, 85 / 259 / 2, 120 / 260 / 3, 138 / 261 / 2, 174 / 262 / 3, 214 / 263 / 2, 273 / 264 / 3, 247 / 265 / 2, 245 / 267 / 3, 279 / 268 / 2, 286 / 269 / 3, 154 / 270 / 2, 338 / 271 / 2, 272 / 272 / 2, 43 / 273 / 2, 258 / 274 / 2, 191 / 275 / 3, 277 / 276 / 2, 301 / 277 / 2, 106 / 278 / 4, 227 / 281 / 3, 99 / 282 / 2, 290 / 283 / 2, 56 / 284 / 2, 130 / 285 / 2, 224 / 286 / 2, 11 / 287 / 3, 44 / 288 / 2, 114 / 289 / 2, 305 / 290 / 2, 374 / 291 / 2, 158 / 292 / 2, 246 / 293 / 3, 131 / 294 / 2, 356 / 295 / 3, 159 / 296 / 2, 21 / 297 / 3, 265 / 298 / 2, 309 / 299 / 2, 110 / 300 / 2, 109 / 301 / 2, 121 / 302 / 4, 328 / 303 / 2, 308 / 304 / 2, 59 / 305 / 2, 254 / 306 / 2, 84 / 307 / 3, 236 / 308 / 2, 78 / 309 / 2, 340 / 310 / 3, 239 / 311 / 2, 222 / 312 / 2, 333 / 313 / 2, 318 / 314 / 2, 371 / 315 / 2, 182 / 316 / 2, 220 / 317 / 3, 232 / 318 / 2, 365 / 319 / 2, 252 / 320 / 2, 281 / 321 / 2, 147 / 322 / 2, 113 / 323 / 2, 321 / 324 / 2, 122 / 325 / 3, 135 / 326 / 2, 65 / 327 / 2, 208 / 328 / 2, 134 / 329 / 2, 199 / 330 / 2, 346 / 331 / 2, 91 / 332 / 2, 160 / 333 / 2, 201 / 334 / 2, 184 / 335 / 3, 351 / 336 / 2, 358 / 337 / 2, 77 / 338 / 2, 46 / 339 / 2, 23 / 340 / 2, 343 / 341 / 2, 282 / 342 / 2, 366 / 343 / 2, 15 / 344 / 2, 302 / 345 / 2, 223 / 346 / 2, 181 / 347 / 2, 37 / 348 / 2, 103 / 351 / 3, 54 / 352 / 2, 203 / 353 / 3, 52 / 354 / 2, 41 / 355 / 2, 231 / 356 / 4, 369 / 357 / 2, 229 / 358 / 2, 370 / 359 / 4, 35 / 360 / 2, 102 / 361 / 2, 260 / 362 / 2, 119 / 363 / 3, 74 / 364 / 2, 151 / 365 / 3, 307 / 366 / 2, 81 / 367 / 3, 261 / 368 / 2, 96 / 369 / 2, 298 / 370 / 2, 255 / 371 / 2, 20 / 372 / 3, 271 / 373 / 2, 205 / 374 / 2
uniform-alpha_1-14-n500.txt, 1, 1, 500, 1857.35, 3454, 2954, 5, 457,281 / 1 / 2, 464 / 2 / 5, 245 / 3 / 2, 55 / 4 / 2, 396 / 5 / 2, 321 / 6 / 3, 268 / 7 / 2, 132 / 8 / 3, 45 / 9 / 2, 148 / 10 / 2, 338 / 11 / 2, 462 / 12 / 2, 341 / 13 / 3, 354 / 16 / 3, 395 / 17 / 2, 302 / 18 / 2, 453 / 19 / 2, 89 / 20 / 5, 466 / 21 / 2, 238 / 22 / 2, 424 / 23 / 2, 151 / 24 / 2, 26 / 25 / 2, 433 / 26 / 2, 484 / 27 / 2, 65 / 28 / 2, 267 / 29 / 2, 405 / 30 / 2, 56 / 31 / 4, 293 / 32 / 2, 119 / 33 / 2, 29 / 34 / 2, 93 / 35 / 2, 460 / 36 / 2, 233 / 37 / 5, 345 / 38 / 2, 9 / 39 / 2, 34 / 40 / 2, 81 / 41 / 3, 84 / 42 / 2, 262 / 43 / 3, 438 / 44 / 2, 290 / 45 / 2, 30 / 46 / 3, 361 / 47 / 2, 54 / 48 / 2, 168 / 49 / 2, 331 / 50 / 5, 169 / 51 / 2, 454 / 52 / 2, 403 / 53 / 2, 43 / 54 / 5, 46 / 55 / 2, 284 / 56 / 2, 368 / 57 / 3, 427 / 58 / 2, 205 / 60 / 4, 108 / 61 / 2, 465 / 62 / 2, 197 / 63 / 4, 104 / 66 / 2, 100 / 67 / 3, 392 / 68 / 2, 10 / 69 / 3, 114 / 70 / 2, 384 / 71 / 3, 145 / 72 / 2, 488 / 73 / 3, 253 / 74 / 2, 162 / 75 / 3, 248 / 76 / 2, 369 / 77 / 2, 23 / 78 / 3, 128 / 79 / 2, 64 / 80 / 2, 308 / 81 / 2, 141 / 82 / 3, 445 / 83 / 2, 279 / 84 / 2, 352 / 85 / 2, 318 / 86 / 2, 177 / 87 / 2, 216 / 88 / 2, 185 / 89 / 2, 319 / 90 / 2, 404 / 91 / 4, 335 / 92 / 2, 382 / 93 / 3, 17 / 94 / 2, 20 / 95 / 2, 324 / 96 / 2, 190 / 97 / 3, 47 / 98 / 2, 250 / 99 / 2, 470 / 100 / 2, 69 / 101 / 2, 400 / 103 / 3, 386 / 104 / 2, 437 / 105 / 2, 218 / 106 / 2, 109 / 107 / 3, 139 / 108 / 2, 73 / 109 / 2, 36 / 110 / 2, 288 / 111 / 3, 49 / 112 / 2, 127 / 113 / 3, 342 / 114 / 2, 188 / 115 / 2, 222 / 116 / 4, 175 / 117 / 2, 471 / 118 / 2, 498 / 119 / 3, 242 / 120 / 2, 480 / 121 / 2, 350 / 122 / 2, 202 / 123 / 3, 201 / 124 / 2, 60 / 125 / 2, 115 / 126 / 2, 286 / 127 / 3, 326 / 129 / 3, 6 / 130 / 2, 310 / 131 / 2, 98 / 132 / 2, 479 / 133 / 2, 416 / 134 / 2, 186 / 135 / 2, 196 / 136 / 2, 70 / 137 / 2, 215 / 138 / 2, 16 / 139 / 4, 224 / 140 / 2, 140 / 143 / 2, 374 / 144 / 4, 285 / 145 / 2, 309 / 146 / 3, 86 / 149 / 2, 42 / 150 / 3, 355 / 151 / 2, 276 / 152 / 3, 24 / 153 / 2, 209 / 154 / 3, 325 / 157 / 4, 406 / 158 / 2, 442 / 160 / 4, 271 / 161 / 2, 490 / 162 / 2, 456 / 163 / 2, 19 / 164 / 3, 232 / 165 / 2, 68 / 166 / 2, 211 / 168 / 3, 258 / 169 / 2, 385 / 170 / 3, 189 / 171 / 2, 163 / 173 / 2, 14 / 174 / 3, 401 / 177 / 2, 236 / 178 / 2, 91 / 179 / 2, 122 / 180 / 2, 264 / 181 / 2, 235 / 182 / 3, 337 / 183 / 2, 474 / 184 / 3, 292 / 185 / 2, 182 / 186 / 2, 51 / 187 / 3, 1 / 188 / 2, 295 / 191 / 5, 483 / 192 / 2, 436 / 193 / 2, 261 / 194 / 2, 320 / 195 / 3, 425 / 196 / 2, 101 / 197 / 3, 18 / 198 / 2, 313 / 199 / 2, 493 / 200 / 2, 31 / 201 / 3, 467 / 202 / 2, 317 / 203 / 2, 478 / 204 / 3, 330 / 205 / 2, 130 / 206 / 2, 344 / 207 / 2, 88 / 208 / 3, 225 / 209 / 2, 417 / 210 / 3, 249 / 211 / 2, 397 / 212 / 2, 150 / 213 / 2, 25 / 214 / 2, 476 / 215 / 2, 204 / 216 / 4, 95 / 217 / 2, 160 / 218 / 2, 332 / 219 / 3, 430 / 220 / 2, 409 / 221 / 4, 343 / 222 / 2, 444 / 223 / 2, 198 / 224 / 2, 15 / 225 / 3, 443 / 226 / 2, 463 / 227 / 3, 5 / 228 / 2, 407 / 229 / 3, 459 / 230 / 2, 351 / 231 / 2, 161 / 232 / 3, 135 / 233 / 2, 316 / 234 / 2, 329 / 235 / 2, 58 / 236 / 2, 299 / 237 / 2, 383 / 238 / 2, 367 / 239 / 2, 418 / 240 / 2, 116 / 241 / 3, 221 / 243 / 3, 28 / 244 / 2, 244 / 245 / 2, 428 / 246 / 2, 328 / 247 / 3, 283 / 248 / 2, 362 / 249 / 3, 113 / 250 / 2, 174 / 251 / 2, 50 / 252 / 3, 74 / 253 / 2, 422 / 254 / 3, 217 / 255 / 2, 260 / 257 / 4, 247 / 258 / 2, 399 / 259 / 3, 72 / 260 / 2, 485 / 261 / 4, 63 / 262 / 2, 334 / 263 / 2, 388 / 264 / 2, 301 / 265 / 5, 499 / 266 / 2, 155 / 267 / 3, 231 / 268 / 2, 90 / 270 / 2, 363 / 271 / 2, 39 / 272 / 3, 429 / 273 / 2, 349 / 274 / 2, 57 / 275 / 4, 297 / 276 / 2, 193 / 277 / 2, 226 / 278 / 2, 492 / 279 / 2, 80 / 280 / 3, 373 / 281 / 2, 450 / 282 / 3, 312 / 283 / 2, 300 / 284 / 3, 339 / 285 / 2, 431 / 286 / 2, 420 / 287 / 2, 340 / 288 / 3, 82 / 289 / 2, 194 / 290 / 4, 243 / 291 / 2, 274 / 292 / 3, 22 / 293 / 2, 223 / 294 / 2, 212 / 295 / 2, 11 / 296 / 2, 134 / 297 / 2, 78 / 298 / 4, 314 / 299 / 2, 486 / 300 / 2, 96 / 301 / 4, 251 / 302 / 2, 419 / 304 / 2, 353 / 305 / 4, 323 / 306 / 2, 365 / 307 / 2, 358 / 308 / 3, 37 / 310 / 3, 153 / 311 / 2, 378 / 312 / 4, 103 / 313 / 2, 306 / 314 / 2, 495 / 315 / 3, 166 / 318 / 3, 277 / 319 / 2, 195 / 320 / 3, 187 / 321 / 2, 124 / 322 / 3, 448 / 323 / 2, 468 / 324 / 2, 136 / 325 / 2, 256 / 326 / 3, 289 / 327 / 2, 97 / 328 / 3, 487 / 329 / 2, 472 / 330 / 2, 142 / 331 / 3, 149 / 332 / 2, 4 / 333 / 3, 461 / 334 / 2, 304 / 335 / 2, 327 / 336 / 2, 305 / 337 / 2, 62 / 338 / 2, 59 / 339 / 2, 200 / 340 / 2, 208 / 341 / 2, 482 / 342 / 2, 75 / 343 / 2, 133 / 344 / 2, 389 / 345 / 3, 254 / 346 / 2, 246 / 347 / 2, 491 / 348 / 2, 237 / 349 / 2, 110 / 350 / 2, 191 / 351 / 5, 241 / 355 / 4, 219 / 356 / 2, 77 / 357 / 2, 48 / 358 / 2, 447 / 359 / 4, 180 / 360 / 2, 426 / 361 / 2, 239 / 362 / 3, 35 / 363 / 2, 259 / 364 / 3, 38 / 368 / 3, 423 / 369 / 2, 143 / 370 / 3, 452 / 371 / 2, 381 / 372 / 2, 475 / 373 / 3, 380 / 374 / 2, 294 / 375 / 3, 375 / 376 / 2, 441 / 377 / 2, 67 / 378 / 2, 359 / 379 / 2, 167 / 380 / 2, 192 / 381 / 3, 234 / 382 / 2, 469 / 383 / 4, 229 / 384 / 2, 336 / 385 / 2, 94 / 386 / 4, 303 / 387 / 2, 296 / 388 / 2, 87 / 389 / 2, 364 / 390 / 3, 79 / 391 / 2, 415 / 392 / 3, 105 / 393 / 2, 156 / 394 / 3, 157 / 395 / 2, 111 / 396 / 3, 83 / 397 / 2, 178 / 398 / 3, 21 / 399 / 2, 210 / 400 / 2, 159 / 401 / 2, 32 / 402 / 2, 477 / 403 / 3, 496 / 404 / 2, 206 / 405 / 3, 203 / 406 / 2, 357 / 407 / 2, 275 / 408 / 3, 165 / 409 / 2, 137 / 410 / 2, 315 / 411 / 3, 138 / 412 / 2, 410 / 413 / 2, 449 / 414 / 3, 440 / 415 / 2, 390 / 416 / 2, 121 / 417 / 2, 252 / 418 / 2, 372 / 419 / 2, 489 / 424 / 2, 227 / 425 / 2, 3 / 426 / 2, 439 / 427 / 3, 413 / 428 / 2, 287 / 429 / 3, 333 / 430 / 2, 307 / 431 / 3, 152 / 432 / 2, 269 / 433 / 2, 280 / 434 / 3, 266 / 435 / 2, 434 / 436 / 2, 117 / 437 / 5, 66 / 438 / 2, 179 / 439 / 2, 371 / 440 / 2, 366 / 441 / 3, 257 / 442 / 2, 171 / 443 / 3, 446 / 444 / 2, 435 / 445 / 2, 432 / 446 / 2, 494 / 447 / 2, 164 / 448 / 2, 402 / 449 / 2, 129 / 450 / 3, 394 / 451 / 2, 414 / 452 / 2, 71 / 453 / 2, 92 / 454 / 2, 270 / 455 / 2, 278 / 456 / 3, 291 / 457 / 2, 181 / 458 / 3, 199 / 459 / 2, 272 / 460 / 2, 144 / 461 / 2, 391 / 462 / 2, 53 / 463 / 3, 393 / 464 / 2, 44 / 465 / 2, 497 / 466 / 4, 102 / 467 / 2, 76 / 468 / 2, 481 / 469 / 3, 125 / 471 / 2, 360 / 472 / 3, 147 / 473 / 2, 172 / 474 / 2, 61 / 475 / 3, 8 / 476 / 2, 282 / 477 / 2, 213 / 478 / 2, 348 / 479 / 3, 7 / 480 / 2, 85 / 481 / 3, 398 / 484 / 3, 451 / 485 / 2, 40 / 486 / 5, 41 / 487 / 2, 13 / 490 / 2, 123 / 491 / 2, 458 / 492 / 3, 346 / 493 / 2, 176 / 494 / 2, 27 / 495 / 2, 220 / 496 / 2, 173 / 497 / 3, 112 / 498 / 2, 106 / 499 / 2
uniform-alpha_1-14-n6.txt, 1, 1, 6, 239.081, 27, 21, 6, 5,4 / 1 / 6, 2 / 2 / 2, 5 / 3 / 2, 3 / 4 / 4, 1 / 5 / 2
uniform-alpha_1-15-n375.txt, 1, 1, 375, 1532.83, 2684, 2309, 5, 353,211 / 1 / 3, 70 / 2 / 2, 282 / 3 / 2, 118 / 4 / 3, 7 / 5 / 2, 95 / 6 / 3, 14 / 7 / 2, 268 / 8 / 3, 206 / 9 / 2, 261 / 10 / 2, 115 / 11 / 2, 194 / 12 / 2, 38 / 13 / 2, 210 / 14 / 4, 62 / 15 / 2, 293 / 16 / 2, 166 / 17 / 2, 72 / 18 / 2, 196 / 19 / 2, 262 / 20 / 2, 90 / 21 / 5, 297 / 22 / 2, 22 / 23 / 3, 331 / 24 / 2, 295 / 27 / 2, 317 / 28 / 2, 94 / 29 / 2, 34 / 30 / 2, 133 / 31 / 2, 92 / 32 / 3, 315 / 33 / 2, 218 / 34 / 5, 252 / 35 / 2, 203 / 36 / 2, 153 / 37 / 2, 270 / 38 / 2, 28 / 39 / 5, 217 / 40 / 2, 54 / 41 / 3, 369 / 42 / 2, 258 / 43 / 4, 372 / 44 / 2, 275 / 45 / 2, 162 / 46 / 2, 157 / 47 / 2, 42 / 48 / 2, 100 / 49 / 5, 361 / 50 / 2, 33 / 51 / 2, 12 / 52 / 2, 77 / 53 / 2, 301 / 54 / 4, 311 / 55 / 2, 352 / 56 / 2, 68 / 57 / 4, 304 / 58 / 2, 6 / 59 / 3, 358 / 60 / 2, 2 / 61 / 2, 184 / 62 / 2, 39 / 63 / 2, 207 / 64 / 2, 333 / 65 / 2, 9 / 66 / 2, 277 / 67 / 3, 129 / 68 / 2, 74 / 69 / 3, 140 / 70 / 2, 187 / 71 / 2, 251 / 72 / 2, 241 / 73 / 2, 117 / 74 / 2, 374 / 75 / 2, 322 / 76 / 2, 357 / 77 / 3, 105 / 78 / 2, 96 / 79 / 2, 231 / 80 / 2, 232 / 81 / 2, 163 / 82 / 2, 178 / 83 / 2, 224 / 84 / 2, 283 / 85 / 2, 128 / 86 / 2, 360 / 87 / 2, 152 / 88 / 4, 147 / 89 / 2, 155 / 90 / 2, 263 / 91 / 3, 135 / 92 / 2, 182 / 93 / 2, 324 / 94 / 2, 214 / 95 / 2, 141 / 96 / 5, 151 / 97 / 2, 335 / 98 / 2, 150 / 99 / 4, 306 / 100 / 2, 67 / 101 / 2, 240 / 102 / 2, 75 / 103 / 2, 294 / 104 / 2, 175 / 105 / 2, 159 / 106 / 3, 362 / 107 / 2, 109 / 108 / 3, 143 / 109 / 2, 371 / 110 / 2, 112 / 111 / 2, 56 / 112 / 2, 50 / 113 / 2, 111 / 114 / 4, 355 / 115 / 2, 273 / 116 / 2, 177 / 117 / 4, 107 / 118 / 2, 266 / 119 / 2, 63 / 120 / 2, 233 / 121 / 2, 51 / 122 / 2, 103 / 123 / 2, 353 / 124 / 2, 11 / 125 / 3, 359 / 126 / 2, 136 / 127 / 3, 57 / 128 / 2, 101 / 129 / 3, 122 / 130 / 2, 195 / 131 / 2, 121 / 132 / 2, 350 / 133 / 2, 309 / 134 / 2, 269 / 135 / 4, 257 / 136 / 2, 55 / 138 / 2, 167 / 139 / 3, 49 / 140 / 2, 126 / 141 / 2, 314 / 143 / 3, 1 / 144 / 2, 108 / 145 / 3, 104 / 146 / 2, 319 / 147 / 3, 193 / 148 / 2, 26 / 151 / 3, 215 / 152 / 2, 373 / 153 / 4, 328 / 154 / 2, 139 / 155 / 2, 330 / 156 / 2, 45 / 157 / 2, 83 / 158 / 2, 120 / 159 / 4, 246 / 160 / 2, 29 / 161 / 2, 253 / 162 / 3, 213 / 163 / 2, 329 / 164 / 2, 185 / 165 / 3, 289 / 166 / 2, 41 / 167 / 2, 234 / 168 / 2, 125 / 169 / 2, 113 / 170 / 3, 144 / 171 / 2, 145 / 172 / 2, 66 / 173 / 2, 174 / 174 / 4, 86 / 175 / 2, 346 / 176 / 2, 298 / 177 / 2, 192 / 178 / 4, 348 / 179 / 2, 370 / 180 / 2, 4 / 181 / 3, 276 / 182 / 2, 305 / 183 / 2, 123 / 184 / 2, 79 / 185 / 2, 183 / 186 / 3, 254 / 187 / 2, 25 / 188 / 2, 189 / 189 / 3, 247 / 190 / 2, 237 / 191 / 3, 236 / 192 / 2, 248 / 193 / 2, 35 / 194 / 3, 138 / 195 / 2, 91 / 196 / 2, 337 / 197 / 3, 43 / 198 / 2, 367 / 199 / 3, 116 / 200 / 2, 332 / 201 / 2, 10 / 204 / 2, 300 / 205 / 5, 284 / 206 / 2, 216 / 207 / 2, 347 / 208 / 2, 286 / 209 / 5, 225 / 210 / 2, 285 / 211 / 3, 93 / 212 / 2, 256 / 213 / 2, 78 / 214 / 2, 98 / 215 / 2, 3 / 216 / 3, 274 / 217 / 2, 146 / 218 / 3, 180 / 219 / 2, 102 / 220 / 2, 204 / 221 / 3, 290 / 222 / 2, 179 / 223 / 2, 341 / 224 / 2, 154 / 225 / 3, 16 / 226 / 2, 53 / 227 / 3, 73 / 228 / 2, 130 / 229 / 2, 24 / 230 / 4, 323 / 231 / 2, 99 / 232 / 3, 209 / 233 / 2, 334 / 234 / 2, 212 / 235 / 3, 127 / 236 / 2, 339 / 237 / 4, 40 / 238 / 2, 338 / 239 / 2, 368 / 240 / 2, 312 / 241 / 3, 137 / 242 / 2, 17 / 243 / 2, 281 / 244 / 2, 243 / 245 / 4, 23 / 246 / 2, 272 / 247 / 2, 278 / 248 / 2, 191 / 249 / 2, 250 / 250 / 2, 81 / 251 / 5, 198 / 252 / 2, 36 / 253 / 2, 181 / 254 / 2, 245 / 255 / 2, 170 / 256 / 3, 164 / 257 / 2, 320 / 258 / 2, 344 / 259 / 2, 97 / 260 / 3, 313 / 261 / 2, 336 / 264 / 2, 52 / 265 / 3, 318 / 266 / 2, 58 / 267 / 2, 201 / 268 / 4, 280 / 269 / 2, 158 / 270 / 2, 259 / 271 / 2, 310 / 272 / 4, 342 / 273 / 2, 160 / 274 / 2, 230 / 275 / 3, 44 / 276 / 2, 114 / 277 / 2, 303 / 278 / 2, 321 / 279 / 2, 60 / 280 / 3, 21 / 281 / 2, 267 / 282 / 2, 271 / 283 / 4, 220 / 287 / 2, 366 / 288 / 2, 148 / 289 / 2, 307 / 290 / 2, 228 / 291 / 3, 110 / 292 / 2, 89 / 293 / 3, 288 / 294 / 2, 222 / 295 / 4, 156 / 296 / 2, 249 / 298 / 2, 59 / 299 / 2, 131 / 300 / 3, 168 / 301 / 2, 202 / 302 / 2, 255 / 303 / 2, 32 / 304 / 4, 219 / 305 / 2, 190 / 306 / 2, 325 / 307 / 3, 18 / 308 / 2, 172 / 309 / 3, 132 / 310 / 2, 48 / 311 / 3, 308 / 312 / 2, 345 / 313 / 2, 354 / 314 / 2, 296 / 315 / 3, 171 / 316 / 2, 61 / 317 / 3, 208 / 319 / 4, 340 / 320 / 2, 119 / 321 / 2, 265 / 322 / 2, 5 / 323 / 2, 221 / 324 / 2, 176 / 325 / 2, 299 / 326 / 2, 173 / 327 / 4, 188 / 328 / 2, 8 / 329 / 3, 200 / 330 / 2, 238 / 333 / 2, 106 / 334 / 2, 71 / 335 / 4, 165 / 336 / 2, 13 / 337 / 2, 244 / 338 / 3, 260 / 339 / 2, 15 / 340 / 2, 356 / 341 / 2, 186 / 342 / 2, 85 / 343 / 3, 142 / 344 / 2, 365 / 345 / 3, 47 / 346 / 2, 279 / 347 / 2, 229 / 348 / 3, 363 / 350 / 2, 69 / 351 / 3, 316 / 352 / 2, 30 / 353 / 3, 65 / 354 / 2, 80 / 355 / 2, 82 / 356 / 3, 264 / 357 / 2, 64 / 358 / 3, 88 / 359 / 2, 223 / 360 / 3, 46 / 361 / 2, 161 / 362 / 3, 349 / 363 / 2, 326 / 364 / 3, 239 / 365 / 2, 19 / 366 / 4, 292 / 367 / 2, 205 / 368 / 2, 20 / 369 / 3, 287 / 372 / 3, 291 / 374 / 3
uniform-alpha_1-15-n6.txt, 1, 1, 6, 213.016, 24, 18, 4, 5,3 / 1 / 2, 1 / 2 / 4, 4 / 3 / 2, 5 / 4 / 2, 2 / 5 / 2
uniform-alpha_1-16-n375.txt, 1, 1, 375, 1570.44, 2677, 2302, 7, 356,114 / 1 / 2, 221 / 2 / 2, 105 / 3 / 2, 320 / 4 / 2, 85 / 5 / 2, 338 / 6 / 2, 278 / 7 / 2, 331 / 8 / 3, 325 / 9 / 2, 258 / 10 / 2, 42 / 11 / 2, 238 / 12 / 4, 32 / 15 / 3, 83 / 16 / 2, 302 / 17 / 5, 121 / 18 / 2, 280 / 19 / 2, 144 / 20 / 3, 214 / 21 / 2, 118 / 22 / 2, 2 / 23 / 6, 271 / 24 / 2, 249 / 25 / 3, 94 / 26 / 2, 355 / 27 / 2, 74 / 28 / 4, 363 / 29 / 2, 199 / 30 / 2, 340 / 31 / 2, 183 / 32 / 2, 19 / 33 / 2, 106 / 34 / 2, 28 / 35 / 3, 174 / 36 / 2, 333 / 37 / 4, 188 / 38 / 2, 164 / 39 / 2, 266 / 40 / 4, 145 / 41 / 2, 48 / 42 / 2, 141 / 43 / 2, 189 / 44 / 3, 240 / 45 / 2, 39 / 46 / 3, 140 / 47 / 2, 224 / 48 / 2, 217 / 49 / 3, 191 / 50 / 2, 61 / 51 / 2, 38 / 52 / 2, 241 / 53 / 3, 244 / 54 / 2, 53 / 55 / 2, 27 / 56 / 2, 67 / 57 / 3, 122 / 58 / 2, 99 / 59 / 2, 156 / 60 / 2, 371 / 61 / 2, 354 / 62 / 2, 178 / 63 / 3, 137 / 64 / 2, 51 / 65 / 2, 123 / 66 / 2, 107 / 67 / 3, 229 / 68 / 2, 250 / 69 / 2, 16 / 70 / 3, 307 / 71 / 2, 171 / 72 / 2, 4 / 73 / 2, 152 / 74 / 2, 151 / 75 / 4, 305 / 76 / 2, 231 / 77 / 2, 76 / 78 / 2, 314 / 79 / 2, 312 / 80 / 2, 98 / 81 / 2, 351 / 82 / 2, 267 / 83 / 2, 336 / 84 / 2, 50 / 85 / 3, 310 / 86 / 2, 147 / 87 / 2, 324 / 88 / 4, 56 / 89 / 2, 286 / 91 / 2, 21 / 92 / 2, 81 / 93 / 6, 60 / 94 / 2, 12 / 95 / 3, 35 / 96 / 2, 315 / 97 / 2, 29 / 98 / 2, 364 / 99 / 3, 162 / 100 / 2, 177 / 101 / 2, 134 / 102 / 2, 14 / 103 / 2, 155 / 104 / 2, 365 / 105 / 2, 218 / 106 / 3, 15 / 107 / 2, 242 / 108 / 3, 262 / 109 / 2, 304 / 110 / 2, 313 / 111 / 3, 236 / 112 / 2, 93 / 113 / 2, 135 / 114 / 2, 90 / 115 / 2, 234 / 116 / 2, 41 / 117 / 2, 175 / 118 / 3, 132 / 119 / 2, 142 / 120 / 2, 281 / 121 / 2, 44 / 122 / 2, 197 / 123 / 2, 348 / 124 / 2, 212 / 125 / 3, 125 / 127 / 3, 345 / 128 / 2, 34 / 129 / 2, 246 / 130 / 2, 92 / 131 / 7, 300 / 132 / 2, 130 / 133 / 3, 149 / 136 / 3, 25 / 137 / 2, 78 / 138 / 3, 349 / 139 / 2, 193 / 140 / 2, 342 / 141 / 2, 207 / 142 / 4, 356 / 143 / 2, 201 / 144 / 2, 10 / 145 / 2, 113 / 146 / 3, 226 / 148 / 2, 97 / 149 / 4, 254 / 150 / 2, 111 / 151 / 2, 277 / 152 / 2, 64 / 153 / 4, 272 / 154 / 2, 308 / 155 / 3, 321 / 156 / 2, 228 / 157 / 3, 46 / 158 / 2, 101 / 159 / 2, 287 / 160 / 4, 265 / 161 / 2, 153 / 162 / 2, 169 / 163 / 3, 168 / 164 / 2, 343 / 165 / 3, 322 / 166 / 2, 233 / 167 / 2, 160 / 168 / 4, 13 / 169 / 2, 7 / 170 / 2, 23 / 171 / 3, 306 / 172 / 2, 150 / 173 / 2, 284 / 174 / 2, 317 / 175 / 2, 100 / 176 / 2, 129 / 177 / 2, 316 / 178 / 2, 163 / 179 / 2, 138 / 180 / 2, 208 / 181 / 3, 37 / 182 / 2, 366 / 183 / 2, 357 / 184 / 3, 261 / 187 / 3, 341 / 188 / 2, 361 / 189 / 2, 80 / 190 / 3, 180 / 191 / 2, 319 / 192 / 2, 167 / 193 / 2, 146 / 194 / 2, 166 / 195 / 2, 116 / 196 / 2, 102 / 197 / 2, 198 / 198 / 2, 73 / 199 / 2, 294 / 202 / 3, 296 / 203 / 2, 264 / 204 / 2, 295 / 205 / 3, 1 / 206 / 2, 334 / 207 / 3, 353 / 208 / 2, 200 / 209 / 3, 31 / 210 / 2, 237 / 211 / 4, 213 / 212 / 2, 71 / 213 / 2, 352 / 214 / 3, 157 / 215 / 2, 328 / 216 / 3, 133 / 217 / 2, 119 / 218 / 2, 374 / 219 / 2, 43 / 220 / 2, 69 / 221 / 2, 103 / 222 / 2, 8 / 223 / 2, 373 / 224 / 2, 256 / 225 / 2, 184 / 226 / 2, 110 / 227 / 2, 3 / 228 / 2, 159 / 229 / 3, 245 / 230 / 2, 47 / 231 / 2, 239 / 232 / 2, 109 / 233 / 2, 173 / 234 / 2, 79 / 235 / 3, 139 / 236 / 2, 65 / 237 / 2, 370 / 238 / 2, 33 / 239 / 4, 126 / 240 / 2, 358 / 241 / 2, 290 / 242 / 2, 299 / 243 / 3, 84 / 244 / 2, 185 / 245 / 3, 309 / 246 / 2, 252 / 248 / 2, 260 / 249 / 3, 165 / 250 / 2, 176 / 251 / 3, 263 / 252 / 2, 360 / 253 / 5, 18 / 254 / 2, 30 / 255 / 2, 279 / 256 / 2, 329 / 257 / 3, 117 / 258 / 2, 112 / 259 / 2, 255 / 260 / 4, 59 / 261 / 2, 323 / 262 / 2, 327 / 263 / 2, 49 / 264 / 2, 247 / 265 / 2, 282 / 266 / 4, 154 / 267 / 2, 251 / 268 / 2, 257 / 269 / 4, 347 / 270 / 2, 179 / 272 / 3, 346 / 273 / 2, 70 / 274 / 3, 367 / 275 / 2, 124 / 276 / 3, 58 / 277 / 2, 66 / 278 / 2, 297 / 279 / 2, 5 / 280 / 3, 86 / 281 / 2, 368 / 282 / 3, 68 / 283 / 2, 350 / 284 / 3, 6 / 285 / 2, 230 / 286 / 3, 182 / 287 / 2, 335 / 288 / 2, 268 / 289 / 2, 339 / 290 / 3, 285 / 291 / 2, 227 / 292 / 3, 26 / 293 / 2, 55 / 294 / 3, 359 / 295 / 2, 136 / 296 / 3, 181 / 299 / 4, 195 / 300 / 2, 204 / 301 / 2, 215 / 302 / 2, 95 / 303 / 2, 52 / 304 / 2, 206 / 305 / 2, 9 / 306 / 3, 187 / 307 / 2, 232 / 308 / 3, 269 / 309 / 2, 170 / 310 / 2, 88 / 311 / 3, 291 / 312 / 2, 192 / 313 / 2, 326 / 314 / 3, 190 / 315 / 2, 273 / 316 / 2, 11 / 317 / 3, 161 / 318 / 2, 87 / 319 / 2, 344 / 320 / 3, 75 / 321 / 2, 318 / 322 / 2, 243 / 323 / 2, 24 / 324 / 4, 216 / 325 / 2, 108 / 326 / 2, 194 / 327 / 4, 17 / 328 / 2, 104 / 330 / 2, 220 / 331 / 4, 22 / 332 / 2, 62 / 333 / 2, 172 / 334 / 2, 63 / 335 / 3, 253 / 336 / 2, 211 / 337 / 3, 115 / 338 / 2, 82 / 339 / 2, 303 / 340 / 4, 120 / 341 / 2, 248 / 342 / 2, 54 / 343 / 2, 301 / 344 / 3, 293 / 347 / 3, 36 / 348 / 2, 275 / 349 / 3, 276 / 350 / 2, 202 / 351 / 3, 210 / 352 / 2, 45 / 353 / 3, 298 / 354 / 2, 96 / 355 / 2, 288 / 356 / 2, 205 / 357 / 5, 40 / 358 / 2, 372 / 359 / 2, 259 / 360 / 2, 91 / 361 / 2, 289 / 362 / 3, 332 / 363 / 2, 158 / 364 / 2, 225 / 365 / 3, 292 / 366 / 2, 89 / 367 / 2, 274 / 368 / 2, 219 / 369 / 2, 72 / 370 / 2, 131 / 371 / 2, 143 / 372 / 2, 186 / 373 / 2, 148 / 374 / 5
uniform-alpha_1-16-n6.txt, 1, 1, 6, 278.498, 23, 17, 3, 5,1 / 1 / 2, 2 / 2 / 3, 5 / 3 / 2, 4 / 4 / 2, 3 / 5 / 2
uniform-alpha_1-17-n375.txt, 1, 1, 375, 1558.92, 2763, 2388, 8, 352,45 / 1 / 3, 253 / 2 / 2, 88 / 3 / 2, 148 / 4 / 3, 66 / 5 / 2, 7 / 6 / 2, 358 / 7 / 2, 323 / 8 / 3, 274 / 9 / 2, 222 / 10 / 2, 94 / 11 / 2, 92 / 12 / 2, 269 / 13 / 3, 149 / 14 / 2, 232 / 15 / 3, 192 / 16 / 2, 64 / 17 / 3, 178 / 18 / 2, 366 / 19 / 2, 304 / 20 / 3, 129 / 21 / 2, 177 / 22 / 4, 311 / 23 / 2, 139 / 24 / 2, 281 / 25 / 2, 295 / 26 / 2, 239 / 27 / 2, 352 / 28 / 2, 38 / 29 / 3, 18 / 30 / 2, 350 / 31 / 2, 115 / 32 / 3, 181 / 33 / 2, 22 / 34 / 3, 329 / 35 / 2, 341 / 36 / 2, 111 / 37 / 2, 259 / 38 / 3, 27 / 39 / 2, 107 / 40 / 2, 286 / 41 / 2, 145 / 42 / 2, 231 / 43 / 2, 132 / 44 / 4, 349 / 45 / 2, 195 / 46 / 2, 371 / 47 / 3, 126 / 48 / 2, 326 / 49 / 3, 24 / 50 / 2, 272 / 51 / 2, 188 / 52 / 3, 105 / 53 / 2, 346 / 54 / 2, 74 / 55 / 2, 112 / 56 / 2, 336 / 57 / 2, 87 / 58 / 2, 116 / 59 / 4, 229 / 60 / 2, 290 / 61 / 2, 202 / 62 / 2, 172 / 63 / 2, 68 / 64 / 2, 72 / 65 / 2, 364 / 66 / 3, 2 / 67 / 2, 265 / 68 / 3, 118 / 69 / 2, 30 / 70 / 2, 103 / 71 / 2, 117 / 72 / 2, 127 / 73 / 4, 363 / 74 / 2, 152 / 75 / 2, 69 / 76 / 4, 370 / 77 / 2, 245 / 78 / 2, 196 / 79 / 2, 291 / 80 / 2, 308 / 81 / 3, 353 / 82 / 2, 236 / 83 / 3, 300 / 84 / 2, 354 / 85 / 2, 194 / 86 / 2, 6 / 87 / 2, 204 / 88 / 2, 158 / 89 / 4, 264 / 90 / 2, 301 / 91 / 2, 163 / 92 / 4, 155 / 93 / 2, 215 / 94 / 3, 89 / 95 / 2, 25 / 96 / 2, 203 / 97 / 3, 17 / 98 / 2, 324 / 99 / 3, 180 / 100 / 2, 271 / 101 / 2, 51 / 102 / 3, 29 / 103 / 2, 331 / 104 / 3, 142 / 105 / 2, 197 / 106 / 3, 60 / 107 / 2, 76 / 108 / 2, 83 / 109 / 2, 296 / 110 / 2, 46 / 111 / 3, 99 / 112 / 2, 41 / 113 / 2, 154 / 114 / 4, 44 / 115 / 2, 340 / 116 / 2, 179 / 117 / 3, 237 / 118 / 2, 159 / 119 / 3, 82 / 120 / 2, 342 / 121 / 2, 164 / 122 / 5, 299 / 123 / 2, 255 / 124 / 2, 37 / 125 / 2, 292 / 126 / 5, 266 / 127 / 2, 171 / 129 / 3, 246 / 130 / 2, 143 / 131 / 2, 243 / 132 / 2, 285 / 133 / 2, 144 / 134 / 2, 160 / 135 / 2, 59 / 136 / 2, 28 / 137 / 2, 235 / 138 / 6, 67 / 139 / 2, 369 / 140 / 3, 184 / 144 / 2, 262 / 145 / 2, 310 / 146 / 6, 335 / 147 / 2, 150 / 148 / 2, 250 / 149 / 3, 122 / 150 / 2, 302 / 151 / 3, 156 / 152 / 2, 344 / 153 / 3, 307 / 154 / 2, 347 / 155 / 3, 359 / 156 / 2, 234 / 157 / 3, 75 / 158 / 2, 121 / 159 / 2, 57 / 160 / 2, 315 / 161 / 2, 210 / 162 / 2, 96 / 163 / 2, 277 / 164 / 2, 104 / 165 / 2, 294 / 166 / 3, 280 / 167 / 2, 98 / 168 / 3, 165 / 169 / 2, 50 / 170 / 2, 227 / 171 / 2, 175 / 172 / 2, 135 / 173 / 2, 343 / 174 / 2, 332 / 175 / 2, 233 / 176 / 2, 80 / 177 / 3, 162 / 178 / 2, 309 / 179 / 3, 275 / 180 / 2, 321 / 183 / 2, 125 / 184 / 4, 267 / 187 / 8, 174 / 188 / 2, 230 / 189 / 2, 20 / 190 / 2, 314 / 191 / 3, 110 / 192 / 2, 217 / 193 / 3, 288 / 194 / 2, 244 / 195 / 3, 23 / 196 / 2, 337 / 197 / 2, 213 / 198 / 2, 9 / 199 / 5, 168 / 200 / 2, 169 / 201 / 2, 106 / 202 / 2, 367 / 203 / 3, 176 / 206 / 3, 79 / 207 / 2, 84 / 208 / 3, 240 / 209 / 2, 182 / 210 / 2, 278 / 211 / 2, 119 / 212 / 3, 130 / 213 / 2, 173 / 214 / 4, 73 / 215 / 2, 19 / 216 / 2, 138 / 217 / 4, 252 / 218 / 2, 1 / 219 / 2, 279 / 220 / 5, 3 / 221 / 2, 93 / 223 / 2, 360 / 224 / 4, 362 / 225 / 2, 26 / 226 / 2, 211 / 227 / 2, 368 / 228 / 2, 228 / 229 / 3, 157 / 230 / 2, 102 / 231 / 2, 357 / 232 / 3, 123 / 233 / 2, 161 / 234 / 3, 328 / 235 / 2, 52 / 236 / 4, 40 / 237 / 2, 351 / 239 / 4, 153 / 240 / 2, 113 / 241 / 2, 137 / 242 / 4, 15 / 243 / 2, 282 / 244 / 2, 190 / 245 / 4, 225 / 246 / 2, 70 / 247 / 3, 322 / 248 / 2, 338 / 249 / 3, 325 / 250 / 2, 293 / 251 / 2, 191 / 252 / 2, 312 / 253 / 4, 313 / 254 / 2, 151 / 255 / 2, 71 / 256 / 2, 146 / 257 / 2, 306 / 258 / 3, 317 / 259 / 2, 263 / 260 / 5, 214 / 261 / 2, 61 / 262 / 2, 209 / 263 / 2, 85 / 264 / 4, 355 / 265 / 2, 86 / 266 / 3, 16 / 267 / 2, 63 / 268 / 2, 205 / 269 / 2, 319 / 270 / 4, 216 / 271 / 2, 270 / 272 / 2, 109 / 273 / 2, 128 / 274 / 2, 224 / 275 / 2, 183 / 276 / 2, 256 / 277 / 2, 78 / 278 / 2, 8 / 279 / 2, 95 / 280 / 3, 170 / 281 / 2, 257 / 282 / 4, 287 / 285 / 3, 13 / 286 / 2, 318 / 287 / 2, 31 / 288 / 3, 108 / 289 / 2, 200 / 290 / 3, 187 / 291 / 2, 54 / 292 / 2, 193 / 293 / 3, 48 / 294 / 2, 327 / 295 / 2, 249 / 296 / 2, 361 / 297 / 3, 166 / 298 / 2, 223 / 299 / 4, 140 / 300 / 2, 258 / 301 / 2, 356 / 302 / 3, 251 / 303 / 2, 90 / 304 / 3, 185 / 310 / 3, 42 / 311 / 2, 226 / 312 / 3, 273 / 313 / 2, 35 / 314 / 3, 218 / 315 / 2, 65 / 316 / 3, 303 / 317 / 2, 21 / 318 / 2, 333 / 319 / 2, 36 / 320 / 2, 47 / 321 / 2, 186 / 322 / 4, 39 / 323 / 2, 77 / 324 / 2, 120 / 325 / 2, 334 / 326 / 4, 208 / 327 / 2, 147 / 328 / 2, 221 / 329 / 3, 289 / 330 / 2, 212 / 331 / 3, 248 / 332 / 2, 365 / 333 / 3, 316 / 334 / 2, 101 / 335 / 2, 198 / 336 / 3, 372 / 337 / 2, 133 / 338 / 3, 55 / 339 / 2, 14 / 340 / 2, 4 / 341 / 2, 33 / 342 / 2, 131 / 343 / 2, 345 / 344 / 2, 238 / 345 / 2, 5 / 346 / 2, 91 / 347 / 3, 283 / 348 / 2, 114 / 349 / 2, 330 / 350 / 2, 12 / 351 / 3, 124 / 352 / 2, 136 / 353 / 2, 247 / 354 / 3, 219 / 355 / 2, 207 / 356 / 4, 374 / 359 / 2, 97 / 360 / 2, 241 / 361 / 2, 100 / 362 / 3, 141 / 363 / 2, 62 / 364 / 2, 254 / 365 / 2, 348 / 366 / 2, 58 / 367 / 3, 49 / 369 / 2, 10 / 370 / 2, 339 / 371 / 2, 284 / 372 / 2, 134 / 373 / 3, 201 / 374 / 2
uniform-alpha_1-17-n6.txt, 1, 1, 6, 304.326, 25, 19, 3, 5,2 / 1 / 3, 5 / 2 / 2, 4 / 3 / 3, 3 / 4 / 2, 1 / 5 / 3
uniform-alpha_1-18-n375.txt, 1, 1, 375, 1551.45, 2640, 2265, 6, 345,272 / 1 / 3, 155 / 3 / 5, 95 / 4 / 2, 369 / 5 / 2, 3 / 6 / 2, 284 / 7 / 3, 170 / 8 / 2, 325 / 9 / 2, 286 / 10 / 3, 90 / 11 / 2, 75 / 14 / 4, 149 / 15 / 2, 106 / 17 / 3, 279 / 18 / 2, 329 / 19 / 4, 16 / 20 / 2, 49 / 21 / 3, 276 / 22 / 2, 143 / 23 / 2, 306 / 24 / 2, 343 / 25 / 2, 157 / 26 / 3, 38 / 27 / 2, 150 / 28 / 3, 240 / 29 / 2, 147 / 30 / 2, 54 / 31 / 2, 291 / 32 / 2, 225 / 33 / 3, 255 / 34 / 2, 298 / 37 / 3, 59 / 38 / 2, 332 / 39 / 2, 254 / 40 / 3, 78 / 41 / 2, 96 / 42 / 2, 93 / 43 / 4, 262 / 44 / 2, 161 / 45 / 2, 211 / 46 / 3, 324 / 47 / 2, 360 / 48 / 2, 80 / 49 / 2, 323 / 50 / 3, 26 / 51 / 2, 114 / 52 / 2, 94 / 53 / 2, 307 / 54 / 4, 69 / 55 / 2, 46 / 56 / 2, 136 / 57 / 2, 194 / 58 / 2, 193 / 59 / 3, 221 / 60 / 2, 117 / 61 / 3, 97 / 62 / 2, 339 / 63 / 3, 160 / 64 / 2, 226 / 65 / 4, 74 / 66 / 2, 182 / 67 / 3, 327 / 68 / 2, 87 / 69 / 4, 337 / 70 / 2, 344 / 71 / 2, 158 / 72 / 3, 308 / 73 / 2, 230 / 74 / 2, 166 / 75 / 2, 29 / 76 / 3, 20 / 77 / 2, 144 / 78 / 3, 83 / 79 / 2, 132 / 80 / 3, 84 / 81 / 2, 200 / 82 / 2, 159 / 83 / 2, 184 / 84 / 2, 357 / 85 / 2, 350 / 86 / 4, 247 / 87 / 2, 190 / 88 / 2, 287 / 89 / 2, 266 / 90 / 2, 241 / 91 / 2, 127 / 92 / 2, 245 / 93 / 2, 238 / 94 / 2, 328 / 95 / 2, 198 / 96 / 2, 237 / 97 / 4, 172 / 98 / 2, 336 / 99 / 3, 312 / 100 / 2, 280 / 101 / 2, 175 / 102 / 2, 42 / 103 / 2, 9 / 104 / 3, 5 / 105 / 2, 178 / 106 / 2, 64 / 107 / 2, 365 / 108 / 3, 44 / 109 / 2, 135 / 110 / 2, 125 / 111 / 2, 104 / 112 / 3, 318 / 113 / 2, 152 / 114 / 3, 341 / 115 / 2, 330 / 116 / 2, 68 / 117 / 2, 167 / 118 / 2, 12 / 119 / 2, 244 / 120 / 2, 28 / 121 / 2, 371 / 122 / 2, 73 / 123 / 2, 191 / 124 / 3, 8 / 125 / 2, 223 / 126 / 3, 354 / 127 / 2, 15 / 128 / 3, 199 / 129 / 2, 304 / 130 / 2, 368 / 131 / 2, 86 / 132 / 2, 65 / 133 / 2, 35 / 134 / 3, 295 / 135 / 2, 50 / 137 / 3, 213 / 138 / 2, 177 / 139 / 3, 48 / 140 / 2, 109 / 141 / 2, 121 / 142 / 2, 216 / 143 / 2, 214 / 144 / 2, 24 / 145 / 3, 192 / 146 / 2, 290 / 147 / 2, 7 / 148 / 3, 189 / 149 / 2, 258 / 150 / 3, 61 / 151 / 2, 112 / 152 / 4, 231 / 153 / 2, 333 / 155 / 2, 317 / 156 / 3, 92 / 157 / 2, 51 / 158 / 2, 356 / 159 / 2, 283 / 160 / 3, 60 / 161 / 2, 229 / 162 / 2, 105 / 163 / 2, 156 / 164 / 3, 186 / 165 / 2, 110 / 166 / 3, 119 / 167 / 2, 320 / 168 / 2, 195 / 169 / 3, 303 / 170 / 2, 17 / 171 / 3, 82 / 173 / 3, 79 / 174 / 2, 207 / 175 / 2, 76 / 176 / 2, 18 / 177 / 5, 294 / 178 / 2, 187 / 179 / 3, 88 / 180 / 2, 292 / 181 / 3, 134 / 182 / 2, 205 / 183 / 2, 242 / 184 / 3, 118 / 185 / 2, 352 / 186 / 3, 259 / 187 / 2, 271 / 188 / 2, 293 / 189 / 2, 274 / 190 / 2, 66 / 191 / 3, 141 / 192 / 2, 103 / 193 / 2, 130 / 194 / 2, 297 / 198 / 2, 168 / 199 / 6, 201 / 200 / 2, 122 / 201 / 2, 309 / 202 / 3, 52 / 203 / 2, 252 / 204 / 4, 236 / 205 / 2, 316 / 206 / 3, 40 / 207 / 2, 351 / 208 / 2, 4 / 209 / 2, 72 / 210 / 5, 63 / 211 / 2, 251 / 212 / 2, 363 / 213 / 2, 151 / 214 / 3, 340 / 217 / 3, 288 / 218 / 2, 21 / 219 / 2, 25 / 220 / 4, 374 / 221 / 2, 282 / 222 / 2, 305 / 223 / 2, 131 / 224 / 2, 314 / 225 / 3, 219 / 226 / 2, 234 / 227 / 2, 321 / 228 / 5, 100 / 229 / 2, 331 / 232 / 2, 342 / 233 / 4, 81 / 234 / 2, 335 / 235 / 2, 366 / 236 / 2, 243 / 237 / 3, 183 / 238 / 2, 37 / 239 / 3, 220 / 240 / 2, 206 / 241 / 4, 269 / 242 / 2, 275 / 243 / 2, 296 / 244 / 2, 319 / 245 / 3, 180 / 246 / 2, 315 / 247 / 2, 115 / 248 / 2, 256 / 249 / 3, 108 / 250 / 2, 101 / 251 / 3, 278 / 252 / 2, 239 / 253 / 2, 138 / 254 / 2, 36 / 255 / 3, 99 / 256 / 2, 179 / 257 / 2, 217 / 258 / 4, 261 / 260 / 2, 218 / 261 / 2, 53 / 262 / 2, 11 / 263 / 2, 145 / 264 / 3, 154 / 265 / 2, 30 / 266 / 2, 55 / 267 / 2, 289 / 268 / 3, 33 / 269 / 2, 39 / 270 / 3, 146 / 271 / 2, 227 / 272 / 2, 31 / 273 / 2, 32 / 274 / 4, 311 / 275 / 2, 277 / 276 / 2, 222 / 277 / 4, 299 / 278 / 2, 111 / 281 / 3, 14 / 282 / 2, 281 / 283 / 2, 210 / 284 / 2, 185 / 285 / 2, 334 / 286 / 2, 140 / 287 / 2, 232 / 288 / 2, 120 / 289 / 2, 19 / 290 / 3, 257 / 291 / 2, 45 / 292 / 3, 70 / 295 / 2, 196 / 296 / 3, 249 / 297 / 2, 197 / 298 / 3, 13 / 299 / 2, 367 / 302 / 3, 27 / 303 / 2, 107 / 304 / 2, 164 / 305 / 2, 116 / 306 / 4, 126 / 307 / 2, 85 / 308 / 3, 224 / 309 / 2, 57 / 310 / 2, 56 / 311 / 2, 174 / 312 / 3, 148 / 313 / 2, 41 / 314 / 2, 302 / 315 / 2, 246 / 316 / 3, 91 / 317 / 2, 203 / 318 / 3, 139 / 319 / 2, 347 / 320 / 3, 153 / 321 / 2, 358 / 322 / 2, 326 / 323 / 4, 89 / 324 / 2, 62 / 325 / 3, 176 / 326 / 2, 253 / 327 / 2, 346 / 328 / 2, 285 / 329 / 4, 10 / 330 / 2, 353 / 331 / 2, 273 / 332 / 3, 2 / 333 / 2, 228 / 334 / 3, 133 / 337 / 4, 123 / 339 / 2, 364 / 340 / 3, 263 / 341 / 2, 162 / 342 / 3, 43 / 343 / 2, 142 / 344 / 2, 212 / 345 / 2, 77 / 346 / 2, 98 / 347 / 2, 322 / 348 / 2, 171 / 349 / 2, 47 / 350 / 2, 265 / 351 / 3, 349 / 352 / 2, 348 / 353 / 2, 313 / 354 / 4, 71 / 355 / 2, 270 / 356 / 2, 202 / 357 / 2, 310 / 358 / 2, 373 / 359 / 2, 102 / 360 / 2, 208 / 361 / 2, 169 / 362 / 2, 361 / 364 / 2, 264 / 365 / 3, 345 / 366 / 2, 137 / 367 / 3, 204 / 368 / 2, 129 / 369 / 3, 188 / 370 / 2, 128 / 373 / 3, 355 / 374 / 2
uniform-alpha_1-18-n6.txt, 1, 1, 6, 238.14, 28, 22, 6, 5,5 / 1 / 5, 4 / 2 / 2, 1 / 3 / 3, 2 / 4 / 2, 3 / 5 / 6
uniform-alpha_1-19-n375.txt, 1, 1, 375, 1495.36, 2816, 2441, 11, 333,356 / 1 / 2, 221 / 2 / 2, 363 / 3 / 2, 247 / 4 / 2, 175 / 5 / 2, 364 / 6 / 2, 56 / 7 / 2, 149 / 8 / 2, 123 / 9 / 2, 169 / 10 / 3, 84 / 13 / 2, 40 / 14 / 2, 333 / 15 / 3, 161 / 16 / 2, 318 / 17 / 3, 144 / 18 / 2, 192 / 19 / 2, 205 / 20 / 2, 310 / 21 / 2, 73 / 22 / 2, 69 / 23 / 2, 346 / 24 / 3, 214 / 25 / 2, 266 / 26 / 3, 54 / 27 / 2, 97 / 28 / 2, 153 / 29 / 2, 25 / 30 / 2, 270 / 31 / 4, 33 / 32 / 2, 50 / 33 / 2, 279 / 34 / 2, 64 / 35 / 2, 350 / 36 / 2, 76 / 37 / 2, 249 / 38 / 3, 325 / 39 / 2, 260 / 40 / 2, 78 / 41 / 3, 107 / 42 / 2, 121 / 43 / 3, 15 / 44 / 2, 7 / 45 / 3, 311 / 46 / 2, 71 / 47 / 2, 8 / 48 / 3, 368 / 51 / 4, 347 / 52 / 2, 374 / 53 / 2, 336 / 54 / 2, 38 / 55 / 2, 274 / 56 / 2, 289 / 57 / 2, 6 / 58 / 3, 89 / 59 / 2, 309 / 60 / 2, 313 / 61 / 3, 197 / 62 / 2, 47 / 63 / 2, 200 / 64 / 2, 143 / 65 / 4, 22 / 66 / 2, 287 / 67 / 2, 124 / 68 / 3, 220 / 69 / 2, 182 / 70 / 2, 237 / 71 / 2, 244 / 72 / 5, 52 / 73 / 2, 233 / 74 / 3, 140 / 75 / 2, 120 / 76 / 5, 204 / 77 / 2, 180 / 78 / 3, 245 / 79 / 2, 215 / 82 / 2, 95 / 83 / 3, 238 / 84 / 2, 158 / 85 / 3, 46 / 86 / 2, 90 / 87 / 2, 280 / 88 / 2, 201 / 89 / 3, 213 / 90 / 2, 126 / 91 / 2, 196 / 92 / 4, 130 / 93 / 2, 194 / 94 / 2, 28 / 95 / 3, 101 / 96 / 2, 193 / 97 / 2, 49 / 98 / 3, 253 / 99 / 2, 284 / 100 / 5, 317 / 101 / 2, 207 / 102 / 2, 42 / 103 / 2, 141 / 104 / 2, 114 / 105 / 2, 119 / 106 / 2, 32 / 107 / 4, 235 / 108 / 2, 228 / 111 / 2, 278 / 112 / 2, 26 / 113 / 2, 236 / 114 / 3, 122 / 115 / 2, 259 / 116 / 3, 113 / 117 / 2, 239 / 118 / 2, 338 / 119 / 2, 13 / 120 / 2, 314 / 121 / 3, 296 / 122 / 2, 232 / 124 / 2, 55 / 125 / 2, 166 / 126 / 2, 298 / 127 / 2, 106 / 128 / 2, 358 / 129 / 2, 225 / 130 / 2, 128 / 131 / 2, 77 / 132 / 4, 39 / 133 / 2, 230 / 134 / 2, 79 / 135 / 4, 254 / 136 / 2, 303 / 137 / 2, 371 / 138 / 3, 152 / 139 / 2, 334 / 140 / 2, 327 / 141 / 2, 44 / 142 / 4, 66 / 143 / 2, 34 / 144 / 2, 349 / 145 / 4, 300 / 147 / 2, 210 / 148 / 3, 255 / 151 / 2, 316 / 152 / 2, 62 / 153 / 3, 108 / 156 / 3, 86 / 157 / 2, 292 / 158 / 3, 160 / 159 / 2, 256 / 160 / 2, 103 / 161 / 4, 273 / 162 / 2, 372 / 165 / 2, 177 / 166 / 2, 184 / 167 / 2, 81 / 168 / 2, 357 / 169 / 2, 4 / 170 / 3, 342 / 171 / 2, 30 / 172 / 2, 87 / 173 / 2, 335 / 174 / 2, 57 / 175 / 4, 109 / 176 / 2, 345 / 177 / 2, 125 / 178 / 2, 27 / 179 / 3, 186 / 180 / 2, 178 / 181 / 4, 265 / 182 / 2, 272 / 183 / 2, 290 / 184 / 6, 261 / 185 / 2, 88 / 186 / 2, 353 / 189 / 5, 198 / 190 / 2, 61 / 193 / 3, 145 / 194 / 2, 21 / 195 / 2, 286 / 196 / 2, 53 / 197 / 3, 110 / 198 / 2, 36 / 199 / 3, 252 / 200 / 2, 202 / 201 / 2, 19 / 202 / 3, 2 / 203 / 2, 132 / 204 / 3, 267 / 206 / 3, 354 / 207 / 2, 285 / 208 / 2, 241 / 209 / 2, 351 / 210 / 2, 291 / 211 / 3, 14 / 212 / 2, 118 / 213 / 2, 10 / 214 / 4, 135 / 215 / 2, 104 / 216 / 3, 24 / 217 / 2, 359 / 218 / 3, 181 / 220 / 4, 332 / 221 / 2, 227 / 222 / 3, 74 / 224 / 5, 58 / 227 / 2, 191 / 228 / 3, 246 / 229 / 2, 151 / 230 / 2, 373 / 231 / 3, 251 / 234 / 3, 167 / 235 / 2, 137 / 236 / 3, 361 / 237 / 2, 324 / 238 / 2, 165 / 239 / 3, 344 / 240 / 2, 170 / 241 / 3, 117 / 242 / 2, 60 / 243 / 2, 139 / 244 / 3, 102 / 245 / 2, 231 / 246 / 2, 91 / 247 / 3, 5 / 248 / 2, 189 / 249 / 2, 150 / 250 / 2, 59 / 251 / 3, 234 / 252 / 2, 82 / 253 / 3, 337 / 254 / 2, 41 / 255 / 2, 9 / 256 / 3, 248 / 257 / 2, 131 / 258 / 2, 72 / 259 / 2, 188 / 260 / 4, 157 / 261 / 2, 185 / 262 / 3, 29 / 263 / 2, 85 / 265 / 3, 115 / 266 / 2, 93 / 267 / 2, 129 / 268 / 3, 307 / 269 / 2, 94 / 270 / 5, 343 / 271 / 2, 369 / 273 / 4, 203 / 274 / 2, 51 / 277 / 4, 276 / 278 / 2, 187 / 279 / 2, 282 / 280 / 2, 159 / 281 / 11, 262 / 282 / 2, 264 / 283 / 2, 242 / 284 / 2, 321 / 285 / 3, 176 / 287 / 3, 35 / 288 / 2, 243 / 289 / 3, 20 / 290 / 2, 352 / 291 / 3, 222 / 292 / 2, 162 / 293 / 2, 302 / 294 / 2, 134 / 295 / 2, 339 / 296 / 3, 250 / 297 / 2, 199 / 298 / 3, 329 / 299 / 2, 277 / 301 / 2, 171 / 302 / 2, 299 / 303 / 2, 216 / 304 / 2, 75 / 307 / 2, 275 / 308 / 2, 138 / 309 / 3, 312 / 310 / 2, 208 / 311 / 3, 218 / 312 / 2, 168 / 313 / 3, 133 / 314 / 2, 323 / 315 / 3, 229 / 316 / 2, 163 / 317 / 2, 48 / 318 / 4, 209 / 319 / 2, 362 / 320 / 2, 370 / 321 / 4, 263 / 322 / 2, 43 / 323 / 2, 301 / 324 / 2, 146 / 325 / 3, 295 / 326 / 2, 306 / 327 / 3, 179 / 328 / 2, 212 / 329 / 3, 23 / 330 / 2, 31 / 331 / 3, 67 / 332 / 2, 98 / 333 / 2, 183 / 334 / 3, 155 / 335 / 2, 136 / 336 / 2, 322 / 337 / 3, 315 / 340 / 5, 226 / 341 / 2, 365 / 342 / 2, 219 / 343 / 2, 12 / 344 / 4, 147 / 345 / 2, 172 / 346 / 2, 223 / 347 / 2, 190 / 348 / 4, 281 / 349 / 2, 96 / 350 / 2, 348 / 351 / 2, 68 / 352 / 3, 288 / 355 / 5, 154 / 356 / 2, 173 / 357 / 2, 70 / 358 / 2, 305 / 359 / 4, 269 / 361 / 2, 257 / 362 / 2, 112 / 363 / 2, 330 / 364 / 2, 83 / 365 / 2, 65 / 366 / 2, 148 / 367 / 4, 326 / 368 / 2, 127 / 370 / 3, 224 / 371 / 2, 18 / 372 / 2, 304 / 373 / 3, 164 / 374 / 2
uniform-alpha_1-19-n6.txt, 1, 1, 6, 269.17, 26, 20, 6, 5,1 / 1 / 3, 4 / 2 / 2, 3 / 3 / 2, 5 / 4 / 6, 2 / 5 / 2
uniform-alpha_1-2-n250.txt, 1, 1, 250, 1257.58, 1843, 1593, 7, 237,84 / 1 / 2, 12 / 2 / 3, 198 / 3 / 2, 65 / 4 / 3, 62 / 5 / 2, 15 / 7 / 5, 17 / 8 / 2, 206 / 9 / 2, 91 / 10 / 3, 229 / 11 / 2, 35 / 12 / 3, 195 / 14 / 3, 130 / 15 / 2, 106 / 16 / 3, 138 / 17 / 2, 90 / 18 / 2, 159 / 19 / 2, 175 / 20 / 2, 30 / 21 / 2, 1 / 22 / 2, 113 / 23 / 3, 222 / 24 / 2, 122 / 25 / 2, 200 / 26 / 2, 129 / 27 / 3, 19 / 28 / 2, 73 / 29 / 5, 245 / 30 / 2, 199 / 31 / 2, 212 / 32 / 2, 146 / 33 / 2, 104 / 34 / 2, 160 / 35 / 3, 111 / 36 / 2, 53 / 37 / 3, 80 / 38 / 2, 214 / 39 / 3, 238 / 40 / 2, 179 / 41 / 3, 27 / 42 / 2, 103 / 43 / 2, 68 / 44 / 2, 168 / 45 / 2, 77 / 46 / 2, 105 / 47 / 2, 74 / 48 / 3, 70 / 49 / 2, 71 / 50 / 3, 162 / 51 / 2, 5 / 52 / 2, 208 / 53 / 4, 33 / 54 / 2, 219 / 55 / 2, 202 / 56 / 2, 102 / 57 / 3, 32 / 58 / 2, 167 / 59 / 3, 34 / 60 / 2, 54 / 63 / 2, 190 / 64 / 3, 137 / 65 / 2, 66 / 66 / 2, 161 / 67 / 3, 31 / 68 / 2, 37 / 69 / 2, 148 / 70 / 2, 120 / 71 / 4, 94 / 72 / 2, 201 / 73 / 2, 100 / 74 / 4, 143 / 75 / 2, 232 / 76 / 2, 249 / 77 / 2, 40 / 78 / 2, 226 / 79 / 2, 152 / 80 / 3, 246 / 81 / 2, 188 / 82 / 2, 123 / 83 / 3, 115 / 84 / 2, 136 / 85 / 3, 151 / 86 / 2, 241 / 87 / 3, 128 / 88 / 2, 78 / 89 / 2, 223 / 90 / 2, 134 / 91 / 7, 213 / 92 / 2, 139 / 93 / 3, 163 / 95 / 2, 164 / 96 / 4, 85 / 97 / 2, 59 / 98 / 2, 204 / 99 / 4, 101 / 100 / 2, 196 / 101 / 2, 235 / 102 / 4, 2 / 103 / 2, 154 / 104 / 2, 107 / 105 / 4, 108 / 106 / 2, 144 / 107 / 2, 28 / 108 / 2, 87 / 109 / 3, 6 / 110 / 2, 194 / 111 / 3, 16 / 112 / 2, 23 / 113 / 3, 239 / 114 / 2, 18 / 115 / 3, 127 / 116 / 2, 205 / 117 / 3, 14 / 120 / 3, 20 / 121 / 2, 56 / 122 / 2, 7 / 123 / 3, 50 / 124 / 2, 114 / 125 / 2, 109 / 126 / 3, 79 / 127 / 2, 236 / 128 / 4, 149 / 129 / 2, 215 / 130 / 2, 191 / 131 / 3, 29 / 132 / 2, 185 / 133 / 4, 69 / 134 / 2, 217 / 135 / 2, 237 / 136 / 4, 133 / 138 / 3, 41 / 139 / 2, 210 / 141 / 5, 192 / 142 / 2, 182 / 143 / 2, 44 / 144 / 2, 4 / 145 / 3, 141 / 146 / 2, 52 / 147 / 2, 112 / 148 / 2, 142 / 149 / 4, 234 / 150 / 2, 38 / 151 / 2, 220 / 152 / 3, 230 / 153 / 2, 36 / 154 / 3, 183 / 155 / 2, 117 / 156 / 3, 248 / 157 / 2, 189 / 158 / 3, 169 / 159 / 2, 228 / 160 / 2, 51 / 161 / 2, 187 / 162 / 2, 11 / 163 / 2, 86 / 164 / 4, 197 / 165 / 2, 224 / 166 / 2, 49 / 167 / 2, 170 / 168 / 2, 42 / 169 / 2, 209 / 170 / 2, 227 / 171 / 2, 135 / 172 / 2, 211 / 173 / 2, 57 / 174 / 3, 92 / 175 / 2, 9 / 176 / 2, 88 / 177 / 3, 81 / 178 / 2, 173 / 179 / 3, 178 / 180 / 2, 61 / 181 / 2, 43 / 182 / 5, 96 / 183 / 2, 153 / 184 / 3, 166 / 185 / 2, 216 / 186 / 4, 180 / 187 / 2, 97 / 188 / 2, 231 / 189 / 2, 218 / 190 / 2, 126 / 191 / 3, 172 / 192 / 2, 119 / 193 / 2, 72 / 194 / 2, 221 / 195 / 3, 171 / 196 / 2, 25 / 197 / 2, 121 / 198 / 2, 145 / 199 / 2, 99 / 200 / 3, 131 / 201 / 2, 174 / 202 / 3, 181 / 203 / 2, 10 / 204 / 2, 82 / 205 / 3, 186 / 206 / 2, 176 / 207 / 2, 55 / 208 / 2, 165 / 209 / 5, 21 / 210 / 2, 64 / 211 / 2, 89 / 212 / 2, 46 / 213 / 4, 207 / 214 / 2, 13 / 215 / 2, 184 / 216 / 4, 39 / 217 / 2, 75 / 218 / 2, 155 / 219 / 2, 157 / 220 / 4, 24 / 221 / 2, 95 / 222 / 2, 3 / 223 / 2, 83 / 224 / 3, 203 / 225 / 2, 177 / 226 / 3, 124 / 227 / 2, 244 / 230 / 3, 240 / 232 / 3, 60 / 233 / 2, 147 / 234 / 2, 26 / 235 / 3, 125 / 236 / 2, 76 / 237 / 2, 118 / 238 / 3, 150 / 239 / 2, 8 / 240 / 3, 233 / 241 / 2, 63 / 242 / 2, 140 / 243 / 3, 48 / 244 / 2, 22 / 245 / 3, 193 / 246 / 2, 243 / 247 / 2, 98 / 248 / 2, 225 / 249 / 3
uniform-alpha_1-2-n375.txt, 1, 1, 375, 1622.59, 2586, 2211, 6, 352,154 / 1 / 4, 322 / 2 / 2, 100 / 3 / 2, 168 / 4 / 3, 134 / 5 / 2, 73 / 6 / 2, 81 / 7 / 3, 291 / 8 / 2, 150 / 9 / 2, 230 / 10 / 2, 203 / 11 / 4, 118 / 14 / 2, 339 / 15 / 3, 290 / 16 / 2, 128 / 17 / 4, 68 / 18 / 2, 104 / 19 / 2, 201 / 20 / 3, 321 / 21 / 2, 207 / 22 / 3, 192 / 23 / 2, 257 / 24 / 6, 12 / 27 / 2, 65 / 28 / 4, 329 / 29 / 2, 70 / 32 / 5, 157 / 33 / 2, 5 / 34 / 2, 243 / 35 / 2, 13 / 36 / 3, 311 / 37 / 2, 256 / 38 / 3, 220 / 39 / 2, 338 / 40 / 2, 260 / 41 / 2, 165 / 42 / 3, 334 / 43 / 2, 149 / 44 / 3, 139 / 45 / 2, 231 / 46 / 2, 50 / 47 / 3, 369 / 48 / 2, 286 / 49 / 3, 34 / 50 / 2, 42 / 51 / 2, 173 / 52 / 2, 360 / 53 / 3, 137 / 54 / 2, 185 / 55 / 2, 200 / 56 / 2, 194 / 57 / 2, 77 / 58 / 3, 217 / 59 / 2, 302 / 60 / 3, 94 / 61 / 2, 245 / 62 / 2, 258 / 63 / 2, 174 / 64 / 3, 43 / 65 / 2, 282 / 66 / 2, 364 / 67 / 2, 37 / 68 / 2, 367 / 69 / 2, 145 / 70 / 2, 97 / 71 / 4, 280 / 72 / 2, 83 / 73 / 3, 349 / 74 / 2, 74 / 75 / 3, 225 / 76 / 2, 120 / 77 / 2, 294 / 78 / 4, 153 / 79 / 2, 281 / 80 / 3, 342 / 81 / 2, 227 / 82 / 2, 127 / 83 / 2, 29 / 84 / 2, 163 / 85 / 2, 333 / 86 / 2, 323 / 87 / 2, 71 / 88 / 3, 189 / 89 / 2, 110 / 90 / 2, 352 / 91 / 2, 347 / 92 / 3, 315 / 93 / 2, 170 / 94 / 2, 131 / 95 / 2, 343 / 98 / 2, 180 / 99 / 2, 69 / 100 / 2, 80 / 101 / 3, 310 / 102 / 2, 132 / 103 / 3, 19 / 104 / 2, 196 / 105 / 2, 160 / 106 / 4, 130 / 107 / 2, 11 / 108 / 2, 26 / 109 / 2, 116 / 110 / 4, 3 / 111 / 2, 162 / 112 / 2, 39 / 113 / 2, 274 / 114 / 2, 285 / 115 / 3, 38 / 116 / 2, 341 / 117 / 2, 144 / 118 / 3, 14 / 119 / 2, 88 / 120 / 2, 307 / 121 / 4, 98 / 122 / 2, 176 / 123 / 2, 9 / 124 / 4, 328 / 125 / 2, 293 / 126 / 3, 277 / 127 / 2, 79 / 128 / 5, 295 / 129 / 2, 188 / 130 / 3, 254 / 131 / 2, 269 / 132 / 2, 304 / 133 / 3, 361 / 134 / 2, 226 / 135 / 2, 363 / 136 / 3, 216 / 138 / 3, 222 / 139 / 2, 138 / 140 / 2, 143 / 141 / 2, 87 / 142 / 2, 21 / 143 / 3, 241 / 144 / 2, 75 / 145 / 2, 292 / 146 / 2, 195 / 147 / 2, 4 / 148 / 2, 62 / 149 / 4, 266 / 150 / 2, 270 / 151 / 2, 267 / 152 / 4, 325 / 153 / 2, 239 / 154 / 2, 161 / 155 / 2, 326 / 156 / 4, 372 / 157 / 2, 133 / 158 / 2, 255 / 159 / 2, 28 / 160 / 3, 263 / 161 / 2, 41 / 162 / 3, 191 / 163 / 2, 237 / 164 / 3, 91 / 165 / 2, 312 / 166 / 2, 55 / 167 / 3, 265 / 168 / 2, 106 / 169 / 4, 313 / 170 / 2, 47 / 171 / 2, 1 / 172 / 2, 332 / 173 / 2, 181 / 174 / 2, 93 / 175 / 2, 279 / 176 / 2, 309 / 177 / 2, 108 / 178 / 2, 15 / 179 / 4, 25 / 180 / 2, 186 / 181 / 2, 177 / 182 / 2, 299 / 183 / 2, 22 / 184 / 2, 370 / 185 / 2, 115 / 186 / 3, 31 / 187 / 2, 193 / 188 / 2, 119 / 189 / 4, 261 / 190 / 2, 52 / 191 / 3, 78 / 192 / 2, 204 / 193 / 3, 205 / 196 / 2, 214 / 197 / 2, 30 / 198 / 3, 32 / 199 / 2, 155 / 200 / 3, 49 / 203 / 3, 147 / 204 / 2, 56 / 205 / 2, 211 / 206 / 4, 354 / 207 / 2, 129 / 208 / 2, 233 / 209 / 4, 319 / 210 / 2, 125 / 211 / 2, 59 / 212 / 2, 219 / 213 / 2, 148 / 214 / 2, 82 / 215 / 2, 146 / 216 / 2, 345 / 217 / 2, 184 / 218 / 3, 288 / 219 / 2, 206 / 220 / 3, 317 / 221 / 2, 51 / 222 / 2, 289 / 223 / 2, 61 / 224 / 2, 6 / 225 / 2, 303 / 226 / 2, 179 / 227 / 2, 85 / 228 / 3, 244 / 229 / 2, 67 / 230 / 2, 57 / 231 / 2, 8 / 232 / 3, 374 / 233 / 2, 16 / 234 / 2, 242 / 235 / 2, 324 / 236 / 2, 40 / 237 / 2, 171 / 238 / 3, 359 / 239 / 2, 126 / 240 / 3, 20 / 241 / 2, 166 / 242 / 2, 344 / 243 / 3, 351 / 244 / 2, 314 / 245 / 3, 187 / 247 / 2, 221 / 248 / 2, 46 / 249 / 3, 278 / 250 / 2, 247 / 251 / 2, 251 / 252 / 4, 284 / 253 / 2, 86 / 255 / 2, 17 / 256 / 5, 102 / 257 / 2, 223 / 258 / 2, 45 / 259 / 3, 164 / 260 / 2, 53 / 261 / 3, 172 / 262 / 2, 48 / 263 / 3, 199 / 264 / 2, 340 / 265 / 2, 99 / 266 / 3, 72 / 267 / 2, 259 / 268 / 2, 103 / 269 / 2, 210 / 270 / 3, 44 / 271 / 2, 316 / 272 / 2, 296 / 273 / 3, 212 / 274 / 2, 336 / 276 / 3, 84 / 277 / 2, 300 / 278 / 3, 353 / 279 / 2, 158 / 280 / 2, 209 / 281 / 2, 109 / 282 / 2, 283 / 283 / 3, 151 / 286 / 4, 112 / 287 / 2, 249 / 288 / 3, 92 / 289 / 2, 60 / 290 / 3, 178 / 291 / 2, 356 / 292 / 2, 318 / 293 / 2, 236 / 294 / 4, 224 / 295 / 2, 229 / 296 / 2, 350 / 297 / 2, 368 / 298 / 4, 298 / 299 / 2, 141 / 300 / 2, 250 / 301 / 2, 169 / 302 / 3, 246 / 303 / 2, 24 / 304 / 3, 90 / 305 / 2, 66 / 306 / 2, 371 / 307 / 4, 348 / 308 / 2, 276 / 309 / 2, 95 / 310 / 2, 301 / 311 / 2, 346 / 312 / 2, 175 / 313 / 4, 111 / 314 / 2, 2 / 318 / 4, 262 / 319 / 2, 190 / 320 / 3, 297 / 321 / 2, 114 / 322 / 2, 198 / 323 / 2, 337 / 324 / 2, 228 / 325 / 3, 327 / 326 / 2, 365 / 327 / 3, 358 / 328 / 2, 159 / 329 / 2, 234 / 330 / 5, 64 / 331 / 2, 253 / 332 / 3, 123 / 333 / 2, 58 / 334 / 3, 306 / 335 / 2, 89 / 336 / 2, 308 / 338 / 2, 182 / 339 / 3, 54 / 340 / 2, 264 / 341 / 2, 275 / 342 / 2, 142 / 343 / 2, 63 / 344 / 3, 156 / 345 / 2, 252 / 346 / 2, 330 / 347 / 2, 305 / 348 / 2, 27 / 349 / 3, 121 / 350 / 2, 271 / 351 / 3, 101 / 352 / 2, 331 / 353 / 2, 335 / 354 / 2, 373 / 355 / 2, 183 / 356 / 2, 235 / 357 / 2, 36 / 358 / 4, 366 / 359 / 2, 23 / 360 / 3, 273 / 361 / 2, 232 / 362 / 3, 238 / 363 / 2, 107 / 364 / 2, 124 / 365 / 2, 240 / 366 / 2, 140 / 367 / 2, 18 / 368 / 2, 76 / 369 / 3, 268 / 370 / 2, 152 / 371 / 2, 218 / 372 / 2, 135 / 373 / 2, 202 / 374 / 2
uniform-alpha_1-2-n5.txt, 1, 1, 5, 261.478, 18, 13, 5, 4,2 / 1 / 2, 4 / 2 / 5, 3 / 3 / 2, 1 / 4 / 2
uniform-alpha_1-20-n375.txt, 1, 1, 375, 1541.51, 2684, 2309, 6, 341,213 / 1 / 2, 219 / 2 / 2, 7 / 3 / 4, 41 / 4 / 2, 23 / 5 / 2, 134 / 6 / 2, 160 / 7 / 3, 151 / 8 / 2, 336 / 9 / 5, 299 / 10 / 2, 341 / 11 / 2, 97 / 14 / 2, 274 / 15 / 4, 174 / 16 / 2, 44 / 17 / 2, 254 / 18 / 2, 279 / 19 / 2, 92 / 20 / 5, 232 / 21 / 2, 251 / 22 / 3, 152 / 24 / 4, 255 / 25 / 2, 374 / 29 / 2, 172 / 30 / 3, 117 / 31 / 2, 221 / 32 / 2, 252 / 33 / 3, 355 / 34 / 2, 95 / 35 / 3, 124 / 36 / 2, 127 / 37 / 2, 269 / 38 / 2, 24 / 39 / 3, 360 / 40 / 2, 94 / 41 / 2, 15 / 42 / 2, 309 / 43 / 3, 2 / 44 / 2, 42 / 45 / 2, 222 / 46 / 3, 167 / 47 / 2, 75 / 48 / 3, 308 / 49 / 2, 349 / 50 / 2, 150 / 51 / 3, 55 / 52 / 2, 93 / 55 / 3, 211 / 56 / 2, 312 / 57 / 2, 153 / 58 / 4, 362 / 59 / 2, 215 / 60 / 2, 304 / 61 / 2, 68 / 63 / 3, 74 / 64 / 2, 226 / 65 / 3, 136 / 66 / 2, 200 / 67 / 2, 16 / 68 / 3, 340 / 69 / 2, 239 / 70 / 4, 107 / 71 / 2, 162 / 72 / 2, 352 / 73 / 2, 369 / 74 / 2, 191 / 75 / 3, 116 / 76 / 2, 141 / 77 / 2, 188 / 78 / 3, 137 / 79 / 2, 161 / 80 / 2, 275 / 81 / 3, 276 / 82 / 2, 86 / 83 / 3, 89 / 84 / 2, 329 / 85 / 2, 295 / 86 / 2, 282 / 87 / 3, 234 / 88 / 2, 38 / 89 / 2, 216 / 90 / 2, 246 / 91 / 2, 156 / 92 / 2, 143 / 93 / 2, 180 / 94 / 2, 357 / 95 / 3, 154 / 96 / 2, 325 / 97 / 2, 321 / 98 / 2, 176 / 99 / 2, 6 / 100 / 3, 303 / 101 / 2, 177 / 102 / 2, 322 / 103 / 2, 123 / 104 / 4, 34 / 105 / 2, 331 / 106 / 2, 293 / 107 / 2, 54 / 108 / 2, 51 / 109 / 2, 347 / 110 / 2, 301 / 111 / 4, 84 / 112 / 2, 189 / 113 / 2, 50 / 114 / 3, 247 / 115 / 2, 32 / 116 / 2, 101 / 117 / 2, 83 / 118 / 2, 205 / 119 / 2, 113 / 120 / 2, 297 / 121 / 4, 11 / 122 / 2, 193 / 125 / 2, 149 / 126 / 2, 131 / 127 / 5, 316 / 128 / 2, 339 / 130 / 2, 126 / 131 / 3, 261 / 132 / 2, 175 / 133 / 2, 187 / 134 / 3, 333 / 135 / 2, 12 / 136 / 3, 300 / 137 / 2, 164 / 138 / 3, 146 / 139 / 2, 80 / 140 / 3, 45 / 141 / 2, 170 / 142 / 2, 179 / 143 / 4, 354 / 144 / 2, 72 / 145 / 2, 157 / 146 / 2, 281 / 147 / 2, 220 / 148 / 2, 65 / 149 / 2, 181 / 150 / 2, 324 / 151 / 2, 73 / 152 / 2, 367 / 153 / 2, 262 / 154 / 2, 338 / 155 / 3, 197 / 157 / 3, 365 / 158 / 2, 318 / 159 / 2, 238 / 160 / 3, 25 / 161 / 2, 319 / 162 / 2, 118 / 163 / 2, 241 / 164 / 4, 158 / 165 / 2, 289 / 166 / 2, 372 / 167 / 3, 108 / 168 / 2, 358 / 169 / 2, 203 / 170 / 2, 278 / 171 / 2, 364 / 172 / 2, 271 / 173 / 2, 90 / 174 / 2, 185 / 175 / 2, 106 / 176 / 3, 284 / 177 / 2, 323 / 178 / 2, 292 / 179 / 2, 171 / 180 / 2, 30 / 181 / 2, 235 / 182 / 2, 130 / 183 / 3, 133 / 184 / 2, 258 / 185 / 2, 248 / 186 / 2, 43 / 187 / 2, 67 / 188 / 3, 236 / 189 / 2, 61 / 190 / 2, 82 / 191 / 2, 345 / 192 / 2, 26 / 193 / 4, 196 / 194 / 2, 288 / 195 / 2, 306 / 196 / 2, 199 / 197 / 2, 178 / 198 / 2, 66 / 199 / 2, 286 / 200 / 3, 173 / 201 / 2, 224 / 202 / 2, 144 / 203 / 2, 253 / 204 / 2, 210 / 205 / 6, 260 / 206 / 2, 373 / 207 / 2, 59 / 208 / 3, 57 / 209 / 2, 145 / 210 / 3, 265 / 212 / 5, 69 / 214 / 3, 259 / 215 / 2, 53 / 216 / 3, 348 / 217 / 2, 326 / 218 / 3, 184 / 219 / 2, 155 / 220 / 2, 78 / 221 / 3, 366 / 222 / 2, 52 / 223 / 3, 142 / 224 / 2, 346 / 225 / 2, 76 / 226 / 2, 287 / 227 / 3, 298 / 230 / 4, 36 / 231 / 2, 217 / 232 / 3, 344 / 233 / 2, 353 / 234 / 2, 361 / 235 / 2, 110 / 236 / 2, 334 / 237 / 2, 111 / 238 / 3, 256 / 239 / 2, 105 / 241 / 2, 21 / 242 / 2, 243 / 243 / 2, 363 / 244 / 2, 40 / 245 / 2, 29 / 246 / 2, 204 / 247 / 6, 98 / 248 / 2, 231 / 249 / 2, 294 / 250 / 2, 302 / 251 / 2, 314 / 252 / 5, 63 / 255 / 4, 195 / 256 / 2, 49 / 259 / 4, 138 / 260 / 2, 125 / 261 / 3, 208 / 262 / 2, 13 / 263 / 2, 19 / 264 / 3, 368 / 265 / 2, 37 / 267 / 2, 330 / 268 / 4, 17 / 269 / 2, 129 / 270 / 2, 350 / 271 / 4, 270 / 272 / 2, 296 / 274 / 4, 121 / 275 / 2, 119 / 276 / 2, 343 / 277 / 2, 165 / 278 / 4, 70 / 280 / 3, 99 / 281 / 2, 62 / 282 / 3, 342 / 283 / 2, 371 / 284 / 2, 229 / 285 / 2, 305 / 286 / 2, 122 / 287 / 2, 60 / 288 / 2, 242 / 289 / 3, 328 / 290 / 2, 223 / 291 / 3, 135 / 292 / 2, 351 / 293 / 4, 96 / 294 / 2, 268 / 295 / 2, 58 / 296 / 2, 112 / 297 / 3, 267 / 298 / 2, 202 / 299 / 2, 311 / 300 / 3, 132 / 301 / 2, 257 / 302 / 3, 356 / 303 / 2, 332 / 304 / 3, 28 / 305 / 2, 169 / 306 / 4, 225 / 307 / 2, 337 / 308 / 2, 100 / 309 / 2, 240 / 311 / 3, 244 / 312 / 2, 245 / 314 / 2, 71 / 315 / 2, 315 / 316 / 2, 307 / 317 / 2, 166 / 318 / 2, 102 / 319 / 2, 228 / 320 / 2, 359 / 321 / 2, 31 / 322 / 2, 10 / 323 / 3, 272 / 324 / 2, 47 / 325 / 3, 27 / 326 / 2, 310 / 327 / 2, 77 / 328 / 4, 313 / 329 / 2, 4 / 330 / 2, 139 / 331 / 2, 266 / 332 / 2, 317 / 333 / 2, 128 / 334 / 2, 285 / 335 / 2, 190 / 336 / 2, 9 / 337 / 3, 218 / 338 / 2, 87 / 339 / 2, 264 / 340 / 2, 263 / 341 / 2, 212 / 342 / 3, 201 / 343 / 2, 48 / 344 / 2, 33 / 345 / 3, 186 / 346 / 2, 88 / 347 / 4, 194 / 348 / 2, 277 / 349 / 2, 192 / 350 / 2, 114 / 351 / 2, 320 / 354 / 2, 115 / 355 / 3, 168 / 356 / 2, 183 / 357 / 3, 39 / 358 / 2, 209 / 359 / 5, 56 / 360 / 2, 147 / 362 / 3, 148 / 363 / 2, 120 / 366 / 3, 18 / 368 / 2, 22 / 369 / 2, 104 / 370 / 2, 91 / 371 / 2, 283 / 372 / 2, 327 / 373 / 2, 280 / 374 / 2
uniform-alpha_1-20-n6.txt, 1, 1, 6, 265.03, 26, 20, 6, 5,3 / 1 / 2, 2 / 2 / 2, 1 / 3 / 6, 4 / 4 / 2, 5 / 5 / 3
uniform-alpha_1-21-n500.txt, 1, 1, 500, 1867.97, 3501, 3001, 6, 453,479 / 1 / 4, 438 / 2 / 2, 407 / 3 / 2, 323 / 4 / 4, 307 / 5 / 2, 292 / 6 / 2, 10 / 7 / 2, 402 / 8 / 3, 404 / 9 / 2, 193 / 10 / 3, 239 / 11 / 2, 238 / 12 / 3, 365 / 13 / 2, 408 / 14 / 2, 90 / 15 / 5, 19 / 16 / 2, 167 / 17 / 3, 74 / 19 / 3, 265 / 22 / 2, 22 / 23 / 3, 311 / 24 / 2, 134 / 25 / 2, 303 / 26 / 2, 132 / 28 / 3, 431 / 29 / 2, 473 / 30 / 2, 209 / 31 / 3, 79 / 32 / 2, 217 / 33 / 3, 297 / 34 / 2, 287 / 35 / 3, 261 / 36 / 2, 240 / 37 / 2, 426 / 38 / 2, 281 / 39 / 2, 53 / 40 / 2, 364 / 41 / 2, 233 / 42 / 2, 54 / 45 / 3, 476 / 46 / 2, 135 / 47 / 3, 185 / 49 / 4, 84 / 52 / 4, 102 / 53 / 2, 448 / 54 / 2, 221 / 55 / 3, 329 / 56 / 2, 26 / 57 / 3, 458 / 58 / 2, 158 / 59 / 3, 78 / 60 / 2, 326 / 61 / 2, 236 / 62 / 2, 214 / 63 / 2, 420 / 64 / 2, 63 / 65 / 3, 370 / 66 / 2, 270 / 67 / 2, 128 / 68 / 4, 254 / 71 / 3, 40 / 72 / 2, 151 / 73 / 2, 271 / 74 / 2, 393 / 75 / 4, 147 / 76 / 2, 96 / 79 / 2, 112 / 80 / 3, 28 / 81 / 2, 388 / 82 / 2, 130 / 83 / 4, 483 / 86 / 4, 27 / 87 / 2, 442 / 89 / 3, 30 / 92 / 3, 460 / 95 / 2, 114 / 96 / 4, 345 / 97 / 2, 288 / 98 / 2, 92 / 99 / 4, 445 / 100 / 2, 282 / 101 / 2, 171 / 102 / 2, 294 / 103 / 2, 244 / 104 / 3, 465 / 105 / 2, 369 / 106 / 2, 21 / 107 / 2, 462 / 108 / 3, 427 / 109 / 2, 43 / 110 / 2, 215 / 111 / 2, 116 / 112 / 2, 148 / 113 / 2, 94 / 114 / 2, 87 / 115 / 2, 381 / 116 / 3, 477 / 118 / 3, 433 / 119 / 2, 35 / 120 / 2, 6 / 121 / 2, 99 / 122 / 2, 231 / 123 / 3, 224 / 124 / 2, 395 / 125 / 2, 267 / 126 / 2, 379 / 127 / 2, 327 / 128 / 2, 52 / 129 / 2, 82 / 130 / 3, 24 / 131 / 2, 150 / 132 / 2, 212 / 133 / 2, 165 / 134 / 2, 312 / 135 / 3, 298 / 136 / 2, 283 / 137 / 2, 285 / 138 / 4, 42 / 139 / 2, 154 / 140 / 2, 49 / 141 / 2, 361 / 142 / 3, 3 / 143 / 2, 263 / 144 / 3, 66 / 146 / 2, 332 / 147 / 2, 457 / 148 / 2, 382 / 149 / 2, 58 / 150 / 2, 309 / 151 / 2, 464 / 152 / 3, 315 / 153 / 2, 45 / 154 / 2, 471 / 155 / 2, 390 / 156 / 2, 106 / 157 / 2, 363 / 158 / 2, 91 / 159 / 2, 275 / 160 / 5, 12 / 161 / 2, 428 / 162 / 2, 57 / 163 / 2, 272 / 165 / 2, 333 / 166 / 2, 437 / 167 / 2, 343 / 168 / 3, 440 / 169 / 2, 80 / 170 / 3, 188 / 171 / 2, 278 / 172 / 2, 302 / 173 / 2, 136 / 174 / 3, 444 / 175 / 2, 454 / 176 / 2, 61 / 177 / 2, 192 / 178 / 3, 352 / 179 / 2, 172 / 180 / 2, 173 / 181 / 3, 266 / 182 / 2, 159 / 183 / 3, 72 / 184 / 2, 138 / 185 / 2, 304 / 186 / 2, 222 / 187 / 3, 300 / 188 / 2, 378 / 189 / 2, 73 / 190 / 3, 59 / 191 / 2, 46 / 192 / 2, 248 / 193 / 4, 196 / 194 / 2, 207 / 195 / 2, 205 / 196 / 4, 314 / 197 / 2, 478 / 198 / 2, 126 / 199 / 2, 481 / 200 / 3, 146 / 201 / 2, 425 / 202 / 2, 56 / 203 / 2, 34 / 204 / 2, 308 / 205 / 2, 356 / 206 / 3, 51 / 209 / 2, 140 / 210 / 4, 101 / 211 / 2, 439 / 212 / 2, 220 / 213 / 4, 398 / 214 / 2, 293 / 215 / 2, 450 / 216 / 2, 44 / 217 / 2, 436 / 218 / 2, 4 / 219 / 2, 497 / 220 / 2, 86 / 221 / 2, 424 / 222 / 3, 344 / 226 / 2, 211 / 227 / 6, 418 / 228 / 2, 169 / 229 / 2, 119 / 230 / 3, 178 / 231 / 2, 230 / 232 / 4, 346 / 233 / 2, 225 / 234 / 2, 206 / 235 / 4, 334 / 236 / 2, 392 / 237 / 2, 391 / 238 / 2, 377 / 239 / 3, 482 / 240 / 2, 400 / 241 / 2, 108 / 242 / 2, 374 / 243 / 4, 176 / 245 / 2, 301 / 246 / 3, 373 / 247 / 2, 155 / 248 / 3, 235 / 249 / 2, 321 / 250 / 2, 494 / 251 / 2, 245 / 252 / 3, 414 / 253 / 2, 443 / 254 / 2, 451 / 255 / 4, 423 / 256 / 2, 144 / 257 / 3, 401 / 258 / 2, 25 / 259 / 3, 32 / 260 / 2, 472 / 261 / 3, 65 / 262 / 2, 406 / 263 / 2, 468 / 264 / 2, 198 / 265 / 2, 234 / 266 / 3, 499 / 267 / 2, 385 / 268 / 2, 104 / 269 / 3, 170 / 270 / 2, 335 / 271 / 3, 492 / 272 / 2, 88 / 273 / 3, 279 / 274 / 2, 89 / 275 / 3, 141 / 276 / 2, 330 / 277 / 3, 210 / 278 / 2, 380 / 279 / 3, 11 / 280 / 2, 256 / 281 / 3, 77 / 282 / 2, 354 / 283 / 2, 93 / 284 / 2, 186 / 285 / 2, 127 / 286 / 2, 180 / 287 / 2, 320 / 288 / 3, 410 / 289 / 2, 164 / 290 / 3, 175 / 291 / 2, 342 / 292 / 3, 299 / 293 / 2, 375 / 294 / 2, 467 / 295 / 2, 422 / 296 / 3, 262 / 297 / 2, 163 / 298 / 3, 318 / 299 / 2, 362 / 300 / 2, 372 / 301 / 3, 306 / 302 / 2, 118 / 303 / 3, 218 / 304 / 2, 495 / 305 / 3, 430 / 306 / 2, 190 / 307 / 3, 412 / 308 / 2, 197 / 309 / 2, 264 / 310 / 5, 177 / 311 / 2, 18 / 312 / 2, 201 / 313 / 3, 216 / 314 / 2, 168 / 315 / 2, 142 / 316 / 3, 16 / 317 / 2, 286 / 318 / 2, 62 / 319 / 3, 325 / 320 / 2, 496 / 321 / 2, 9 / 322 / 2, 243 / 323 / 2, 359 / 324 / 4, 493 / 325 / 2, 36 / 326 / 3, 349 / 327 / 2, 259 / 328 / 2, 105 / 329 / 3, 260 / 331 / 2, 296 / 332 / 2, 152 / 333 / 4, 396 / 334 / 2, 181 / 335 / 3, 110 / 336 / 2, 204 / 337 / 3, 109 / 338 / 2, 23 / 339 / 2, 305 / 340 / 2, 100 / 341 / 2, 95 / 342 / 3, 371 / 343 / 2, 415 / 344 / 3, 143 / 345 / 2, 1 / 346 / 3, 7 / 347 / 2, 20 / 348 / 2, 489 / 349 / 3, 449 / 350 / 2, 195 / 351 / 3, 461 / 352 / 2, 123 / 353 / 3, 131 / 354 / 2, 397 / 355 / 3, 223 / 356 / 2, 161 / 357 / 3, 295 / 358 / 2, 360 / 359 / 2, 417 / 360 / 3, 480 / 361 / 2, 47 / 362 / 2, 368 / 363 / 2, 81 / 364 / 3, 8 / 365 / 2, 459 / 367 / 2, 276 / 368 / 4, 488 / 369 / 2, 111 / 370 / 3, 252 / 371 / 2, 64 / 372 / 3, 48 / 373 / 2, 486 / 374 / 3, 474 / 375 / 2, 487 / 376 / 2, 249 / 377 / 2, 37 / 378 / 3, 411 / 379 / 2, 434 / 380 / 3, 133 / 381 / 2, 328 / 382 / 3, 98 / 383 / 2, 384 / 384 / 2, 113 / 385 / 3, 350 / 386 / 2, 291 / 387 / 2, 39 / 388 / 2, 55 / 389 / 4, 15 / 391 / 2, 268 / 392 / 2, 351 / 393 / 5, 145 / 394 / 2, 208 / 395 / 2, 455 / 396 / 3, 376 / 397 / 2, 38 / 398 / 2, 366 / 399 / 2, 179 / 400 / 3, 41 / 401 / 2, 29 / 402 / 3, 274 / 403 / 2, 68 / 404 / 3, 160 / 405 / 2, 232 / 407 / 4, 246 / 408 / 2, 69 / 409 / 2, 258 / 410 / 3, 277 / 411 / 2, 14 / 412 / 2, 319 / 413 / 2, 103 / 414 / 2, 184 / 415 / 5, 340 / 416 / 2, 199 / 419 / 3, 429 / 420 / 2, 475 / 421 / 2, 456 / 422 / 3, 115 / 423 / 2, 166 / 424 / 2, 129 / 425 / 3, 421 / 426 / 2, 337 / 427 / 2, 484 / 428 / 2, 316 / 429 / 5, 257 / 430 / 2, 453 / 431 / 2, 229 / 433 / 4, 290 / 434 / 2, 227 / 435 / 3, 200 / 436 / 2, 491 / 437 / 2, 331 / 438 / 2, 71 / 439 / 5, 446 / 440 / 2, 60 / 441 / 2, 405 / 442 / 2, 183 / 443 / 2, 386 / 444 / 2, 247 / 447 / 3, 13 / 448 / 2, 97 / 449 / 2, 156 / 450 / 2, 194 / 451 / 2, 269 / 452 / 2, 237 / 453 / 4, 121 / 456 / 2, 213 / 457 / 2, 341 / 458 / 2, 162 / 459 / 2, 153 / 460 / 2, 419 / 461 / 2, 182 / 462 / 3, 83 / 463 / 2, 124 / 464 / 2, 31 / 465 / 2, 339 / 466 / 4, 70 / 468 / 2, 399 / 469 / 4, 67 / 470 / 2, 191 / 471 / 2, 120 / 472 / 2, 241 / 473 / 2, 284 / 474 / 4, 255 / 475 / 2, 409 / 476 / 2, 273 / 477 / 3, 367 / 478 / 2, 125 / 479 / 3, 466 / 480 / 2, 469 / 481 / 3, 324 / 482 / 2, 416 / 483 / 3, 357 / 485 / 4, 317 / 488 / 4, 122 / 489 / 2, 348 / 490 / 2, 353 / 491 / 4, 226 / 492 / 2, 322 / 495 / 3, 75 / 496 / 2, 187 / 497 / 2, 470 / 498 / 2, 310 / 499 / 6
uniform-alpha_1-21-n7.txt, 1, 1, 7, 270.69, 33, 26, 4, 6,5 / 1 / 2, 3 / 2 / 2, 6 / 3 / 4, 1 / 4 / 2, 4 / 5 / 2, 2 / 6 / 4
uniform-alpha_1-22-n7.txt, 1, 1, 7, 314.335, 31, 24, 3, 6,5 / 1 / 3, 2 / 2 / 2, 6 / 3 / 3, 3 / 4 / 2, 4 / 5 / 2, 1 / 6 / 3
uniform-alpha_1-23-n7.txt, 1, 1, 7, 277.201, 30, 23, 4, 6,2 / 1 / 2, 6 / 2 / 2, 5 / 3 / 2, 3 / 4 / 2, 4 / 5 / 2, 1 / 6 / 4
uniform-alpha_1-24-n7.txt, 1, 1, 7, 297.721, 32, 25, 3, 6,2 / 1 / 2, 4 / 2 / 3, 6 / 3 / 2, 1 / 4 / 3, 5 / 5 / 2, 3 / 6 / 3
uniform-alpha_1-25-n7.txt, 1, 1, 7, 291.346, 32, 25, 4, 6,5 / 1 / 2, 4 / 2 / 3, 2 / 3 / 2, 6 / 4 / 4, 3 / 5 / 2, 1 / 6 / 2
uniform-alpha_1-26-n7.txt, 1, 1, 7, 242.938, 28, 21, 3, 6,6 / 1 / 2, 1 / 2 / 3, 5 / 3 / 2, 2 / 4 / 2, 3 / 5 / 2, 4 / 6 / 3
uniform-alpha_1-27-n7.txt, 1, 1, 7, 287.874, 35, 28, 7, 6,6 / 1 / 2, 5 / 2 / 2, 3 / 3 / 7, 1 / 4 / 2, 2 / 5 / 2, 4 / 6 / 4
uniform-alpha_1-28-n7.txt, 1, 1, 7, 333.357, 29, 22, 3, 6,5 / 1 / 3, 2 / 2 / 2, 6 / 3 / 2, 1 / 4 / 3, 4 / 5 / 2, 3 / 6 / 2
uniform-alpha_1-29-n7.txt, 1, 1, 7, 335.334, 30, 23, 4, 6,4 / 1 / 2, 5 / 2 / 3, 3 / 3 / 2, 2 / 4 / 2, 6 / 5 / 4, 1 / 6 / 2
uniform-alpha_1-3-n250.txt, 1, 1, 250, 1322.8, 1764, 1514, 6, 236,26 / 1 / 3, 194 / 2 / 2, 40 / 3 / 3, 211 / 6 / 3, 162 / 7 / 2, 58 / 8 / 2, 49 / 9 / 3, 171 / 10 / 2, 242 / 11 / 2, 65 / 12 / 2, 133 / 13 / 3, 204 / 14 / 2, 53 / 15 / 4, 185 / 16 / 2, 137 / 17 / 2, 184 / 18 / 2, 93 / 19 / 2, 59 / 20 / 2, 186 / 21 / 3, 223 / 22 / 2, 216 / 23 / 3, 38 / 24 / 2, 150 / 25 / 2, 119 / 26 / 2, 43 / 27 / 3, 231 / 28 / 2, 189 / 30 / 3, 161 / 31 / 2, 175 / 32 / 3, 19 / 33 / 2, 83 / 34 / 2, 247 / 35 / 3, 27 / 38 / 3, 76 / 41 / 5, 77 / 42 / 2, 86 / 43 / 2, 105 / 44 / 2, 191 / 45 / 3, 1 / 46 / 2, 226 / 47 / 2, 91 / 48 / 3, 20 / 49 / 2, 18 / 50 / 3, 217 / 51 / 2, 56 / 52 / 2, 160 / 53 / 3, 196 / 54 / 2, 114 / 55 / 2, 51 / 56 / 2, 116 / 57 / 5, 246 / 58 / 2, 81 / 59 / 3, 30 / 60 / 2, 225 / 61 / 2, 84 / 62 / 5, 208 / 64 / 3, 172 / 65 / 2, 95 / 66 / 2, 156 / 67 / 2, 123 / 68 / 3, 212 / 69 / 2, 71 / 70 / 2, 44 / 71 / 2, 36 / 72 / 2, 33 / 73 / 2, 198 / 74 / 2, 11 / 75 / 2, 21 / 76 / 2, 158 / 77 / 2, 103 / 78 / 2, 241 / 79 / 3, 111 / 80 / 2, 197 / 81 / 2, 139 / 82 / 3, 174 / 83 / 2, 89 / 84 / 3, 117 / 85 / 2, 130 / 86 / 2, 46 / 87 / 2, 203 / 88 / 2, 207 / 89 / 2, 143 / 90 / 2, 236 / 91 / 2, 154 / 92 / 3, 124 / 93 / 2, 28 / 94 / 3, 54 / 95 / 2, 136 / 96 / 3, 147 / 97 / 2, 14 / 98 / 2, 32 / 99 / 2, 2 / 100 / 2, 180 / 101 / 3, 178 / 102 / 2, 213 / 103 / 2, 16 / 104 / 2, 60 / 105 / 2, 126 / 106 / 3, 167 / 107 / 2, 149 / 108 / 2, 165 / 109 / 2, 200 / 110 / 2, 48 / 111 / 2, 179 / 112 / 2, 249 / 113 / 2, 68 / 114 / 5, 34 / 115 / 2, 146 / 116 / 2, 157 / 117 / 3, 141 / 118 / 2, 176 / 119 / 3, 233 / 120 / 2, 98 / 121 / 2, 235 / 122 / 2, 88 / 123 / 2, 94 / 124 / 2, 10 / 125 / 2, 15 / 126 / 2, 97 / 127 / 2, 113 / 128 / 3, 164 / 129 / 2, 67 / 130 / 3, 221 / 131 / 2, 239 / 132 / 4, 17 / 133 / 2, 152 / 134 / 2, 142 / 135 / 4, 138 / 136 / 2, 131 / 137 / 2, 168 / 138 / 2, 188 / 139 / 3, 82 / 140 / 2, 106 / 141 / 3, 31 / 142 / 2, 230 / 143 / 3, 169 / 144 / 2, 62 / 145 / 2, 125 / 146 / 3, 47 / 147 / 2, 218 / 148 / 2, 155 / 149 / 2, 80 / 150 / 3, 173 / 151 / 2, 220 / 152 / 2, 148 / 153 / 2, 23 / 154 / 3, 121 / 155 / 2, 243 / 156 / 2, 118 / 157 / 3, 41 / 158 / 2, 170 / 159 / 3, 50 / 160 / 2, 228 / 161 / 2, 190 / 162 / 2, 108 / 163 / 4, 96 / 164 / 2, 101 / 165 / 2, 222 / 166 / 3, 240 / 167 / 2, 120 / 168 / 3, 13 / 169 / 2, 122 / 170 / 2, 134 / 171 / 2, 70 / 172 / 2, 237 / 173 / 2, 199 / 174 / 2, 166 / 175 / 6, 25 / 176 / 2, 153 / 177 / 3, 214 / 178 / 2, 99 / 179 / 2, 35 / 180 / 3, 205 / 181 / 2, 195 / 182 / 2, 61 / 183 / 3, 224 / 184 / 2, 219 / 185 / 3, 187 / 186 / 2, 42 / 187 / 2, 3 / 188 / 2, 4 / 189 / 3, 182 / 190 / 2, 52 / 191 / 2, 215 / 192 / 2, 100 / 196 / 2, 244 / 197 / 4, 5 / 198 / 2, 127 / 199 / 2, 109 / 200 / 4, 63 / 201 / 2, 135 / 202 / 3, 37 / 203 / 2, 206 / 204 / 2, 132 / 205 / 2, 210 / 206 / 2, 92 / 207 / 2, 151 / 208 / 2, 181 / 209 / 4, 128 / 210 / 2, 183 / 211 / 3, 115 / 212 / 2, 29 / 213 / 2, 79 / 214 / 2, 193 / 215 / 2, 73 / 216 / 2, 64 / 217 / 3, 75 / 218 / 2, 102 / 219 / 2, 22 / 220 / 2, 163 / 221 / 2, 6 / 222 / 5, 129 / 223 / 2, 201 / 226 / 4, 232 / 227 / 2, 45 / 228 / 2, 66 / 229 / 2, 72 / 230 / 3, 57 / 231 / 2, 9 / 232 / 2, 245 / 233 / 4, 55 / 234 / 2, 107 / 235 / 2, 238 / 236 / 4, 104 / 237 / 2, 12 / 238 / 2, 202 / 239 / 4, 177 / 240 / 2, 112 / 241 / 2, 248 / 242 / 3, 110 / 243 / 2, 145 / 244 / 3, 140 / 245 / 2, 24 / 246 / 2, 90 / 247 / 2, 7 / 248 / 2, 74 / 249 / 2
uniform-alpha_1-3-n375.txt, 1, 1, 375, 1519.02, 2648, 2273, 6, 357,129 / 1 / 2, 334 / 2 / 2, 276 / 3 / 3, 101 / 4 / 2, 175 / 5 / 2, 285 / 6 / 3, 241 / 7 / 2, 7 / 8 / 3, 259 / 9 / 2, 5 / 10 / 3, 256 / 11 / 2, 239 / 12 / 2, 330 / 13 / 2, 282 / 14 / 2, 43 / 15 / 2, 162 / 16 / 2, 18 / 17 / 3, 372 / 18 / 2, 296 / 19 / 2, 373 / 20 / 2, 221 / 21 / 5, 11 / 22 / 2, 310 / 23 / 3, 23 / 25 / 2, 51 / 26 / 2, 332 / 27 / 3, 365 / 28 / 2, 311 / 29 / 3, 295 / 30 / 2, 67 / 31 / 2, 176 / 32 / 3, 359 / 33 / 2, 305 / 34 / 2, 161 / 35 / 3, 15 / 36 / 2, 77 / 37 / 2, 292 / 38 / 4, 272 / 39 / 2, 185 / 40 / 2, 258 / 41 / 2, 75 / 42 / 3, 27 / 43 / 2, 134 / 44 / 2, 307 / 45 / 2, 301 / 46 / 2, 260 / 47 / 2, 245 / 48 / 2, 340 / 49 / 3, 226 / 50 / 2, 74 / 51 / 3, 157 / 52 / 2, 265 / 53 / 2, 163 / 54 / 3, 100 / 55 / 2, 274 / 56 / 2, 35 / 57 / 2, 327 / 58 / 3, 173 / 59 / 2, 165 / 60 / 2, 84 / 61 / 2, 267 / 62 / 2, 142 / 63 / 2, 240 / 64 / 2, 36 / 65 / 2, 95 / 66 / 2, 322 / 67 / 2, 263 / 68 / 3, 52 / 69 / 2, 164 / 70 / 2, 108 / 71 / 2, 156 / 72 / 2, 106 / 73 / 2, 82 / 74 / 3, 86 / 75 / 2, 329 / 76 / 3, 139 / 77 / 2, 236 / 78 / 2, 252 / 79 / 2, 255 / 80 / 2, 337 / 81 / 3, 33 / 82 / 2, 211 / 83 / 3, 212 / 84 / 2, 312 / 85 / 2, 138 / 86 / 5, 289 / 87 / 2, 181 / 89 / 2, 109 / 90 / 2, 331 / 91 / 2, 49 / 92 / 3, 154 / 93 / 2, 3 / 94 / 2, 283 / 95 / 3, 37 / 96 / 2, 294 / 97 / 3, 293 / 98 / 2, 167 / 99 / 2, 346 / 100 / 2, 251 / 101 / 2, 219 / 102 / 3, 97 / 103 / 2, 132 / 104 / 3, 279 / 105 / 2, 196 / 106 / 3, 374 / 109 / 2, 145 / 110 / 3, 291 / 111 / 2, 298 / 112 / 2, 367 / 113 / 2, 244 / 114 / 3, 195 / 115 / 2, 46 / 116 / 3, 19 / 117 / 2, 320 / 118 / 2, 371 / 119 / 3, 118 / 120 / 2, 237 / 122 / 2, 66 / 123 / 2, 335 / 124 / 2, 178 / 125 / 2, 32 / 126 / 3, 351 / 127 / 2, 98 / 128 / 3, 94 / 129 / 2, 54 / 130 / 2, 99 / 131 / 2, 234 / 132 / 2, 121 / 133 / 3, 137 / 134 / 2, 288 / 135 / 2, 171 / 137 / 4, 344 / 139 / 3, 60 / 140 / 2, 321 / 141 / 5, 204 / 142 / 2, 205 / 143 / 2, 42 / 144 / 4, 10 / 145 / 2, 17 / 146 / 2, 28 / 147 / 3, 325 / 148 / 2, 150 / 149 / 2, 338 / 150 / 2, 315 / 151 / 2, 249 / 152 / 2, 151 / 153 / 2, 24 / 154 / 2, 308 / 155 / 3, 286 / 156 / 2, 306 / 157 / 2, 197 / 158 / 4, 135 / 159 / 2, 140 / 160 / 2, 14 / 161 / 3, 155 / 162 / 2, 248 / 163 / 3, 120 / 164 / 2, 83 / 165 / 2, 199 / 166 / 2, 102 / 167 / 2, 63 / 168 / 2, 345 / 169 / 2, 247 / 170 / 2, 202 / 171 / 2, 64 / 173 / 2, 88 / 174 / 4, 127 / 175 / 2, 266 / 176 / 2, 47 / 177 / 3, 198 / 178 / 2, 81 / 179 / 3, 284 / 180 / 2, 125 / 181 / 2, 290 / 182 / 2, 323 / 183 / 3, 218 / 184 / 2, 336 / 185 / 2, 56 / 186 / 2, 20 / 187 / 4, 69 / 188 / 2, 210 / 191 / 2, 187 / 192 / 2, 166 / 193 / 3, 200 / 194 / 2, 159 / 195 / 2, 29 / 196 / 2, 103 / 197 / 2, 352 / 198 / 5, 309 / 199 / 2, 57 / 200 / 3, 16 / 201 / 2, 229 / 202 / 5, 39 / 203 / 2, 136 / 204 / 2, 123 / 205 / 3, 230 / 206 / 2, 146 / 207 / 2, 78 / 208 / 2, 254 / 209 / 2, 113 / 210 / 2, 116 / 213 / 3, 85 / 214 / 2, 347 / 215 / 3, 141 / 216 / 2, 70 / 217 / 2, 59 / 218 / 4, 13 / 219 / 2, 168 / 222 / 4, 191 / 223 / 2, 354 / 224 / 2, 79 / 225 / 2, 188 / 226 / 4, 216 / 227 / 2, 280 / 228 / 2, 277 / 229 / 2, 115 / 230 / 2, 302 / 231 / 2, 333 / 232 / 4, 190 / 233 / 2, 21 / 234 / 3, 80 / 235 / 2, 231 / 236 / 3, 53 / 237 / 2, 183 / 238 / 2, 45 / 239 / 2, 238 / 240 / 3, 223 / 241 / 2, 180 / 242 / 2, 257 / 243 / 2, 40 / 244 / 3, 91 / 245 / 2, 355 / 246 / 2, 217 / 247 / 2, 133 / 248 / 2, 30 / 249 / 6, 348 / 250 / 2, 9 / 251 / 2, 153 / 252 / 2, 370 / 253 / 2, 363 / 254 / 2, 192 / 255 / 2, 124 / 256 / 2, 68 / 257 / 2, 278 / 258 / 3, 366 / 259 / 2, 319 / 260 / 2, 172 / 261 / 2, 130 / 262 / 2, 215 / 263 / 2, 48 / 264 / 2, 170 / 265 / 2, 110 / 266 / 3, 300 / 267 / 2, 114 / 268 / 2, 149 / 269 / 2, 304 / 270 / 2, 8 / 271 / 3, 342 / 272 / 2, 25 / 273 / 3, 220 / 274 / 2, 314 / 275 / 2, 26 / 276 / 3, 227 / 278 / 2, 1 / 279 / 3, 213 / 280 / 2, 126 / 281 / 3, 6 / 282 / 2, 73 / 283 / 3, 107 / 284 / 2, 76 / 285 / 2, 349 / 286 / 3, 368 / 287 / 2, 228 / 288 / 2, 160 / 289 / 2, 61 / 290 / 2, 328 / 291 / 2, 206 / 292 / 2, 264 / 293 / 3, 270 / 294 / 2, 326 / 295 / 3, 313 / 296 / 2, 343 / 297 / 3, 117 / 298 / 2, 4 / 299 / 2, 184 / 300 / 2, 369 / 301 / 2, 262 / 302 / 2, 246 / 303 / 2, 253 / 304 / 2, 353 / 305 / 5, 96 / 306 / 2, 186 / 307 / 2, 317 / 308 / 2, 12 / 309 / 4, 90 / 310 / 2, 112 / 311 / 2, 243 / 312 / 2, 316 / 313 / 2, 58 / 314 / 5, 122 / 315 / 2, 2 / 316 / 3, 158 / 317 / 2, 143 / 318 / 3, 356 / 319 / 2, 44 / 320 / 2, 261 / 321 / 2, 225 / 322 / 2, 31 / 323 / 3, 92 / 324 / 2, 147 / 325 / 3, 214 / 326 / 2, 361 / 327 / 2, 131 / 328 / 2, 268 / 329 / 2, 271 / 330 / 3, 189 / 331 / 2, 209 / 332 / 2, 194 / 333 / 4, 287 / 334 / 2, 41 / 335 / 2, 222 / 336 / 2, 318 / 337 / 3, 358 / 338 / 2, 169 / 339 / 3, 55 / 340 / 2, 364 / 341 / 2, 341 / 342 / 2, 275 / 343 / 5, 233 / 344 / 2, 34 / 347 / 2, 193 / 348 / 2, 148 / 349 / 3, 350 / 350 / 2, 281 / 351 / 3, 250 / 352 / 2, 208 / 353 / 3, 235 / 354 / 2, 242 / 355 / 2, 339 / 356 / 2, 87 / 357 / 2, 128 / 358 / 2, 22 / 359 / 4, 224 / 360 / 2, 201 / 361 / 2, 269 / 362 / 4, 174 / 363 / 2, 119 / 364 / 3, 232 / 365 / 2, 207 / 366 / 4, 72 / 367 / 2, 89 / 368 / 2, 182 / 369 / 2, 65 / 370 / 2, 105 / 371 / 3, 71 / 372 / 2, 104 / 373 / 2, 177 / 374 / 2
uniform-alpha_1-3-n5.txt, 1, 1, 5, 272.513, 18, 13, 5, 4,1 / 1 / 2, 4 / 2 / 2, 3 / 3 / 5, 2 / 4 / 2
uniform-alpha_1-30-n7.txt, 1, 1, 7, 238.887, 29, 22, 3, 6,5 / 1 / 2, 4 / 2 / 3, 2 / 3 / 2, 6 / 4 / 3, 3 / 5 / 2, 1 / 6 / 2
uniform-alpha_1-31-n8.txt, 1, 1, 8, 306.56, 38, 30, 3, 7,5 / 1 / 2, 7 / 2 / 3, 4 / 3 / 2, 3 / 4 / 3, 1 / 5 / 2, 6 / 6 / 2, 2 / 7 / 2
uniform-alpha_1-32-n8.txt, 1, 1, 8, 259.905, 43, 35, 8, 7,7 / 1 / 3, 6 / 2 / 2, 1 / 3 / 8, 5 / 4 / 2, 2 / 5 / 2, 4 / 6 / 2, 3 / 7 / 2
uniform-alpha_1-33-n8.txt, 1, 1, 8, 246.208, 45, 37, 6, 7,6 / 1 / 2, 7 / 2 / 6, 2 / 3 / 2, 5 / 4 / 2, 3 / 5 / 2, 4 / 6 / 2, 1 / 7 / 6
uniform-alpha_1-34-n8.txt, 1, 1, 8, 331.25, 41, 33, 3, 7,4 / 1 / 2, 7 / 2 / 2, 5 / 3 / 3, 2 / 4 / 2, 6 / 5 / 3, 1 / 6 / 2, 3 / 7 / 3
uniform-alpha_1-35-n8.txt, 1, 1, 8, 254.714, 36, 28, 3, 7,2 / 1 / 2, 3 / 2 / 2, 6 / 3 / 2, 7 / 4 / 3, 5 / 5 / 2, 1 / 6 / 2, 4 / 7 / 2
uniform-alpha_1-36-n8.txt, 1, 1, 8, 347.116, 38, 30, 6, 7,4 / 1 / 2, 3 / 2 / 2, 7 / 3 / 2, 1 / 4 / 2, 2 / 5 / 2, 5 / 6 / 2, 6 / 7 / 6
uniform-alpha_1-37-n8.txt, 1, 1, 8, 309.948, 37, 29, 4, 7,1 / 1 / 2, 2 / 2 / 3, 4 / 3 / 2, 3 / 4 / 2, 6 / 5 / 4, 5 / 6 / 2, 7 / 7 / 2
uniform-alpha_1-38-n8.txt, 1, 1, 8, 333.952, 37, 29, 3, 7,6 / 1 / 2, 7 / 2 / 3, 5 / 3 / 2, 1 / 4 / 3, 3 / 5 / 2, 2 / 6 / 3, 4 / 7 / 2
uniform-alpha_1-39-n8.txt, 1, 1, 8, 297.747, 39, 31, 4, 7,6 / 1 / 4, 2 / 2 / 2, 3 / 3 / 2, 4 / 4 / 3, 7 / 5 / 2, 5 / 6 / 3, 1 / 7 / 2
uniform-alpha_1-4-n250.txt, 1, 1, 250, 1285.14, 1762, 1512, 5, 240,174 / 1 / 3, 102 / 2 / 2, 62 / 3 / 3, 101 / 4 / 2, 68 / 5 / 2, 179 / 6 / 2, 86 / 7 / 2, 69 / 8 / 3, 204 / 9 / 2, 125 / 10 / 4, 229 / 11 / 2, 116 / 12 / 2, 171 / 13 / 2, 221 / 14 / 3, 198 / 15 / 2, 98 / 16 / 2, 172 / 17 / 2, 238 / 18 / 2, 40 / 19 / 2, 159 / 20 / 2, 16 / 21 / 2, 241 / 22 / 4, 192 / 23 / 2, 43 / 24 / 2, 15 / 25 / 4, 142 / 26 / 2, 200 / 27 / 2, 193 / 28 / 2, 245 / 29 / 2, 117 / 30 / 2, 99 / 31 / 2, 60 / 32 / 4, 196 / 33 / 2, 80 / 34 / 2, 152 / 35 / 3, 11 / 36 / 2, 137 / 37 / 2, 132 / 38 / 2, 115 / 39 / 3, 234 / 41 / 2, 19 / 42 / 4, 63 / 43 / 2, 175 / 44 / 2, 194 / 45 / 2, 29 / 46 / 4, 21 / 47 / 2, 148 / 48 / 2, 246 / 49 / 3, 85 / 50 / 2, 61 / 51 / 4, 124 / 52 / 2, 244 / 54 / 3, 44 / 55 / 2, 195 / 56 / 2, 78 / 57 / 2, 122 / 58 / 3, 45 / 59 / 2, 167 / 60 / 3, 107 / 61 / 2, 37 / 62 / 3, 177 / 63 / 2, 235 / 64 / 5, 220 / 65 / 2, 88 / 66 / 2, 212 / 67 / 2, 127 / 68 / 2, 169 / 69 / 2, 114 / 70 / 2, 1 / 71 / 2, 181 / 72 / 2, 243 / 73 / 2, 93 / 74 / 2, 183 / 75 / 2, 147 / 76 / 3, 7 / 77 / 2, 39 / 78 / 2, 118 / 79 / 2, 231 / 80 / 2, 168 / 81 / 3, 176 / 82 / 2, 57 / 83 / 4, 134 / 84 / 2, 108 / 85 / 2, 51 / 86 / 2, 96 / 87 / 4, 91 / 88 / 2, 95 / 89 / 2, 84 / 90 / 5, 232 / 92 / 2, 205 / 93 / 2, 247 / 94 / 2, 145 / 95 / 5, 190 / 96 / 2, 31 / 97 / 2, 90 / 98 / 2, 230 / 99 / 3, 52 / 100 / 2, 166 / 101 / 3, 55 / 102 / 2, 119 / 103 / 3, 240 / 104 / 2, 109 / 105 / 2, 87 / 106 / 2, 201 / 107 / 3, 202 / 108 / 2, 25 / 110 / 2, 9 / 111 / 3, 73 / 112 / 2, 104 / 113 / 2, 140 / 114 / 2, 41 / 115 / 2, 155 / 116 / 2, 222 / 117 / 2, 28 / 118 / 2, 38 / 119 / 2, 219 / 120 / 3, 206 / 121 / 2, 186 / 122 / 4, 191 / 123 / 2, 144 / 124 / 2, 89 / 125 / 2, 211 / 126 / 2, 128 / 127 / 5, 224 / 128 / 2, 23 / 130 / 4, 210 / 131 / 2, 123 / 132 / 2, 3 / 133 / 2, 70 / 134 / 3, 157 / 136 / 4, 58 / 137 / 2, 22 / 138 / 2, 217 / 139 / 3, 5 / 140 / 2, 146 / 141 / 2, 111 / 142 / 4, 203 / 143 / 2, 65 / 144 / 2, 121 / 145 / 2, 189 / 146 / 2, 150 / 147 / 2, 6 / 148 / 2, 27 / 149 / 3, 130 / 150 / 2, 214 / 151 / 3, 42 / 152 / 2, 180 / 153 / 2, 50 / 154 / 2, 228 / 155 / 3, 77 / 156 / 2, 18 / 157 / 2, 187 / 158 / 3, 112 / 159 / 2, 185 / 160 / 5, 213 / 161 / 2, 54 / 162 / 3, 100 / 163 / 2, 26 / 164 / 2, 163 / 165 / 3, 156 / 166 / 2, 215 / 169 / 3, 53 / 170 / 2, 17 / 171 / 3, 207 / 172 / 2, 47 / 173 / 2, 66 / 174 / 3, 151 / 175 / 2, 46 / 176 / 2, 106 / 177 / 2, 34 / 178 / 2, 178 / 179 / 2, 113 / 180 / 3, 110 / 182 / 2, 75 / 183 / 2, 143 / 184 / 3, 227 / 185 / 2, 120 / 186 / 3, 133 / 187 / 2, 36 / 188 / 2, 13 / 189 / 2, 226 / 190 / 2, 76 / 191 / 3, 188 / 192 / 2, 165 / 193 / 3, 35 / 194 / 2, 10 / 195 / 2, 82 / 196 / 4, 138 / 197 / 2, 67 / 198 / 2, 56 / 199 / 3, 249 / 200 / 2, 233 / 201 / 2, 153 / 202 / 3, 103 / 203 / 2, 79 / 204 / 3, 83 / 205 / 2, 136 / 206 / 3, 105 / 207 / 2, 161 / 208 / 2, 49 / 209 / 2, 92 / 210 / 2, 33 / 211 / 4, 170 / 212 / 2, 162 / 213 / 2, 81 / 214 / 4, 139 / 215 / 2, 237 / 216 / 2, 24 / 217 / 3, 72 / 218 / 2, 182 / 219 / 2, 173 / 220 / 2, 64 / 221 / 4, 158 / 222 / 2, 12 / 223 / 2, 74 / 224 / 2, 131 / 225 / 2, 32 / 226 / 2, 160 / 227 / 2, 97 / 228 / 2, 154 / 229 / 2, 223 / 230 / 2, 242 / 231 / 3, 71 / 232 / 2, 30 / 233 / 2, 208 / 234 / 2, 209 / 235 / 2, 135 / 236 / 3, 164 / 237 / 2, 248 / 238 / 2, 216 / 239 / 2, 94 / 240 / 2, 129 / 241 / 3, 48 / 242 / 2, 20 / 243 / 3, 8 / 244 / 2, 218 / 245 / 2, 2 / 246 / 2, 236 / 247 / 2, 4 / 248 / 2, 126 / 249 / 2
uniform-alpha_1-4-n375.txt, 1, 1, 375, 1542.85, 2645, 2270, 6, 350,272 / 1 / 2, 210 / 2 / 2, 82 / 3 / 2, 308 / 4 / 2, 357 / 5 / 2, 129 / 6 / 2, 251 / 7 / 3, 258 / 8 / 2, 297 / 9 / 2, 18 / 10 / 2, 264 / 11 / 2, 8 / 12 / 2, 361 / 13 / 4, 228 / 14 / 2, 24 / 15 / 2, 184 / 16 / 2, 358 / 17 / 2, 153 / 18 / 2, 126 / 19 / 2, 151 / 20 / 2, 304 / 21 / 2, 23 / 22 / 2, 87 / 23 / 3, 302 / 24 / 2, 94 / 25 / 2, 123 / 26 / 2, 52 / 27 / 2, 276 / 28 / 2, 104 / 29 / 2, 223 / 30 / 2, 322 / 31 / 2, 325 / 32 / 3, 146 / 33 / 2, 337 / 34 / 3, 196 / 35 / 2, 68 / 36 / 2, 230 / 37 / 2, 118 / 38 / 3, 171 / 39 / 2, 88 / 40 / 3, 35 / 41 / 2, 14 / 42 / 2, 209 / 43 / 3, 176 / 44 / 2, 135 / 45 / 3, 374 / 46 / 2, 44 / 47 / 3, 268 / 48 / 2, 331 / 49 / 3, 175 / 50 / 2, 366 / 51 / 3, 363 / 52 / 2, 356 / 53 / 2, 238 / 54 / 2, 10 / 55 / 3, 295 / 56 / 2, 33 / 57 / 3, 354 / 58 / 2, 201 / 59 / 3, 67 / 60 / 2, 112 / 61 / 2, 105 / 62 / 2, 309 / 63 / 4, 69 / 64 / 2, 130 / 65 / 2, 48 / 66 / 3, 173 / 67 / 2, 170 / 68 / 3, 4 / 69 / 2, 206 / 70 / 2, 312 / 71 / 2, 257 / 72 / 5, 203 / 73 / 2, 370 / 74 / 3, 371 / 75 / 2, 329 / 76 / 3, 327 / 77 / 2, 93 / 78 / 3, 95 / 81 / 3, 160 / 82 / 2, 161 / 83 / 2, 218 / 84 / 3, 320 / 85 / 2, 243 / 86 / 2, 89 / 87 / 2, 373 / 88 / 2, 127 / 89 / 2, 144 / 90 / 3, 132 / 91 / 2, 1 / 92 / 2, 367 / 93 / 3, 81 / 94 / 2, 46 / 95 / 2, 138 / 96 / 2, 224 / 97 / 3, 70 / 99 / 4, 250 / 100 / 2, 211 / 101 / 2, 27 / 102 / 4, 53 / 104 / 3, 324 / 105 / 2, 239 / 106 / 2, 43 / 107 / 2, 80 / 108 / 2, 25 / 109 / 3, 28 / 110 / 2, 191 / 111 / 2, 311 / 112 / 3, 273 / 113 / 2, 274 / 114 / 2, 139 / 115 / 2, 350 / 116 / 2, 333 / 117 / 3, 21 / 118 / 2, 275 / 119 / 2, 352 / 120 / 2, 122 / 121 / 2, 141 / 122 / 4, 296 / 125 / 2, 232 / 126 / 3, 45 / 128 / 2, 187 / 129 / 2, 217 / 130 / 3, 339 / 131 / 2, 134 / 132 / 3, 281 / 133 / 2, 125 / 134 / 2, 360 / 135 / 3, 372 / 136 / 2, 234 / 137 / 3, 212 / 138 / 2, 32 / 139 / 3, 290 / 140 / 2, 267 / 141 / 2, 321 / 142 / 3, 314 / 143 / 2, 213 / 144 / 2, 177 / 145 / 2, 137 / 146 / 2, 61 / 147 / 2, 117 / 148 / 3, 343 / 149 / 2, 36 / 150 / 2, 348 / 151 / 2, 294 / 152 / 4, 86 / 154 / 2, 76 / 155 / 3, 66 / 156 / 2, 159 / 157 / 3, 163 / 158 / 2, 37 / 159 / 2, 108 / 160 / 2, 280 / 161 / 2, 72 / 162 / 3, 236 / 164 / 3, 71 / 165 / 2, 20 / 166 / 3, 365 / 167 / 2, 288 / 168 / 2, 40 / 169 / 3, 103 / 170 / 2, 291 / 171 / 3, 190 / 172 / 2, 156 / 173 / 2, 253 / 174 / 4, 310 / 175 / 2, 341 / 176 / 2, 7 / 177 / 2, 121 / 178 / 2, 315 / 179 / 2, 47 / 180 / 4, 42 / 181 / 2, 226 / 182 / 2, 349 / 183 / 2, 248 / 184 / 4, 313 / 185 / 2, 181 / 186 / 3, 194 / 187 / 2, 342 / 188 / 6, 19 / 189 / 2, 96 / 191 / 3, 162 / 194 / 2, 180 / 195 / 4, 158 / 196 / 2, 111 / 197 / 2, 303 / 198 / 4, 39 / 199 / 2, 114 / 200 / 2, 364 / 201 / 2, 261 / 202 / 3, 254 / 203 / 2, 31 / 204 / 4, 182 / 205 / 2, 188 / 206 / 2, 29 / 207 / 4, 345 / 208 / 2, 58 / 209 / 2, 131 / 210 / 3, 154 / 211 / 2, 244 / 212 / 2, 215 / 213 / 3, 199 / 214 / 2, 247 / 215 / 3, 189 / 216 / 2, 172 / 217 / 3, 64 / 218 / 2, 179 / 219 / 2, 13 / 220 / 2, 259 / 221 / 2, 301 / 222 / 2, 292 / 223 / 3, 214 / 224 / 2, 332 / 225 / 2, 169 / 226 / 2, 75 / 227 / 2, 316 / 228 / 3, 63 / 229 / 2, 271 / 230 / 3, 220 / 231 / 2, 55 / 232 / 2, 369 / 233 / 2, 298 / 234 / 2, 245 / 235 / 3, 278 / 236 / 2, 186 / 237 / 2, 336 / 238 / 2, 200 / 239 / 2, 3 / 240 / 3, 306 / 243 / 2, 91 / 244 / 2, 140 / 245 / 3, 328 / 246 / 2, 164 / 247 / 3, 204 / 248 / 2, 208 / 250 / 3, 344 / 251 / 2, 265 / 252 / 3, 167 / 253 / 2, 334 / 254 / 3, 120 / 256 / 2, 225 / 257 / 4, 198 / 258 / 2, 299 / 259 / 2, 113 / 260 / 2, 5 / 261 / 2, 50 / 262 / 2, 240 / 263 / 3, 57 / 264 / 2, 318 / 265 / 3, 65 / 266 / 2, 11 / 267 / 2, 107 / 268 / 2, 83 / 269 / 4, 102 / 270 / 2, 106 / 272 / 2, 183 / 273 / 3, 185 / 274 / 2, 133 / 275 / 3, 34 / 276 / 2, 30 / 277 / 2, 242 / 278 / 2, 286 / 279 / 2, 262 / 280 / 2, 149 / 281 / 3, 305 / 282 / 2, 147 / 283 / 3, 77 / 284 / 2, 279 / 285 / 2, 300 / 286 / 2, 116 / 288 / 2, 143 / 289 / 5, 178 / 290 / 2, 38 / 291 / 2, 233 / 292 / 2, 193 / 293 / 4, 269 / 294 / 2, 282 / 295 / 2, 227 / 296 / 2, 368 / 297 / 3, 16 / 298 / 2, 241 / 299 / 2, 283 / 300 / 3, 362 / 301 / 2, 99 / 302 / 2, 98 / 303 / 4, 6 / 304 / 2, 73 / 305 / 2, 319 / 306 / 2, 346 / 307 / 2, 335 / 308 / 3, 12 / 309 / 2, 90 / 310 / 2, 255 / 311 / 2, 266 / 313 / 4, 148 / 314 / 2, 197 / 315 / 2, 2 / 316 / 3, 22 / 318 / 2, 270 / 319 / 2, 109 / 320 / 2, 56 / 321 / 3, 317 / 322 / 2, 136 / 323 / 2, 145 / 324 / 3, 78 / 325 / 2, 326 / 326 / 2, 168 / 327 / 3, 79 / 328 / 2, 237 / 329 / 3, 165 / 330 / 2, 277 / 331 / 3, 246 / 332 / 2, 252 / 333 / 3, 289 / 335 / 2, 338 / 336 / 4, 174 / 337 / 2, 216 / 340 / 2, 115 / 341 / 2, 359 / 342 / 2, 347 / 343 / 2, 284 / 344 / 2, 128 / 345 / 2, 330 / 346 / 4, 256 / 347 / 2, 353 / 348 / 2, 62 / 349 / 2, 260 / 350 / 2, 235 / 351 / 2, 287 / 352 / 5, 192 / 353 / 2, 166 / 354 / 3, 49 / 355 / 2, 101 / 356 / 3, 110 / 357 / 2, 249 / 358 / 3, 152 / 359 / 2, 323 / 360 / 3, 26 / 361 / 2, 351 / 362 / 3, 100 / 363 / 2, 202 / 364 / 2, 142 / 366 / 3, 150 / 367 / 2, 195 / 368 / 3, 355 / 369 / 2, 97 / 370 / 3, 293 / 371 / 2, 119 / 372 / 3, 84 / 373 / 2, 59 / 374 / 2
uniform-alpha_1-4-n5.txt, 1, 1, 5, 224.592, 20, 15, 5, 4,1 / 1 / 5, 4 / 2 / 2, 3 / 3 / 2, 2 / 4 / 4
uniform-alpha_1-40-n8.txt, 1, 1, 8, 262.318, 39, 31, 4, 7,4 / 1 / 2, 7 / 2 / 4, 6 / 3 / 2, 1 / 4 / 3, 5 / 5 / 2, 3 / 6 / 2, 2 / 7 / 3
uniform-alpha_1-41-n9.txt, 1, 1, 9, 360.836, 42, 33, 4, 8,1 / 1 / 2, 7 / 2 / 3, 2 / 3 / 2, 5 / 4 / 2, 6 / 5 / 2, 8 / 6 / 2, 4 / 7 / 4, 3 / 8 / 2
uniform-alpha_1-42-n9.txt, 1, 1, 9, 285.597, 50, 41, 5, 8,1 / 1 / 2, 8 / 2 / 3, 6 / 3 / 2, 2 / 4 / 3, 3 / 5 / 2, 5 / 6 / 5, 7 / 7 / 2, 4 / 8 / 3
uniform-alpha_1-43-n9.txt, 1, 1, 9, 305.754, 40, 31, 4, 8,7 / 1 / 2, 8 / 2 / 2, 2 / 3 / 2, 5 / 4 / 3, 6 / 5 / 2, 4 / 6 / 2, 3 / 7 / 4, 1 / 8 / 2
uniform-alpha_1-44-n9.txt, 1, 1, 9, 289.015, 51, 42, 5, 8,3 / 1 / 3, 8 / 2 / 2, 2 / 3 / 4, 7 / 4 / 2, 6 / 5 / 2, 1 / 6 / 5, 5 / 7 / 2, 4 / 8 / 3
uniform-alpha_1-45-n9.txt, 1, 1, 9, 322.979, 46, 37, 5, 8,4 / 1 / 5, 3 / 2 / 2, 8 / 3 / 2, 7 / 4 / 2, 1 / 5 / 2, 6 / 6 / 2, 2 / 7 / 4, 5 / 8 / 2
uniform-alpha_1-46-n9.txt, 1, 1, 9, 306.315, 42, 33, 4, 8,6 / 1 / 2, 5 / 2 / 4, 4 / 3 / 2, 2 / 4 / 2, 7 / 5 / 2, 1 / 6 / 2, 3 / 7 / 2, 8 / 8 / 3
uniform-alpha_1-47-n9.txt, 1, 1, 9, 349.988, 44, 35, 3, 8,7 / 1 / 2, 4 / 2 / 2, 8 / 3 / 2, 6 / 4 / 2, 5 / 5 / 3, 1 / 6 / 2, 3 / 7 / 2, 2 / 8 / 3
uniform-alpha_1-48-n9.txt, 1, 1, 9, 358.676, 41, 32, 3, 8,7 / 1 / 2, 5 / 2 / 2, 1 / 3 / 3, 4 / 4 / 2, 6 / 5 / 2, 2 / 6 / 3, 3 / 7 / 2, 8 / 8 / 3
uniform-alpha_1-49-n9.txt, 1, 1, 9, 228.502, 52, 43, 4, 8,3 / 1 / 4, 1 / 2 / 2, 5 / 3 / 2, 7 / 4 / 4, 4 / 5 / 2, 8 / 6 / 3, 6 / 7 / 2, 2 / 8 / 3
uniform-alpha_1-5-n250.txt, 1, 1, 250, 1282.9, 1760, 1510, 6, 234,204 / 1 / 2, 140 / 2 / 6, 13 / 3 / 2, 136 / 4 / 2, 157 / 5 / 2, 210 / 6 / 2, 132 / 7 / 3, 79 / 8 / 2, 155 / 9 / 3, 115 / 10 / 2, 111 / 12 / 3, 42 / 13 / 2, 35 / 14 / 2, 173 / 15 / 2, 116 / 16 / 2, 76 / 17 / 2, 17 / 18 / 2, 54 / 19 / 2, 109 / 20 / 2, 237 / 21 / 2, 131 / 22 / 3, 242 / 23 / 2, 51 / 24 / 2, 45 / 25 / 2, 199 / 26 / 2, 18 / 27 / 5, 9 / 28 / 2, 238 / 29 / 2, 81 / 30 / 2, 156 / 31 / 3, 152 / 32 / 2, 120 / 33 / 2, 84 / 34 / 2, 4 / 35 / 5, 235 / 36 / 2, 127 / 37 / 2, 172 / 38 / 3, 23 / 39 / 2, 118 / 40 / 2, 101 / 41 / 2, 177 / 42 / 4, 214 / 43 / 2, 125 / 44 / 2, 30 / 45 / 3, 234 / 46 / 2, 189 / 47 / 3, 95 / 49 / 2, 146 / 50 / 2, 190 / 51 / 3, 240 / 52 / 2, 130 / 53 / 3, 83 / 54 / 2, 248 / 55 / 2, 32 / 56 / 2, 88 / 57 / 2, 174 / 58 / 2, 65 / 59 / 2, 19 / 61 / 2, 85 / 62 / 2, 108 / 63 / 2, 216 / 64 / 3, 245 / 65 / 2, 104 / 66 / 3, 209 / 67 / 2, 145 / 68 / 3, 94 / 69 / 2, 25 / 70 / 2, 100 / 71 / 2, 5 / 72 / 2, 247 / 73 / 2, 105 / 74 / 2, 12 / 75 / 2, 15 / 76 / 2, 244 / 77 / 2, 196 / 78 / 3, 143 / 79 / 2, 62 / 80 / 2, 102 / 81 / 3, 31 / 82 / 2, 167 / 83 / 2, 60 / 84 / 2, 150 / 85 / 2, 147 / 86 / 4, 202 / 87 / 2, 165 / 88 / 3, 215 / 91 / 3, 217 / 92 / 2, 123 / 93 / 2, 6 / 94 / 2, 113 / 95 / 5, 203 / 96 / 2, 112 / 99 / 2, 137 / 100 / 3, 192 / 101 / 2, 154 / 102 / 2, 58 / 103 / 2, 86 / 104 / 2, 48 / 105 / 4, 72 / 106 / 2, 8 / 107 / 2, 168 / 108 / 3, 14 / 109 / 2, 70 / 110 / 2, 57 / 111 / 2, 151 / 112 / 4, 153 / 113 / 2, 87 / 114 / 2, 183 / 115 / 2, 44 / 116 / 5, 1 / 117 / 2, 239 / 118 / 2, 99 / 119 / 3, 158 / 120 / 2, 92 / 121 / 2, 208 / 122 / 2, 198 / 123 / 3, 188 / 124 / 2, 77 / 125 / 3, 46 / 126 / 2, 159 / 127 / 2, 230 / 128 / 2, 21 / 129 / 3, 24 / 130 / 2, 194 / 131 / 3, 193 / 132 / 2, 142 / 133 / 3, 162 / 134 / 2, 225 / 135 / 2, 98 / 136 / 3, 106 / 137 / 2, 129 / 138 / 2, 243 / 139 / 2, 169 / 140 / 4, 164 / 141 / 2, 53 / 142 / 3, 96 / 143 / 2, 141 / 144 / 3, 218 / 146 / 3, 233 / 149 / 3, 107 / 150 / 2, 114 / 151 / 3, 161 / 152 / 2, 236 / 153 / 3, 63 / 154 / 2, 110 / 155 / 2, 22 / 156 / 2, 180 / 157 / 4, 28 / 158 / 2, 34 / 159 / 2, 67 / 160 / 2, 186 / 161 / 5, 80 / 162 / 2, 122 / 163 / 2, 135 / 164 / 3, 10 / 165 / 2, 249 / 166 / 3, 211 / 167 / 2, 97 / 168 / 2, 61 / 169 / 4, 69 / 170 / 2, 59 / 171 / 3, 82 / 172 / 2, 126 / 173 / 3, 191 / 174 / 2, 52 / 175 / 3, 227 / 176 / 2, 170 / 177 / 2, 43 / 178 / 4, 185 / 179 / 2, 197 / 180 / 2, 27 / 182 / 4, 37 / 183 / 2, 187 / 184 / 2, 90 / 185 / 4, 179 / 186 / 2, 56 / 187 / 3, 33 / 188 / 2, 41 / 189 / 2, 133 / 190 / 4, 38 / 191 / 2, 229 / 192 / 2, 75 / 193 / 2, 68 / 194 / 3, 205 / 195 / 2, 224 / 196 / 3, 47 / 198 / 3, 160 / 199 / 2, 91 / 200 / 3, 73 / 202 / 2, 138 / 203 / 2, 220 / 204 / 2, 221 / 205 / 2, 128 / 206 / 3, 195 / 207 / 2, 134 / 208 / 2, 7 / 209 / 2, 212 / 210 / 2, 163 / 211 / 3, 66 / 212 / 2, 71 / 213 / 2, 144 / 214 / 4, 124 / 216 / 2, 178 / 217 / 4, 231 / 218 / 2, 200 / 220 / 3, 36 / 221 / 2, 201 / 222 / 2, 16 / 223 / 2, 2 / 224 / 2, 103 / 225 / 2, 49 / 226 / 2, 176 / 227 / 3, 39 / 228 / 2, 55 / 229 / 4, 184 / 230 / 2, 117 / 231 / 2, 40 / 232 / 3, 171 / 233 / 2, 223 / 234 / 3, 3 / 235 / 2, 232 / 236 / 2, 74 / 237 / 3, 26 / 238 / 2, 222 / 239 / 2, 64 / 240 / 5, 148 / 241 / 2, 29 / 242 / 2, 166 / 243 / 2, 20 / 244 / 4, 241 / 245 / 2, 78 / 246 / 2, 219 / 247 / 5, 206 / 248 / 2, 181 / 249 / 3
uniform-alpha_1-5-n5.txt, 1, 1, 5, 319.61, 20, 15, 4, 4,1 / 1 / 4, 3 / 2 / 2, 2 / 3 / 2, 4 / 4 / 4
uniform-alpha_1-5-n500.txt, 1, 1, 500, 1788.34, 3522, 3022, 6, 471,133 / 1 / 2, 137 / 2 / 5, 473 / 3 / 2, 302 / 4 / 3, 443 / 5 / 2, 118 / 6 / 3, 90 / 7 / 2, 314 / 8 / 2, 19 / 9 / 2, 47 / 10 / 3, 457 / 11 / 2, 157 / 12 / 5, 379 / 13 / 2, 104 / 14 / 2, 122 / 15 / 2, 409 / 16 / 3, 25 / 17 / 2, 280 / 18 / 3, 22 / 19 / 2, 327 / 20 / 2, 472 / 21 / 4, 62 / 22 / 2, 173 / 23 / 2, 14 / 24 / 2, 71 / 25 / 2, 477 / 26 / 2, 23 / 27 / 3, 390 / 28 / 2, 340 / 29 / 2, 28 / 30 / 3, 388 / 31 / 2, 121 / 32 / 2, 283 / 33 / 3, 497 / 34 / 2, 48 / 35 / 2, 211 / 36 / 2, 195 / 37 / 3, 63 / 38 / 2, 397 / 39 / 4, 70 / 42 / 3, 267 / 43 / 2, 440 / 44 / 2, 278 / 45 / 3, 468 / 46 / 2, 461 / 47 / 2, 38 / 48 / 3, 265 / 49 / 2, 295 / 50 / 3, 148 / 51 / 2, 442 / 52 / 2, 354 / 53 / 2, 214 / 54 / 3, 105 / 55 / 2, 196 / 56 / 2, 330 / 57 / 3, 304 / 58 / 2, 241 / 59 / 3, 151 / 61 / 2, 156 / 62 / 2, 381 / 63 / 2, 179 / 64 / 2, 481 / 65 / 2, 116 / 66 / 2, 67 / 67 / 3, 87 / 68 / 2, 453 / 69 / 3, 123 / 70 / 2, 356 / 71 / 2, 290 / 72 / 2, 169 / 73 / 3, 60 / 74 / 2, 318 / 75 / 2, 218 / 76 / 4, 6 / 77 / 2, 4 / 78 / 2, 373 / 79 / 3, 414 / 80 / 2, 459 / 81 / 3, 1 / 83 / 2, 193 / 84 / 4, 190 / 85 / 2, 370 / 86 / 2, 149 / 87 / 2, 11 / 88 / 2, 92 / 89 / 3, 293 / 90 / 2, 56 / 91 / 3, 57 / 92 / 2, 378 / 93 / 2, 15 / 94 / 3, 225 / 95 / 2, 335 / 96 / 2, 41 / 97 / 2, 89 / 98 / 2, 338 / 99 / 3, 46 / 100 / 2, 476 / 101 / 2, 83 / 102 / 2, 344 / 103 / 2, 58 / 104 / 2, 475 / 105 / 2, 435 / 106 / 2, 251 / 107 / 3, 289 / 108 / 2, 236 / 109 / 2, 215 / 110 / 2, 462 / 111 / 2, 7 / 112 / 2, 300 / 113 / 2, 216 / 114 / 2, 34 / 115 / 2, 346 / 116 / 2, 311 / 117 / 2, 81 / 118 / 2, 153 / 119 / 2, 347 / 120 / 2, 258 / 121 / 3, 5 / 122 / 2, 145 / 123 / 3, 465 / 124 / 2, 180 / 125 / 2, 13 / 126 / 2, 329 / 127 / 2, 382 / 128 / 3, 16 / 129 / 2, 360 / 130 / 2, 119 / 131 / 2, 212 / 132 / 2, 469 / 133 / 2, 452 / 134 / 2, 486 / 135 / 2, 30 / 136 / 2, 456 / 137 / 2, 174 / 138 / 4, 64 / 139 / 2, 324 / 140 / 2, 261 / 141 / 3, 355 / 142 / 2, 362 / 143 / 2, 491 / 144 / 3, 127 / 145 / 2, 401 / 146 / 2, 474 / 147 / 3, 79 / 148 / 2, 424 / 149 / 2, 21 / 150 / 3, 332 / 151 / 2, 272 / 152 / 3, 210 / 154 / 2, 339 / 155 / 3, 168 / 156 / 2, 29 / 157 / 3, 78 / 158 / 2, 55 / 159 / 2, 480 / 160 / 2, 73 / 161 / 3, 143 / 162 / 2, 114 / 163 / 2, 445 / 164 / 3, 499 / 165 / 2, 80 / 166 / 2, 308 / 167 / 2, 84 / 168 / 2, 487 / 169 / 2, 464 / 170 / 3, 403 / 171 / 2, 279 / 172 / 2, 40 / 173 / 3, 305 / 174 / 2, 107 / 175 / 3, 498 / 176 / 2, 99 / 177 / 2, 405 / 178 / 2, 198 / 179 / 3, 245 / 182 / 2, 257 / 183 / 2, 482 / 184 / 4, 249 / 185 / 2, 458 / 186 / 2, 470 / 187 / 5, 207 / 188 / 2, 124 / 189 / 2, 260 / 190 / 2, 423 / 191 / 2, 446 / 192 / 2, 455 / 193 / 2, 231 / 194 / 3, 408 / 197 / 3, 431 / 198 / 2, 111 / 199 / 2, 18 / 200 / 2, 185 / 201 / 5, 387 / 202 / 2, 235 / 203 / 3, 189 / 204 / 2, 221 / 205 / 3, 364 / 206 / 2, 39 / 207 / 3, 447 / 208 / 2, 37 / 209 / 3, 490 / 210 / 2, 419 / 211 / 2, 224 / 212 / 3, 494 / 213 / 2, 130 / 214 / 2, 396 / 215 / 2, 97 / 216 / 2, 232 / 217 / 3, 182 / 218 / 2, 2 / 219 / 2, 320 / 220 / 3, 129 / 221 / 2, 220 / 222 / 2, 155 / 223 / 2, 242 / 224 / 2, 115 / 225 / 2, 325 / 226 / 2, 412 / 227 / 2, 323 / 228 / 2, 359 / 229 / 4, 142 / 230 / 2, 188 / 231 / 2, 492 / 232 / 2, 383 / 233 / 2, 287 / 234 / 3, 256 / 235 / 2, 395 / 236 / 2, 348 / 237 / 2, 386 / 238 / 2, 342 / 239 / 2, 449 / 240 / 2, 404 / 241 / 4, 270 / 242 / 2, 186 / 243 / 2, 203 / 244 / 3, 82 / 245 / 2, 100 / 246 / 2, 299 / 247 / 2, 248 / 248 / 3, 94 / 249 / 2, 428 / 250 / 2, 448 / 251 / 3, 33 / 252 / 2, 262 / 253 / 2, 365 / 254 / 4, 243 / 255 / 2, 296 / 256 / 2, 227 / 257 / 3, 376 / 258 / 2, 399 / 259 / 3, 322 / 260 / 2, 380 / 261 / 2, 136 / 262 / 2, 88 / 263 / 3, 298 / 264 / 2, 183 / 265 / 4, 266 / 266 / 2, 389 / 267 / 2, 26 / 268 / 4, 269 / 269 / 2, 274 / 270 / 2, 184 / 271 / 2, 204 / 272 / 3, 417 / 273 / 2, 451 / 274 / 3, 275 / 275 / 2, 162 / 276 / 3, 209 / 277 / 2, 426 / 278 / 4, 201 / 279 / 2, 337 / 280 / 2, 197 / 281 / 4, 264 / 282 / 2, 106 / 283 / 2, 178 / 284 / 3, 483 / 285 / 2, 50 / 286 / 3, 292 / 288 / 3, 259 / 289 / 2, 147 / 290 / 2, 163 / 291 / 3, 415 / 292 / 2, 77 / 293 / 4, 301 / 294 / 2, 418 / 295 / 2, 495 / 296 / 4, 113 / 297 / 2, 69 / 298 / 2, 358 / 299 / 2, 75 / 300 / 3, 371 / 301 / 2, 17 / 302 / 3, 357 / 303 / 2, 24 / 304 / 4, 205 / 305 / 2, 351 / 306 / 2, 91 / 307 / 2, 176 / 309 / 2, 27 / 310 / 2, 294 / 311 / 3, 268 / 312 / 2, 117 / 313 / 3, 369 / 314 / 2, 226 / 315 / 3, 141 / 316 / 2, 247 / 317 / 3, 334 / 318 / 2, 177 / 319 / 2, 307 / 320 / 4, 108 / 321 / 2, 466 / 322 / 2, 52 / 323 / 2, 160 / 324 / 2, 433 / 325 / 2, 421 / 326 / 2, 229 / 327 / 3, 391 / 328 / 2, 135 / 329 / 3, 154 / 330 / 2, 126 / 331 / 2, 463 / 332 / 3, 406 / 333 / 2, 239 / 334 / 2, 317 / 335 / 2, 263 / 336 / 3, 281 / 337 / 2, 250 / 338 / 2, 407 / 339 / 2, 132 / 340 / 2, 437 / 341 / 2, 35 / 342 / 4, 131 / 343 / 2, 164 / 344 / 2, 72 / 345 / 4, 146 / 346 / 2, 484 / 347 / 2, 110 / 348 / 4, 321 / 350 / 3, 161 / 351 / 2, 171 / 352 / 2, 416 / 353 / 3, 427 / 354 / 2, 12 / 355 / 2, 384 / 356 / 2, 103 / 357 / 2, 166 / 358 / 2, 345 / 359 / 3, 134 / 360 / 2, 76 / 361 / 2, 413 / 362 / 2, 343 / 363 / 2, 42 / 364 / 2, 68 / 365 / 2, 51 / 366 / 4, 377 / 367 / 2, 310 / 368 / 2, 109 / 369 / 2, 352 / 370 / 5, 450 / 371 / 2, 45 / 374 / 4, 213 / 375 / 2, 441 / 376 / 2, 49 / 377 / 3, 66 / 380 / 3, 315 / 381 / 2, 222 / 382 / 2, 478 / 383 / 3, 139 / 384 / 2, 306 / 385 / 2, 460 / 386 / 2, 120 / 387 / 2, 254 / 388 / 2, 31 / 389 / 2, 439 / 390 / 2, 319 / 391 / 2, 255 / 392 / 3, 112 / 393 / 2, 331 / 394 / 2, 489 / 395 / 2, 430 / 396 / 2, 333 / 397 / 2, 366 / 398 / 3, 230 / 399 / 2, 454 / 400 / 3, 496 / 401 / 2, 394 / 402 / 2, 276 / 403 / 3, 170 / 404 / 2, 277 / 405 / 2, 36 / 406 / 2, 353 / 407 / 2, 175 / 408 / 2, 253 / 409 / 3, 140 / 410 / 2, 217 / 411 / 3, 233 / 414 / 3, 400 / 415 / 2, 350 / 416 / 3, 341 / 417 / 2, 3 / 418 / 2, 240 / 419 / 5, 432 / 420 / 2, 312 / 421 / 3, 309 / 423 / 3, 223 / 424 / 2, 194 / 425 / 4, 467 / 426 / 2, 252 / 427 / 2, 297 / 428 / 3, 199 / 429 / 2, 219 / 430 / 3, 436 / 432 / 3, 74 / 433 / 2, 282 / 435 / 3, 422 / 436 / 2, 410 / 437 / 2, 363 / 438 / 2, 246 / 439 / 2, 102 / 440 / 6, 361 / 441 / 2, 493 / 444 / 2, 271 / 445 / 3, 488 / 446 / 2, 167 / 447 / 2, 65 / 448 / 3, 101 / 449 / 2, 208 / 450 / 3, 374 / 451 / 2, 286 / 452 / 2, 385 / 455 / 3, 444 / 456 / 2, 336 / 457 / 2, 95 / 458 / 3, 206 / 459 / 2, 238 / 460 / 2, 93 / 461 / 3, 43 / 462 / 2, 288 / 463 / 3, 393 / 464 / 2, 172 / 465 / 5, 98 / 466 / 2, 200 / 467 / 2, 44 / 468 / 2, 485 / 469 / 5, 326 / 470 / 2, 375 / 471 / 2, 228 / 472 / 2, 411 / 473 / 3, 425 / 474 / 2, 392 / 475 / 3, 402 / 476 / 2, 181 / 477 / 2, 420 / 478 / 3, 429 / 480 / 2, 192 / 481 / 4, 150 / 482 / 2, 438 / 483 / 2, 187 / 484 / 3, 398 / 485 / 2, 471 / 488 / 2, 284 / 489 / 2, 96 / 490 / 2, 59 / 491 / 2, 128 / 492 / 3, 434 / 493 / 2, 165 / 494 / 4, 234 / 495 / 2, 86 / 496 / 3, 20 / 497 / 2, 32 / 498 / 2, 479 / 499 / 4
uniform-alpha_1-50-n9.txt, 1, 1, 9, 324.468, 47, 38, 5, 8,8 / 1 / 2, 5 / 2 / 4, 2 / 3 / 2, 1 / 4 / 2, 7 / 5 / 3, 4 / 6 / 2, 6 / 7 / 5, 3 / 8 / 2
uniform-alpha_1-51-n10.txt, 1, 1, 10, 349.088, 53, 43, 5, 9,6 / 1 / 2, 7 / 2 / 2, 3 / 3 / 4, 4 / 4 / 2, 1 / 5 / 2, 9 / 6 / 3, 5 / 7 / 2, 2 / 8 / 2, 8 / 9 / 5
uniform-alpha_1-52-n10.txt, 1, 1, 10, 303.873, 61, 51, 6, 8,1 / 1 / 3, 6 / 3 / 6, 3 / 4 / 2, 8 / 5 / 2, 9 / 6 / 4, 7 / 7 / 2, 5 / 8 / 2, 2 / 9 / 4
uniform-alpha_1-53-n10.txt, 1, 1, 10, 284.656, 51, 41, 4, 9,6 / 1 / 4, 2 / 2 / 2, 9 / 3 / 2, 1 / 4 / 2, 7 / 5 / 3, 3 / 6 / 2, 5 / 7 / 2, 8 / 8 / 3, 4 / 9 / 2
uniform-alpha_1-54-n10.txt, 1, 1, 10, 311.087, 50, 40, 4, 9,7 / 1 / 2, 4 / 2 / 2, 3 / 3 / 2, 5 / 4 / 3, 8 / 5 / 2, 9 / 6 / 2, 2 / 7 / 2, 1 / 8 / 4, 6 / 9 / 2
uniform-alpha_1-55-n10.txt, 1, 1, 10, 338.061, 57, 47, 4, 9,3 / 1 / 3, 7 / 2 / 2, 5 / 3 / 2, 4 / 4 / 4, 1 / 5 / 2, 6 / 6 / 2, 2 / 7 / 4, 8 / 8 / 2, 9 / 9 / 3
uniform-alpha_1-56-n10.txt, 1, 1, 10, 342.462, 55, 45, 4, 9,6 / 1 / 4, 4 / 2 / 2, 9 / 3 / 3, 1 / 4 / 2, 2 / 5 / 2, 3 / 6 / 4, 8 / 7 / 2, 7 / 8 / 2, 5 / 9 / 3
uniform-alpha_1-57-n10.txt, 1, 1, 10, 261.681, 60, 50, 5, 9,4 / 1 / 2, 5 / 2 / 2, 6 / 3 / 2, 9 / 4 / 2, 8 / 5 / 5, 7 / 6 / 2, 1 / 7 / 2, 3 / 8 / 2, 2 / 9 / 5
uniform-alpha_1-58-n10.txt, 1, 1, 10, 307.08, 45, 35, 3, 9,5 / 1 / 2, 4 / 2 / 2, 3 / 3 / 3, 9 / 4 / 2, 6 / 5 / 3, 1 / 6 / 2, 2 / 7 / 2, 8 / 8 / 3, 7 / 9 / 2
uniform-alpha_1-59-n10.txt, 1, 1, 10, 381.641, 48, 38, 3, 9,4 / 1 / 2, 7 / 2 / 2, 3 / 3 / 2, 8 / 4 / 2, 2 / 5 / 2, 1 / 6 / 2, 6 / 7 / 3, 9 / 8 / 2, 5 / 9 / 3
uniform-alpha_1-6-n250.txt, 1, 1, 250, 1296.87, 1794, 1544, 6, 245,141 / 1 / 2, 162 / 2 / 2, 224 / 3 / 4, 118 / 4 / 2, 21 / 5 / 3, 192 / 6 / 2, 24 / 7 / 3, 71 / 8 / 2, 197 / 9 / 2, 73 / 10 / 4, 33 / 11 / 2, 156 / 12 / 2, 104 / 13 / 2, 61 / 14 / 2, 35 / 15 / 3, 129 / 16 / 2, 222 / 17 / 3, 125 / 18 / 2, 153 / 19 / 2, 216 / 20 / 3, 228 / 21 / 2, 199 / 22 / 3, 207 / 23 / 2, 43 / 24 / 2, 85 / 27 / 2, 94 / 28 / 2, 168 / 29 / 4, 67 / 30 / 2, 203 / 31 / 2, 77 / 32 / 2, 167 / 33 / 2, 114 / 34 / 3, 147 / 35 / 2, 55 / 36 / 2, 205 / 37 / 2, 69 / 38 / 2, 88 / 39 / 2, 140 / 40 / 2, 39 / 41 / 4, 42 / 42 / 2, 185 / 43 / 2, 38 / 44 / 3, 89 / 45 / 2, 238 / 46 / 2, 134 / 47 / 2, 213 / 48 / 4, 36 / 49 / 2, 109 / 50 / 2, 187 / 51 / 3, 155 / 52 / 2, 111 / 53 / 2, 131 / 54 / 2, 169 / 55 / 2, 132 / 56 / 2, 2 / 57 / 4, 12 / 58 / 2, 47 / 59 / 2, 237 / 60 / 4, 231 / 61 / 2, 246 / 62 / 2, 188 / 63 / 3, 215 / 64 / 2, 204 / 65 / 3, 148 / 66 / 2, 16 / 67 / 3, 174 / 68 / 2, 18 / 69 / 3, 146 / 70 / 2, 115 / 71 / 2, 121 / 72 / 2, 158 / 73 / 3, 106 / 74 / 2, 245 / 75 / 2, 34 / 76 / 2, 139 / 77 / 2, 37 / 78 / 2, 195 / 79 / 3, 5 / 80 / 2, 14 / 81 / 3, 186 / 82 / 2, 66 / 83 / 3, 17 / 84 / 2, 135 / 85 / 3, 124 / 86 / 2, 152 / 87 / 3, 110 / 88 / 2, 96 / 89 / 2, 151 / 90 / 3, 138 / 91 / 2, 102 / 92 / 4, 62 / 93 / 2, 160 / 94 / 3, 59 / 95 / 2, 25 / 96 / 2, 122 / 97 / 3, 179 / 98 / 2, 210 / 99 / 3, 157 / 100 / 2, 234 / 101 / 2, 105 / 102 / 3, 209 / 103 / 2, 149 / 104 / 2, 32 / 105 / 2, 28 / 106 / 4, 217 / 107 / 2, 91 / 108 / 2, 163 / 109 / 2, 211 / 110 / 3, 63 / 111 / 2, 50 / 112 / 2, 172 / 113 / 2, 31 / 114 / 2, 27 / 115 / 2, 233 / 116 / 3, 130 / 117 / 2, 49 / 118 / 2, 214 / 119 / 2, 57 / 120 / 2, 51 / 121 / 2, 123 / 122 / 2, 212 / 123 / 5, 6 / 124 / 2, 46 / 125 / 2, 82 / 126 / 2, 183 / 127 / 2, 190 / 128 / 2, 136 / 129 / 4, 93 / 130 / 2, 7 / 131 / 3, 80 / 132 / 2, 76 / 133 / 2, 236 / 134 / 3, 29 / 135 / 2, 108 / 138 / 4, 193 / 139 / 2, 247 / 140 / 2, 119 / 141 / 2, 159 / 142 / 3, 241 / 143 / 2, 229 / 144 / 3, 81 / 145 / 2, 103 / 146 / 2, 150 / 147 / 2, 3 / 148 / 3, 208 / 149 / 2, 86 / 150 / 3, 56 / 151 / 2, 244 / 152 / 2, 74 / 153 / 2, 101 / 154 / 2, 165 / 155 / 2, 90 / 156 / 2, 10 / 157 / 3, 221 / 158 / 2, 144 / 159 / 2, 202 / 160 / 3, 219 / 161 / 2, 8 / 162 / 2, 143 / 163 / 2, 171 / 164 / 5, 180 / 165 / 2, 142 / 166 / 2, 60 / 167 / 4, 145 / 168 / 2, 92 / 169 / 3, 72 / 170 / 2, 239 / 171 / 2, 240 / 172 / 2, 198 / 173 / 2, 196 / 174 / 2, 87 / 175 / 3, 30 / 176 / 2, 1 / 177 / 3, 13 / 178 / 2, 113 / 179 / 2, 23 / 180 / 2, 84 / 181 / 4, 68 / 182 / 2, 116 / 183 / 2, 58 / 184 / 2, 117 / 185 / 3, 218 / 186 / 2, 182 / 187 / 3, 95 / 188 / 2, 184 / 189 / 2, 41 / 190 / 3, 154 / 191 / 2, 52 / 192 / 2, 54 / 193 / 3, 83 / 194 / 2, 201 / 195 / 3, 161 / 196 / 2, 170 / 197 / 2, 249 / 198 / 3, 128 / 199 / 2, 48 / 200 / 3, 242 / 201 / 2, 112 / 202 / 3, 189 / 203 / 2, 181 / 204 / 3, 75 / 205 / 2, 178 / 206 / 3, 126 / 207 / 2, 191 / 208 / 2, 15 / 209 / 3, 194 / 210 / 2, 22 / 211 / 2, 20 / 212 / 2, 173 / 213 / 2, 230 / 214 / 3, 97 / 215 / 2, 227 / 216 / 2, 53 / 217 / 2, 65 / 218 / 2, 206 / 219 / 4, 223 / 220 / 2, 70 / 221 / 2, 248 / 222 / 4, 175 / 223 / 2, 9 / 224 / 2, 164 / 225 / 2, 225 / 226 / 2, 107 / 227 / 2, 99 / 228 / 2, 40 / 229 / 6, 232 / 230 / 2, 235 / 231 / 2, 44 / 232 / 2, 200 / 233 / 2, 11 / 234 / 2, 220 / 235 / 4, 64 / 236 / 2, 19 / 237 / 2, 137 / 238 / 2, 243 / 239 / 3, 4 / 240 / 2, 45 / 241 / 2, 78 / 242 / 2, 133 / 243 / 5, 166 / 244 / 2, 127 / 245 / 2, 226 / 246 / 2, 177 / 247 / 2, 120 / 248 / 3, 79 / 249 / 2
uniform-alpha_1-6-n5.txt, 1, 1, 5, 291.385, 17, 12, 2, 4,4 / 1 / 2, 3 / 2 / 2, 1 / 3 / 2, 2 / 4 / 2
uniform-alpha_1-6-n500.txt, 1, 1, 500, 1805.58, 3684, 3184, 7, 452,227 / 1 / 2, 309 / 2 / 2, 249 / 3 / 7, 113 / 4 / 2, 312 / 7 / 4, 78 / 8 / 2, 433 / 9 / 3, 265 / 10 / 2, 450 / 11 / 2, 181 / 12 / 3, 394 / 14 / 3, 302 / 15 / 2, 215 / 16 / 3, 105 / 17 / 2, 242 / 18 / 5, 87 / 19 / 2, 207 / 20 / 2, 317 / 21 / 2, 28 / 22 / 2, 304 / 23 / 2, 59 / 24 / 4, 14 / 26 / 2, 264 / 27 / 4, 139 / 28 / 2, 89 / 29 / 2, 148 / 30 / 4, 111 / 31 / 2, 398 / 32 / 2, 356 / 33 / 4, 50 / 34 / 2, 98 / 35 / 3, 256 / 36 / 2, 79 / 37 / 2, 1 / 38 / 2, 159 / 39 / 3, 144 / 40 / 2, 3 / 41 / 2, 455 / 42 / 2, 162 / 43 / 3, 235 / 44 / 2, 307 / 45 / 2, 17 / 46 / 4, 206 / 48 / 2, 315 / 49 / 2, 157 / 50 / 2, 260 / 51 / 2, 368 / 52 / 3, 421 / 53 / 2, 155 / 54 / 3, 486 / 55 / 2, 462 / 56 / 2, 420 / 57 / 3, 303 / 58 / 2, 270 / 59 / 3, 224 / 60 / 2, 287 / 61 / 3, 136 / 62 / 2, 88 / 63 / 2, 300 / 64 / 4, 160 / 65 / 2, 364 / 66 / 3, 460 / 67 / 2, 248 / 68 / 2, 32 / 69 / 3, 349 / 70 / 2, 35 / 71 / 2, 90 / 72 / 2, 330 / 73 / 2, 49 / 74 / 3, 340 / 75 / 2, 310 / 76 / 2, 9 / 77 / 2, 415 / 78 / 3, 481 / 79 / 2, 103 / 80 / 3, 482 / 81 / 2, 106 / 82 / 2, 226 / 83 / 6, 192 / 84 / 2, 377 / 85 / 3, 278 / 87 / 2, 401 / 88 / 2, 271 / 89 / 3, 186 / 90 / 2, 100 / 91 / 3, 326 / 92 / 2, 285 / 93 / 3, 346 / 94 / 2, 366 / 95 / 2, 171 / 98 / 2, 373 / 99 / 2, 440 / 100 / 3, 286 / 101 / 2, 393 / 102 / 2, 71 / 103 / 2, 328 / 104 / 3, 363 / 106 / 3, 187 / 107 / 2, 123 / 108 / 2, 232 / 109 / 5, 133 / 110 / 2, 25 / 111 / 2, 434 / 112 / 3, 358 / 113 / 2, 150 / 114 / 2, 432 / 115 / 3, 251 / 116 / 2, 60 / 117 / 2, 236 / 118 / 3, 10 / 119 / 2, 145 / 120 / 2, 293 / 121 / 2, 114 / 122 / 3, 367 / 123 / 2, 476 / 124 / 2, 499 / 125 / 2, 254 / 126 / 2, 452 / 127 / 2, 65 / 128 / 2, 357 / 129 / 2, 149 / 130 / 5, 64 / 131 / 2, 263 / 132 / 2, 74 / 133 / 3, 199 / 134 / 2, 161 / 135 / 2, 33 / 136 / 2, 419 / 137 / 3, 334 / 138 / 2, 210 / 139 / 2, 288 / 140 / 3, 180 / 141 / 2, 125 / 142 / 2, 45 / 143 / 2, 447 / 144 / 2, 246 / 145 / 3, 341 / 146 / 2, 6 / 147 / 3, 379 / 148 / 2, 378 / 149 / 2, 44 / 150 / 3, 385 / 151 / 2, 479 / 152 / 2, 30 / 153 / 3, 291 / 154 / 2, 279 / 155 / 2, 435 / 156 / 3, 99 / 157 / 2, 453 / 158 / 2, 182 / 159 / 2, 305 / 160 / 2, 332 / 161 / 3, 81 / 162 / 2, 381 / 163 / 2, 428 / 164 / 4, 76 / 167 / 2, 422 / 168 / 2, 165 / 169 / 2, 108 / 170 / 4, 16 / 171 / 2, 427 / 172 / 2, 31 / 173 / 2, 418 / 174 / 2, 327 / 175 / 2, 38 / 176 / 2, 259 / 178 / 2, 322 / 179 / 6, 261 / 180 / 2, 72 / 181 / 2, 216 / 182 / 2, 194 / 183 / 2, 425 / 184 / 6, 95 / 185 / 2, 484 / 186 / 2, 333 / 187 / 2, 175 / 188 / 2, 430 / 189 / 2, 389 / 190 / 6, 406 / 191 / 2, 27 / 192 / 2, 495 / 193 / 4, 443 / 194 / 2, 172 / 195 / 2, 335 / 196 / 4, 457 / 199 / 3, 252 / 200 / 2, 463 / 201 / 2, 201 / 204 / 2, 459 / 205 / 4, 66 / 206 / 2, 137 / 207 / 2, 369 / 208 / 2, 109 / 209 / 3, 41 / 210 / 2, 238 / 211 / 2, 196 / 212 / 2, 53 / 213 / 2, 399 / 214 / 3, 183 / 215 / 2, 438 / 216 / 3, 213 / 217 / 2, 104 / 218 / 2, 92 / 219 / 3, 359 / 220 / 2, 388 / 221 / 3, 269 / 222 / 2, 231 / 223 / 4, 119 / 224 / 2, 431 / 225 / 3, 200 / 226 / 2, 353 / 227 / 2, 124 / 228 / 2, 321 / 229 / 2, 299 / 230 / 2, 46 / 231 / 2, 4 / 232 / 2, 467 / 233 / 2, 469 / 234 / 2, 164 / 235 / 3, 134 / 236 / 2, 132 / 237 / 2, 413 / 238 / 3, 112 / 240 / 5, 436 / 241 / 2, 347 / 242 / 2, 158 / 243 / 4, 209 / 244 / 2, 229 / 245 / 2, 77 / 246 / 2, 489 / 247 / 2, 297 / 248 / 6, 412 / 249 / 2, 284 / 250 / 2, 396 / 251 / 2, 86 / 252 / 2, 448 / 253 / 2, 176 / 254 / 2, 308 / 255 / 2, 214 / 256 / 2, 338 / 257 / 3, 188 / 258 / 2, 130 / 259 / 3, 127 / 260 / 2, 198 / 261 / 2, 234 / 262 / 3, 442 / 263 / 2, 115 / 264 / 3, 245 / 266 / 3, 470 / 267 / 2, 391 / 268 / 3, 403 / 270 / 2, 122 / 271 / 3, 471 / 272 / 2, 20 / 273 / 2, 370 / 274 / 3, 241 / 275 / 2, 276 / 276 / 2, 85 / 277 / 2, 189 / 278 / 3, 68 / 279 / 2, 55 / 282 / 2, 8 / 283 / 2, 218 / 284 / 2, 82 / 285 / 2, 437 / 286 / 5, 208 / 287 / 2, 496 / 288 / 2, 51 / 289 / 2, 488 / 290 / 5, 323 / 291 / 2, 179 / 292 / 2, 449 / 293 / 2, 392 / 294 / 4, 386 / 297 / 2, 466 / 298 / 2, 13 / 299 / 5, 494 / 300 / 2, 439 / 301 / 2, 110 / 302 / 2, 277 / 303 / 2, 313 / 304 / 2, 352 / 305 / 2, 185 / 306 / 2, 382 / 307 / 4, 167 / 308 / 2, 93 / 309 / 2, 52 / 310 / 5, 294 / 311 / 2, 143 / 312 / 3, 478 / 313 / 2, 337 / 314 / 2, 153 / 315 / 2, 336 / 316 / 2, 343 / 317 / 5, 480 / 318 / 2, 219 / 319 / 2, 18 / 320 / 2, 272 / 321 / 3, 39 / 322 / 2, 351 / 323 / 3, 29 / 324 / 2, 493 / 325 / 2, 316 / 326 / 2, 169 / 327 / 2, 485 / 328 / 3, 151 / 329 / 2, 414 / 330 / 2, 204 / 331 / 2, 120 / 332 / 3, 225 / 333 / 2, 48 / 334 / 2, 233 / 335 / 2, 306 / 336 / 3, 465 / 337 / 2, 83 / 338 / 2, 266 / 339 / 2, 274 / 340 / 2, 80 / 341 / 4, 11 / 342 / 2, 202 / 343 / 2, 178 / 344 / 2, 141 / 345 / 5, 195 / 346 / 2, 417 / 347 / 2, 268 / 348 / 2, 267 / 349 / 4, 212 / 350 / 2, 253 / 353 / 2, 451 / 354 / 3, 454 / 356 / 3, 441 / 357 / 2, 395 / 358 / 2, 477 / 359 / 2, 69 / 360 / 3, 355 / 361 / 2, 483 / 362 / 3, 221 / 363 / 2, 445 / 364 / 3, 57 / 365 / 2, 325 / 366 / 2, 168 / 367 / 5, 472 / 368 / 2, 464 / 369 / 2, 97 / 372 / 3, 243 / 373 / 2, 96 / 374 / 3, 147 / 375 / 2, 371 / 376 / 3, 375 / 379 / 4, 275 / 380 / 2, 301 / 383 / 2, 223 / 384 / 3, 26 / 385 / 2, 362 / 386 / 3, 458 / 387 / 2, 411 / 388 / 2, 329 / 389 / 2, 324 / 390 / 2, 163 / 391 / 3, 63 / 392 / 2, 446 / 393 / 5, 374 / 396 / 2, 217 / 397 / 2, 61 / 398 / 2, 239 / 399 / 5, 490 / 401 / 2, 19 / 402 / 2, 152 / 403 / 2, 22 / 404 / 3, 190 / 405 / 2, 56 / 406 / 2, 244 / 407 / 2, 121 / 408 / 2, 107 / 410 / 2, 102 / 411 / 4, 116 / 412 / 2, 21 / 413 / 2, 211 / 414 / 4, 289 / 415 / 2, 410 / 418 / 3, 36 / 419 / 2, 94 / 420 / 3, 497 / 421 / 2, 118 / 422 / 3, 184 / 423 / 2, 407 / 424 / 2, 456 / 425 / 3, 142 / 426 / 2, 298 / 427 / 2, 101 / 430 / 5, 230 / 431 / 2, 156 / 432 / 2, 197 / 433 / 2, 320 / 434 / 3, 390 / 435 / 2, 222 / 436 / 3, 191 / 437 / 2, 135 / 438 / 2, 423 / 439 / 2, 220 / 440 / 2, 237 / 441 / 2, 331 / 442 / 2, 62 / 443 / 2, 474 / 444 / 2, 354 / 445 / 2, 23 / 446 / 3, 281 / 447 / 2, 295 / 448 / 2, 129 / 449 / 6, 405 / 450 / 2, 404 / 451 / 2, 283 / 452 / 3, 193 / 453 / 2, 282 / 458 / 3, 408 / 459 / 2, 174 / 460 / 2, 257 / 461 / 3, 292 / 462 / 2, 380 / 463 / 2, 7 / 464 / 2, 24 / 465 / 2, 75 / 466 / 2, 360 / 467 / 3, 5 / 468 / 2, 177 / 469 / 2, 126 / 470 / 2, 345 / 471 / 2, 296 / 472 / 2, 468 / 473 / 2, 376 / 474 / 2, 205 / 475 / 2, 444 / 476 / 3, 43 / 477 / 2, 67 / 478 / 2, 138 / 479 / 2, 117 / 480 / 3, 409 / 481 / 2, 348 / 482 / 2, 475 / 486 / 3, 361 / 487 / 2, 424 / 488 / 2, 429 / 489 / 3, 365 / 490 / 2, 37 / 491 / 3, 258 / 492 / 2, 255 / 493 / 2, 314 / 494 / 2, 416 / 495 / 2, 397 / 496 / 2, 166 / 497 / 3, 350 / 498 / 2, 344 / 499 / 3
uniform-alpha_1-60-n10.txt, 1, 1, 10, 361.388, 46, 36, 3, 9,2 / 1 / 3, 6 / 2 / 2, 1 / 3 / 3, 7 / 4 / 2, 9 / 5 / 3, 5 / 6 / 2, 3 / 7 / 2, 8 / 8 / 2, 4 / 9 / 3
uniform-alpha_1-61-n20.txt, 1, 1, 20, 381.405, 135, 115, 9, 19,9 / 1 / 9, 4 / 2 / 2, 8 / 3 / 2, 11 / 4 / 2, 13 / 5 / 4, 3 / 6 / 2, 7 / 7 / 2, 1 / 8 / 2, 10 / 9 / 5, 14 / 10 / 2, 18 / 11 / 2, 15 / 12 / 2, 6 / 13 / 2, 2 / 14 / 2, 17 / 15 / 2, 12 / 16 / 3, 19 / 17 / 2, 16 / 18 / 2, 5 / 19 / 4
uniform-alpha_1-62-n20.txt, 1, 1, 20, 380.075, 110, 90, 3, 19,16 / 1 / 2, 12 / 2 / 2, 11 / 3 / 3, 5 / 4 / 2, 17 / 5 / 2, 7 / 6 / 3, 10 / 7 / 2, 18 / 8 / 3, 2 / 9 / 2, 6 / 10 / 2, 19 / 11 / 2, 8 / 12 / 2, 1 / 13 / 2, 14 / 14 / 2, 13 / 15 / 2, 9 / 16 / 3, 3 / 17 / 2, 4 / 18 / 2, 15 / 19 / 3
uniform-alpha_1-63-n20.txt, 1, 1, 20, 399.134, 120, 100, 4, 19,7 / 1 / 2, 4 / 2 / 4, 10 / 3 / 2, 8 / 4 / 2, 9 / 5 / 4, 6 / 6 / 2, 17 / 7 / 2, 12 / 8 / 2, 3 / 9 / 3, 18 / 10 / 2, 2 / 11 / 2, 5 / 12 / 2, 19 / 13 / 2, 16 / 14 / 2, 14 / 15 / 3, 15 / 16 / 2, 1 / 17 / 3, 11 / 18 / 2, 13 / 19 / 3
uniform-alpha_1-64-n20.txt, 1, 1, 20, 370.01, 157, 137, 7, 19,1 / 1 / 3, 18 / 2 / 2, 11 / 3 / 7, 17 / 4 / 2, 13 / 5 / 2, 5 / 6 / 2, 4 / 7 / 4, 19 / 8 / 2, 15 / 9 / 2, 3 / 10 / 6, 6 / 11 / 2, 16 / 12 / 3, 12 / 13 / 2, 2 / 14 / 2, 7 / 15 / 3, 9 / 16 / 2, 14 / 17 / 2, 10 / 18 / 3, 8 / 19 / 2
uniform-alpha_1-65-n20.txt, 1, 1, 20, 418.792, 106, 86, 3, 19,7 / 1 / 3, 18 / 2 / 2, 10 / 3 / 2, 1 / 4 / 2, 15 / 5 / 2, 4 / 6 / 2, 2 / 7 / 2, 6 / 8 / 2, 12 / 9 / 2, 9 / 10 / 2, 13 / 11 / 2, 14 / 12 / 2, 11 / 13 / 3, 3 / 14 / 2, 8 / 15 / 2, 17 / 16 / 3, 19 / 17 / 2, 5 / 18 / 3, 16 / 19 / 2
uniform-alpha_1-66-n20.txt, 1, 1, 20, 489.804, 148, 128, 4, 19,18 / 1 / 2, 16 / 2 / 3, 9 / 3 / 2, 6 / 4 / 2, 2 / 5 / 2, 5 / 6 / 2, 14 / 7 / 2, 10 / 8 / 4, 15 / 9 / 2, 7 / 10 / 2, 1 / 11 / 3, 11 / 12 / 2, 4 / 13 / 2, 19 / 14 / 3, 17 / 15 / 2, 8 / 16 / 2, 12 / 17 / 4, 13 / 18 / 2, 3 / 19 / 3
uniform-alpha_1-67-n20.txt, 1, 1, 20, 406.122, 123, 103, 5, 19,7 / 1 / 5, 6 / 2 / 2, 11 / 3 / 3, 3 / 4 / 2, 15 / 5 / 3, 1 / 6 / 2, 4 / 7 / 3, 17 / 8 / 2, 8 / 9 / 3, 18 / 10 / 2, 9 / 11 / 3, 13 / 12 / 2, 14 / 13 / 2, 19 / 14 / 4, 16 / 15 / 2, 5 / 16 / 2, 12 / 17 / 2, 2 / 18 / 4, 10 / 19 / 2
uniform-alpha_1-68-n20.txt, 1, 1, 20, 455.378, 137, 117, 6, 19,19 / 1 / 2, 7 / 2 / 2, 6 / 3 / 6, 9 / 4 / 2, 13 / 5 / 2, 5 / 6 / 2, 10 / 7 / 2, 18 / 8 / 3, 4 / 9 / 2, 3 / 10 / 3, 17 / 11 / 2, 1 / 12 / 4, 14 / 13 / 2, 15 / 14 / 2, 12 / 15 / 4, 2 / 16 / 2, 16 / 17 / 2, 11 / 18 / 2, 8 / 19 / 2
uniform-alpha_1-69-n20.txt, 1, 1, 20, 380.47, 114, 94, 5, 19,13 / 1 / 2, 8 / 2 / 3, 4 / 3 / 2, 9 / 4 / 2, 17 / 5 / 3, 19 / 6 / 2, 16 / 7 / 2, 12 / 8 / 2, 1 / 9 / 3, 5 / 10 / 2, 6 / 11 / 3, 11 / 12 / 2, 10 / 13 / 3, 3 / 14 / 2, 15 / 15 / 2, 18 / 16 / 3, 2 / 17 / 2, 14 / 18 / 5, 7 / 19 / 2
uniform-alpha_1-7-n250.txt, 1, 1, 250, 1313.13, 1724, 1474, 7, 238,26 / 1 / 2, 14 / 2 / 7, 112 / 3 / 2, 84 / 4 / 3, 116 / 5 / 2, 245 / 7 / 2, 52 / 8 / 3, 77 / 9 / 2, 138 / 10 / 4, 40 / 11 / 2, 83 / 12 / 3, 35 / 13 / 2, 219 / 14 / 2, 9 / 15 / 4, 8 / 17 / 3, 167 / 18 / 2, 56 / 19 / 3, 16 / 20 / 2, 19 / 21 / 2, 80 / 22 / 2, 228 / 23 / 2, 159 / 24 / 5, 122 / 25 / 2, 53 / 26 / 2, 90 / 27 / 2, 42 / 28 / 3, 189 / 29 / 2, 205 / 30 / 2, 115 / 31 / 3, 4 / 32 / 2, 57 / 33 / 2, 238 / 34 / 3, 181 / 35 / 2, 144 / 36 / 2, 186 / 37 / 2, 64 / 38 / 2, 22 / 39 / 3, 32 / 40 / 2, 136 / 41 / 2, 182 / 42 / 2, 175 / 43 / 3, 96 / 44 / 2, 240 / 45 / 2, 59 / 46 / 3, 161 / 47 / 2, 222 / 50 / 2, 166 / 51 / 4, 92 / 52 / 2, 194 / 53 / 2, 38 / 54 / 2, 37 / 55 / 2, 87 / 56 / 3, 232 / 57 / 2, 200 / 58 / 2, 202 / 59 / 2, 95 / 60 / 2, 2 / 61 / 3, 89 / 62 / 2, 234 / 63 / 3, 146 / 64 / 2, 217 / 65 / 2, 188 / 66 / 2, 196 / 67 / 2, 227 / 68 / 2, 134 / 69 / 2, 211 / 70 / 2, 247 / 71 / 2, 30 / 73 / 2, 246 / 74 / 3, 213 / 76 / 2, 68 / 77 / 4, 132 / 78 / 2, 221 / 79 / 2, 164 / 80 / 4, 130 / 81 / 2, 82 / 82 / 2, 177 / 83 / 2, 224 / 84 / 2, 20 / 85 / 2, 178 / 86 / 2, 198 / 87 / 2, 160 / 88 / 2, 128 / 89 / 2, 70 / 90 / 2, 6 / 91 / 2, 97 / 92 / 3, 106 / 93 / 2, 249 / 94 / 2, 25 / 95 / 3, 248 / 96 / 2, 114 / 97 / 2, 133 / 98 / 2, 103 / 99 / 2, 43 / 102 / 3, 153 / 103 / 2, 216 / 104 / 3, 60 / 105 / 2, 244 / 106 / 2, 126 / 107 / 2, 29 / 108 / 2, 125 / 109 / 2, 158 / 110 / 2, 165 / 111 / 2, 155 / 112 / 2, 231 / 113 / 2, 104 / 114 / 4, 140 / 115 / 2, 66 / 116 / 2, 233 / 117 / 2, 111 / 118 / 2, 120 / 119 / 2, 46 / 120 / 2, 102 / 121 / 3, 220 / 122 / 2, 135 / 123 / 2, 241 / 124 / 2, 171 / 125 / 3, 18 / 126 / 2, 199 / 127 / 2, 85 / 128 / 3, 170 / 129 / 2, 21 / 130 / 4, 207 / 131 / 2, 39 / 132 / 2, 109 / 133 / 3, 236 / 134 / 2, 149 / 135 / 3, 142 / 136 / 2, 143 / 137 / 2, 5 / 138 / 3, 86 / 139 / 2, 17 / 140 / 2, 51 / 141 / 3, 50 / 142 / 2, 184 / 143 / 3, 187 / 144 / 2, 212 / 145 / 2, 54 / 146 / 2, 117 / 147 / 2, 163 / 148 / 2, 168 / 149 / 2, 58 / 150 / 2, 173 / 151 / 2, 150 / 152 / 3, 145 / 153 / 2, 235 / 155 / 3, 190 / 156 / 2, 99 / 157 / 4, 208 / 158 / 2, 214 / 159 / 2, 123 / 160 / 2, 44 / 161 / 2, 3 / 162 / 2, 172 / 163 / 3, 100 / 164 / 2, 195 / 165 / 3, 191 / 166 / 2, 197 / 167 / 2, 180 / 168 / 2, 237 / 169 / 5, 27 / 170 / 2, 76 / 171 / 3, 94 / 172 / 2, 88 / 173 / 3, 242 / 174 / 2, 203 / 175 / 3, 156 / 176 / 2, 62 / 177 / 2, 36 / 178 / 4, 45 / 179 / 2, 107 / 180 / 3, 69 / 182 / 4, 11 / 183 / 2, 71 / 184 / 2, 157 / 185 / 3, 141 / 186 / 2, 176 / 187 / 3, 124 / 188 / 2, 91 / 189 / 2, 226 / 190 / 2, 72 / 192 / 3, 218 / 193 / 2, 31 / 194 / 2, 33 / 195 / 3, 215 / 196 / 2, 74 / 197 / 3, 108 / 198 / 2, 137 / 199 / 2, 67 / 200 / 2, 23 / 201 / 4, 162 / 202 / 2, 204 / 203 / 2, 34 / 204 / 2, 78 / 205 / 3, 229 / 206 / 2, 183 / 207 / 3, 179 / 208 / 2, 154 / 209 / 2, 223 / 210 / 2, 148 / 211 / 2, 129 / 212 / 2, 12 / 213 / 2, 105 / 214 / 2, 55 / 215 / 2, 225 / 216 / 3, 93 / 217 / 2, 101 / 218 / 3, 152 / 219 / 2, 192 / 220 / 2, 118 / 221 / 2, 201 / 222 / 3, 243 / 223 / 2, 239 / 224 / 2, 73 / 225 / 2, 15 / 226 / 4, 121 / 227 / 2, 113 / 228 / 2, 10 / 229 / 2, 206 / 230 / 2, 7 / 231 / 2, 174 / 232 / 3, 139 / 233 / 2, 24 / 234 / 3, 110 / 235 / 2, 61 / 236 / 2, 81 / 237 / 3, 147 / 238 / 2, 75 / 239 / 2, 28 / 240 / 2, 210 / 241 / 3, 1 / 242 / 2, 209 / 243 / 2, 230 / 244 / 2, 151 / 245 / 2, 13 / 246 / 2, 41 / 247 / 2, 131 / 248 / 2, 127 / 249 / 3
uniform-alpha_1-7-n5.txt, 1, 1, 5, 291.804, 19, 14, 5, 4,4 / 1 / 2, 1 / 2 / 3, 2 / 3 / 2, 3 / 4 / 5
uniform-alpha_1-7-n500.txt, 1, 1, 500, 1804.61, 3573, 3073, 7, 465,427 / 1 / 2, 292 / 2 / 2, 455 / 3 / 5, 362 / 4 / 2, 481 / 5 / 2, 93 / 6 / 2, 176 / 7 / 3, 419 / 8 / 2, 314 / 9 / 2, 217 / 10 / 3, 239 / 11 / 2, 4 / 12 / 3, 368 / 13 / 2, 485 / 14 / 2, 468 / 15 / 2, 473 / 16 / 3, 105 / 17 / 2, 192 / 18 / 3, 425 / 19 / 2, 423 / 20 / 2, 158 / 21 / 3, 138 / 22 / 2, 433 / 23 / 3, 190 / 24 / 2, 476 / 25 / 2, 405 / 26 / 2, 384 / 27 / 2, 417 / 28 / 6, 183 / 29 / 2, 291 / 30 / 2, 467 / 31 / 2, 381 / 32 / 4, 443 / 33 / 2, 416 / 34 / 2, 13 / 35 / 2, 47 / 36 / 3, 209 / 37 / 2, 20 / 38 / 2, 414 / 39 / 4, 147 / 40 / 2, 90 / 41 / 2, 98 / 42 / 2, 305 / 43 / 2, 37 / 44 / 4, 316 / 45 / 2, 101 / 47 / 4, 271 / 49 / 2, 264 / 50 / 2, 393 / 51 / 2, 106 / 52 / 2, 266 / 53 / 2, 129 / 54 / 2, 232 / 55 / 2, 483 / 56 / 5, 471 / 57 / 2, 435 / 58 / 3, 367 / 59 / 2, 240 / 60 / 4, 249 / 61 / 2, 109 / 62 / 2, 497 / 63 / 2, 207 / 64 / 2, 363 / 65 / 2, 285 / 66 / 2, 376 / 67 / 2, 96 / 68 / 3, 267 / 69 / 2, 348 / 70 / 2, 301 / 71 / 2, 191 / 72 / 3, 488 / 73 / 2, 257 / 74 / 3, 154 / 75 / 2, 475 / 76 / 2, 202 / 77 / 2, 200 / 78 / 5, 107 / 79 / 2, 82 / 80 / 3, 133 / 81 / 2, 364 / 82 / 2, 124 / 83 / 2, 339 / 84 / 2, 424 / 85 / 3, 307 / 86 / 2, 459 / 87 / 2, 396 / 88 / 2, 477 / 89 / 4, 234 / 90 / 2, 39 / 91 / 2, 258 / 92 / 2, 469 / 93 / 2, 63 / 94 / 2, 418 / 95 / 2, 422 / 96 / 2, 193 / 97 / 4, 482 / 98 / 2, 299 / 99 / 2, 398 / 100 / 2, 241 / 101 / 2, 178 / 102 / 2, 366 / 103 / 4, 495 / 104 / 2, 499 / 105 / 2, 50 / 106 / 2, 321 / 107 / 3, 412 / 108 / 2, 123 / 109 / 3, 164 / 110 / 2, 252 / 111 / 2, 498 / 112 / 3, 181 / 113 / 2, 113 / 114 / 2, 86 / 115 / 2, 100 / 116 / 2, 251 / 117 / 3, 5 / 118 / 2, 493 / 119 / 2, 52 / 120 / 3, 391 / 121 / 2, 338 / 122 / 2, 189 / 123 / 4, 333 / 124 / 2, 403 / 125 / 2, 269 / 126 / 3, 87 / 128 / 3, 130 / 129 / 2, 137 / 130 / 2, 479 / 131 / 3, 43 / 132 / 2, 255 / 133 / 2, 275 / 134 / 2, 188 / 135 / 3, 290 / 136 / 2, 327 / 137 / 2, 120 / 138 / 3, 345 / 140 / 2, 15 / 141 / 2, 44 / 142 / 2, 472 / 143 / 2, 238 / 144 / 3, 206 / 145 / 2, 125 / 146 / 2, 16 / 147 / 2, 119 / 148 / 2, 180 / 149 / 3, 484 / 150 / 2, 281 / 151 / 2, 237 / 152 / 2, 75 / 153 / 2, 286 / 154 / 3, 355 / 155 / 2, 265 / 156 / 3, 387 / 157 / 2, 450 / 158 / 2, 220 / 159 / 2, 313 / 160 / 2, 466 / 161 / 4, 244 / 162 / 2, 374 / 163 / 2, 347 / 164 / 2, 309 / 165 / 4, 272 / 166 / 2, 370 / 167 / 3, 163 / 168 / 2, 268 / 169 / 2, 134 / 170 / 3, 254 / 171 / 2, 144 / 172 / 3, 104 / 173 / 2, 132 / 174 / 3, 215 / 175 / 2, 276 / 176 / 3, 311 / 177 / 2, 185 / 178 / 2, 340 / 181 / 2, 14 / 182 / 2, 410 / 183 / 3, 442 / 184 / 2, 118 / 185 / 2, 440 / 186 / 2, 453 / 187 / 2, 10 / 188 / 3, 127 / 189 / 2, 439 / 190 / 2, 165 / 191 / 2, 330 / 192 / 5, 388 / 193 / 2, 306 / 194 / 2, 121 / 195 / 2, 22 / 196 / 5, 149 / 199 / 3, 461 / 200 / 2, 111 / 201 / 2, 438 / 202 / 2, 353 / 203 / 3, 62 / 204 / 2, 103 / 205 / 4, 489 / 206 / 2, 151 / 207 / 2, 219 / 208 / 2, 350 / 209 / 3, 18 / 210 / 2, 407 / 211 / 2, 373 / 212 / 3, 45 / 213 / 2, 447 / 214 / 2, 315 / 215 / 2, 389 / 216 / 2, 429 / 217 / 3, 135 / 218 / 2, 73 / 219 / 2, 295 / 220 / 3, 243 / 221 / 2, 380 / 222 / 2, 140 / 223 / 2, 288 / 224 / 3, 99 / 225 / 2, 357 / 226 / 2, 199 / 227 / 2, 94 / 228 / 4, 300 / 229 / 2, 319 / 230 / 3, 227 / 231 / 2, 336 / 232 / 2, 166 / 233 / 2, 394 / 234 / 4, 274 / 235 / 2, 222 / 236 / 2, 382 / 237 / 4, 383 / 239 / 2, 446 / 240 / 3, 399 / 241 / 2, 436 / 242 / 3, 12 / 243 / 2, 55 / 244 / 2, 59 / 245 / 2, 91 / 246 / 3, 32 / 249 / 3, 324 / 250 / 2, 460 / 251 / 2, 344 / 252 / 2, 233 / 253 / 2, 411 / 254 / 2, 415 / 255 / 3, 492 / 256 / 2, 148 / 257 / 2, 141 / 258 / 3, 77 / 259 / 2, 60 / 260 / 2, 198 / 261 / 4, 1 / 263 / 3, 342 / 264 / 2, 308 / 265 / 2, 360 / 266 / 4, 95 / 267 / 2, 253 / 268 / 2, 491 / 269 / 3, 61 / 270 / 2, 354 / 271 / 2, 470 / 272 / 2, 260 / 273 / 4, 69 / 274 / 2, 317 / 276 / 2, 235 / 277 / 3, 17 / 278 / 2, 195 / 279 / 3, 480 / 281 / 2, 169 / 282 / 2, 145 / 283 / 3, 358 / 284 / 2, 31 / 285 / 2, 25 / 286 / 2, 474 / 287 / 5, 186 / 290 / 3, 213 / 292 / 2, 212 / 293 / 5, 385 / 295 / 3, 9 / 296 / 2, 397 / 297 / 3, 441 / 298 / 2, 57 / 299 / 2, 337 / 300 / 2, 223 / 301 / 4, 409 / 302 / 2, 261 / 303 / 2, 36 / 304 / 2, 204 / 305 / 4, 413 / 306 / 2, 304 / 307 / 3, 346 / 309 / 2, 161 / 310 / 2, 23 / 311 / 2, 449 / 312 / 2, 72 / 313 / 2, 351 / 314 / 2, 326 / 315 / 2, 303 / 316 / 2, 157 / 317 / 3, 182 / 318 / 2, 160 / 319 / 2, 229 / 320 / 2, 80 / 321 / 2, 112 / 322 / 5, 54 / 323 / 2, 369 / 324 / 2, 457 / 325 / 2, 35 / 326 / 3, 395 / 327 / 2, 110 / 328 / 3, 81 / 329 / 2, 19 / 330 / 2, 298 / 331 / 2, 434 / 332 / 3, 194 / 333 / 2, 196 / 334 / 2, 49 / 335 / 2, 322 / 336 / 2, 221 / 337 / 2, 454 / 338 / 3, 172 / 339 / 2, 245 / 341 / 2, 97 / 342 / 3, 201 / 343 / 2, 464 / 344 / 3, 122 / 345 / 2, 211 / 346 / 2, 392 / 347 / 2, 139 / 348 / 3, 408 / 349 / 2, 3 / 350 / 3, 128 / 351 / 2, 375 / 352 / 2, 8 / 353 / 2, 263 / 354 / 2, 282 / 357 / 3, 262 / 358 / 2, 7 / 360 / 2, 108 / 361 / 2, 487 / 362 / 2, 38 / 363 / 2, 88 / 364 / 2, 343 / 365 / 3, 359 / 366 / 2, 42 / 368 / 2, 71 / 369 / 2, 230 / 370 / 3, 225 / 371 / 2, 214 / 372 / 3, 352 / 373 / 2, 65 / 374 / 2, 297 / 375 / 4, 426 / 376 / 2, 378 / 378 / 2, 56 / 379 / 2, 420 / 380 / 5, 278 / 381 / 2, 310 / 382 / 2, 67 / 383 / 3, 458 / 384 / 2, 76 / 385 / 2, 156 / 386 / 2, 463 / 387 / 2, 320 / 388 / 3, 167 / 389 / 2, 115 / 390 / 2, 136 / 391 / 2, 27 / 392 / 2, 341 / 393 / 3, 361 / 394 / 2, 494 / 395 / 2, 401 / 396 / 2, 456 / 397 / 2, 84 / 398 / 2, 444 / 399 / 2, 379 / 400 / 2, 331 / 401 / 2, 170 / 402 / 3, 296 / 403 / 2, 236 / 404 / 2, 102 / 405 / 2, 184 / 406 / 3, 312 / 407 / 2, 270 / 408 / 2, 2 / 409 / 3, 390 / 410 / 2, 231 / 411 / 2, 89 / 412 / 3, 66 / 415 / 2, 318 / 416 / 3, 226 / 417 / 2, 323 / 419 / 4, 126 / 420 / 2, 143 / 421 / 2, 400 / 422 / 4, 406 / 423 / 2, 79 / 424 / 2, 421 / 425 / 2, 294 / 426 / 2, 430 / 427 / 3, 490 / 428 / 2, 153 / 429 / 2, 150 / 430 / 2, 21 / 431 / 4, 283 / 432 / 2, 256 / 433 / 2, 179 / 436 / 2, 334 / 437 / 2, 11 / 438 / 2, 287 / 439 / 2, 34 / 440 / 2, 68 / 441 / 2, 51 / 442 / 3, 142 / 443 / 2, 259 / 444 / 3, 175 / 445 / 2, 246 / 446 / 2, 83 / 447 / 2, 24 / 448 / 2, 41 / 449 / 3, 30 / 450 / 2, 224 / 451 / 2, 279 / 452 / 2, 26 / 453 / 2, 402 / 454 / 2, 250 / 455 / 3, 496 / 456 / 2, 177 / 458 / 2, 365 / 459 / 2, 328 / 460 / 2, 404 / 461 / 5, 218 / 462 / 2, 248 / 464 / 2, 6 / 465 / 3, 377 / 468 / 7, 371 / 469 / 2, 335 / 470 / 2, 187 / 471 / 3, 478 / 472 / 2, 247 / 473 / 2, 486 / 474 / 2, 273 / 475 / 4, 216 / 476 / 2, 349 / 477 / 3, 159 / 478 / 2, 452 / 479 / 2, 152 / 480 / 4, 277 / 481 / 2, 302 / 482 / 2, 242 / 483 / 3, 205 / 484 / 2, 64 / 485 / 2, 386 / 486 / 2, 48 / 487 / 2, 131 / 488 / 4, 29 / 489 / 2, 284 / 490 / 2, 116 / 491 / 2, 58 / 492 / 2, 168 / 493 / 2, 451 / 494 / 2, 155 / 495 / 2, 74 / 496 / 2, 173 / 497 / 2, 114 / 498 / 2, 293 / 499 / 3
uniform-alpha_1-70-n20.txt, 1, 1, 20, 453.583, 135, 115, 5, 19,8 / 1 / 5, 6 / 2 / 2, 17 / 3 / 3, 13 / 4 / 2, 18 / 5 / 2, 12 / 6 / 2, 11 / 7 / 4, 9 / 8 / 2, 7 / 9 / 3, 15 / 10 / 2, 10 / 11 / 3, 5 / 12 / 2, 1 / 13 / 2, 4 / 14 / 3, 19 / 15 / 2, 14 / 16 / 2, 3 / 17 / 3, 16 / 18 / 2, 2 / 19 / 4
uniform-alpha_1-71-n50.txt, 1, 1, 50, 585.689, 370, 320, 5, 48,1 / 1 / 3, 15 / 2 / 2, 24 / 3 / 2, 44 / 4 / 4, 33 / 5 / 2, 7 / 6 / 2, 17 / 7 / 3, 8 / 8 / 2, 3 / 9 / 3, 39 / 10 / 2, 18 / 11 / 3, 43 / 12 / 2, 27 / 13 / 3, 40 / 14 / 2, 22 / 15 / 3, 45 / 16 / 2, 10 / 17 / 2, 6 / 18 / 2, 26 / 19 / 2, 13 / 20 / 2, 21 / 21 / 4, 20 / 22 / 2, 49 / 23 / 2, 29 / 24 / 2, 11 / 25 / 5, 32 / 26 / 2, 19 / 27 / 2, 42 / 28 / 2, 5 / 29 / 5, 9 / 30 / 2, 12 / 32 / 3, 37 / 33 / 2, 2 / 34 / 2, 35 / 35 / 3, 4 / 36 / 2, 38 / 37 / 3, 30 / 38 / 2, 34 / 39 / 3, 28 / 40 / 2, 41 / 41 / 2, 16 / 42 / 2, 23 / 43 / 2, 46 / 44 / 5, 47 / 45 / 2, 36 / 46 / 3, 31 / 47 / 2, 14 / 48 / 2, 25 / 49 / 4
uniform-alpha_1-72-n50.txt, 1, 1, 50, 653.495, 355, 305, 5, 48,20 / 1 / 2, 18 / 2 / 2, 5 / 3 / 4, 38 / 4 / 2, 46 / 5 / 2, 39 / 6 / 3, 42 / 7 / 2, 45 / 8 / 3, 10 / 9 / 2, 24 / 10 / 2, 6 / 11 / 2, 7 / 12 / 3, 16 / 13 / 2, 8 / 14 / 3, 28 / 15 / 2, 4 / 16 / 2, 19 / 17 / 5, 11 / 18 / 2, 34 / 19 / 2, 31 / 20 / 2, 33 / 21 / 4, 26 / 22 / 2, 23 / 23 / 2, 13 / 24 / 4, 15 / 25 / 2, 35 / 26 / 3, 9 / 27 / 2, 2 / 28 / 3, 30 / 30 / 2, 41 / 31 / 3, 27 / 32 / 2, 49 / 33 / 3, 3 / 34 / 2, 29 / 35 / 3, 48 / 36 / 2, 47 / 37 / 2, 1 / 38 / 3, 37 / 39 / 2, 32 / 40 / 5, 12 / 41 / 2, 36 / 42 / 3, 22 / 43 / 2, 14 / 44 / 2, 40 / 45 / 3, 21 / 46 / 2, 17 / 47 / 2, 44 / 48 / 2, 25 / 49 / 5
uniform-alpha_1-73-n50.txt, 1, 1, 50, 608.256, 335, 285, 5, 49,49 / 1 / 2, 29 / 2 / 3, 46 / 3 / 2, 11 / 4 / 3, 31 / 5 / 2, 27 / 6 / 3, 34 / 7 / 2, 38 / 8 / 2, 41 / 9 / 2, 9 / 10 / 3, 35 / 11 / 2, 16 / 12 / 2, 48 / 13 / 2, 30 / 14 / 3, 26 / 15 / 2, 42 / 16 / 3, 45 / 17 / 2, 2 / 18 / 4, 1 / 19 / 2, 44 / 20 / 2, 20 / 21 / 2, 19 / 22 / 3, 6 / 23 / 2, 21 / 24 / 3, 7 / 25 / 2, 28 / 26 / 2, 13 / 27 / 2, 47 / 28 / 3, 5 / 29 / 2, 8 / 30 / 2, 37 / 31 / 2, 39 / 32 / 3, 36 / 33 / 2, 43 / 34 / 2, 18 / 35 / 2, 10 / 36 / 4, 3 / 37 / 2, 17 / 38 / 2, 4 / 39 / 2, 15 / 40 / 2, 12 / 41 / 4, 33 / 42 / 2, 23 / 43 / 2, 24 / 44 / 3, 40 / 45 / 2, 25 / 46 / 2, 32 / 47 / 2, 22 / 48 / 2, 14 / 49 / 5
uniform-alpha_1-74-n50.txt, 1, 1, 50, 621.445, 357, 307, 5, 49,22 / 1 / 3, 19 / 2 / 2, 33 / 3 / 3, 10 / 4 / 2, 47 / 5 / 2, 48 / 6 / 3, 32 / 7 / 2, 42 / 8 / 3, 44 / 9 / 2, 38 / 10 / 2, 9 / 11 / 2, 29 / 12 / 2, 4 / 13 / 5, 11 / 14 / 2, 2 / 15 / 2, 49 / 16 / 3, 26 / 17 / 2, 40 / 18 / 4, 34 / 19 / 2, 31 / 20 / 2, 20 / 21 / 3, 30 / 22 / 2, 16 / 23 / 3, 28 / 24 / 2, 35 / 25 / 3, 36 / 26 / 2, 3 / 27 / 3, 27 / 28 / 2, 21 / 29 / 2, 15 / 30 / 2, 46 / 31 / 3, 17 / 32 / 2, 14 / 33 / 2, 39 / 34 / 4, 37 / 35 / 2, 7 / 36 / 2, 1 / 37 / 2, 41 / 38 / 3, 5 / 39 / 2, 8 / 40 / 3, 24 / 41 / 2, 12 / 42 / 2, 25 / 43 / 2, 18 / 44 / 4, 45 / 45 / 2, 23 / 46 / 2, 43 / 47 / 2, 6 / 48 / 4, 13 / 49 / 2
uniform-alpha_1-75-n50.txt, 1, 1, 50, 642.724, 340, 290, 4, 49,19 / 1 / 4, 4 / 2 / 2, 41 / 3 / 2, 30 / 4 / 2, 29 / 5 / 2, 15 / 6 / 2, 8 / 7 / 2, 7 / 8 / 3, 20 / 9 / 2, 37 / 10 / 2, 1 / 11 / 3, 9 / 12 / 2, 22 / 13 / 2, 5 / 14 / 3, 28 / 15 / 2, 35 / 16 / 3, 23 / 17 / 2, 34 / 18 / 3, 44 / 19 / 2, 25 / 20 / 2, 48 / 21 / 2, 42 / 22 / 2, 2 / 23 / 2, 45 / 24 / 3, 40 / 25 / 2, 33 / 26 / 3, 26 / 27 / 2, 12 / 28 / 2, 10 / 29 / 2, 27 / 30 / 2, 39 / 31 / 3, 3 / 32 / 2, 47 / 33 / 2, 32 / 34 / 2, 17 / 35 / 4, 36 / 36 / 2, 38 / 37 / 2, 46 / 38 / 2, 13 / 39 / 3, 31 / 40 / 2, 21 / 41 / 2, 24 / 42 / 3, 6 / 43 / 2, 11 / 44 / 2, 43 / 45 / 2, 49 / 46 / 2, 16 / 47 / 3, 14 / 48 / 2, 18 / 49 / 3
uniform-alpha_1-76-n50.txt, 1, 1, 50, 613.579, 352, 302, 5, 49,27 / 1 / 5, 23 / 2 / 2, 44 / 3 / 3, 19 / 4 / 2, 2 / 5 / 3, 42 / 6 / 2, 33 / 7 / 2, 17 / 8 / 4, 32 / 9 / 2, 34 / 10 / 2, 37 / 11 / 2, 30 / 12 / 5, 41 / 13 / 2, 24 / 14 / 2, 36 / 15 / 2, 8 / 16 / 2, 10 / 17 / 4, 38 / 18 / 2, 40 / 19 / 2, 45 / 20 / 4, 48 / 21 / 2, 1 / 22 / 2, 26 / 23 / 3, 28 / 24 / 2, 46 / 25 / 4, 49 / 26 / 2, 29 / 27 / 2, 16 / 28 / 3, 9 / 29 / 2, 22 / 30 / 2, 13 / 31 / 2, 12 / 32 / 2, 5 / 33 / 2, 18 / 34 / 3, 14 / 35 / 2, 7 / 36 / 2, 39 / 37 / 2, 43 / 38 / 2, 20 / 39 / 4, 47 / 40 / 2, 6 / 41 / 2, 25 / 42 / 2, 15 / 43 / 2, 21 / 44 / 2, 11 / 45 / 3, 31 / 46 / 2, 4 / 47 / 3, 3 / 48 / 2, 35 / 49 / 2
uniform-alpha_1-77-n50.txt, 1, 1, 50, 686.887, 310, 260, 5, 49,15 / 1 / 5, 38 / 2 / 2, 44 / 3 / 2, 24 / 4 / 2, 36 / 5 / 4, 49 / 6 / 2, 9 / 7 / 2, 26 / 8 / 2, 30 / 9 / 3, 1 / 10 / 2, 8 / 11 / 2, 43 / 12 / 2, 45 / 13 / 2, 37 / 14 / 2, 2 / 15 / 2, 14 / 16 / 2, 17 / 17 / 2, 42 / 18 / 2, 32 / 19 / 2, 22 / 20 / 2, 28 / 21 / 2, 27 / 22 / 2, 41 / 23 / 3, 3 / 24 / 2, 39 / 25 / 2, 20 / 26 / 3, 31 / 27 / 2, 19 / 28 / 2, 4 / 29 / 2, 25 / 30 / 3, 23 / 31 / 2, 47 / 32 / 3, 48 / 33 / 2, 11 / 34 / 2, 7 / 35 / 3, 6 / 36 / 2, 21 / 37 / 3, 13 / 38 / 2, 33 / 39 / 3, 29 / 40 / 2, 46 / 41 / 2, 12 / 42 / 2, 34 / 43 / 3, 16 / 44 / 2, 35 / 45 / 2, 10 / 46 / 2, 18 / 47 / 2, 5 / 48 / 2, 40 / 49 / 3
uniform-alpha_1-78-n50.txt, 1, 1, 50, 610.62, 318, 268, 4, 49,32 / 1 / 2, 38 / 2 / 3, 21 / 3 / 2, 29 / 4 / 3, 49 / 5 / 2, 15 / 6 / 3, 8 / 7 / 2, 33 / 8 / 4, 7 / 9 / 2, 26 / 10 / 2, 42 / 11 / 2, 25 / 12 / 2, 44 / 13 / 2, 37 / 14 / 2, 28 / 15 / 2, 41 / 16 / 3, 35 / 17 / 2, 47 / 18 / 2, 30 / 19 / 2, 34 / 20 / 2, 40 / 21 / 2, 20 / 22 / 3, 17 / 23 / 2, 14 / 24 / 3, 27 / 25 / 2, 11 / 26 / 3, 6 / 27 / 2, 24 / 28 / 2, 5 / 29 / 2, 9 / 30 / 2, 10 / 31 / 2, 46 / 32 / 2, 36 / 33 / 2, 1 / 34 / 2, 2 / 35 / 2, 48 / 36 / 3, 39 / 37 / 2, 12 / 38 / 2, 19 / 39 / 4, 16 / 40 / 2, 23 / 41 / 2, 18 / 42 / 2, 31 / 43 / 3, 3 / 44 / 2, 43 / 45 / 3, 45 / 46 / 2, 13 / 47 / 2, 4 / 48 / 4, 22 / 49 / 2
uniform-alpha_1-79-n50.txt, 1, 1, 50, 597.645, 320, 270, 5, 49,26 / 1 / 2, 21 / 2 / 2, 46 / 3 / 5, 34 / 4 / 2, 3 / 5 / 2, 1 / 6 / 2, 41 / 7 / 2, 37 / 8 / 2, 27 / 9 / 2, 9 / 10 / 4, 13 / 11 / 2, 44 / 12 / 2, 31 / 13 / 2, 12 / 14 / 2, 8 / 15 / 2, 30 / 16 / 2, 32 / 17 / 2, 38 / 18 / 2, 10 / 19 / 3, 11 / 20 / 2, 20 / 21 / 2, 23 / 22 / 2, 19 / 23 / 4, 29 / 24 / 2, 4 / 25 / 2, 49 / 26 / 2, 39 / 27 / 3, 22 / 28 / 2, 33 / 29 / 2, 35 / 30 / 2, 28 / 31 / 4, 43 / 32 / 2, 40 / 33 / 2, 6 / 34 / 3, 47 / 35 / 2, 18 / 36 / 3, 15 / 37 / 2, 24 / 38 / 3, 7 / 39 / 2, 48 / 40 / 3, 17 / 41 / 2, 36 / 42 / 3, 14 / 43 / 2, 5 / 44 / 2, 16 / 45 / 2, 42 / 46 / 2, 2 / 47 / 2, 45 / 48 / 2, 25 / 49 / 5
uniform-alpha_1-8-n250.txt, 1, 1, 250, 1323.58, 1645, 1395, 5, 244,220 / 1 / 2, 43 / 2 / 2, 214 / 3 / 2, 184 / 4 / 2, 55 / 5 / 2, 120 / 6 / 2, 241 / 7 / 3, 175 / 10 / 3, 25 / 11 / 2, 212 / 12 / 2, 69 / 13 / 2, 139 / 14 / 2, 138 / 15 / 3, 179 / 16 / 2, 242 / 17 / 3, 134 / 18 / 2, 29 / 19 / 2, 226 / 20 / 3, 67 / 21 / 2, 116 / 22 / 3, 115 / 23 / 2, 27 / 24 / 3, 53 / 25 / 2, 173 / 26 / 2, 82 / 27 / 2, 91 / 28 / 2, 141 / 29 / 2, 50 / 30 / 3, 208 / 31 / 2, 54 / 32 / 2, 94 / 33 / 4, 18 / 34 / 2, 38 / 35 / 2, 32 / 36 / 3, 177 / 37 / 2, 185 / 38 / 2, 77 / 39 / 2, 57 / 40 / 2, 126 / 41 / 2, 229 / 42 / 2, 12 / 43 / 3, 234 / 44 / 2, 102 / 45 / 2, 143 / 46 / 2, 133 / 47 / 2, 166 / 48 / 2, 152 / 49 / 3, 170 / 50 / 2, 161 / 52 / 2, 233 / 53 / 2, 124 / 54 / 2, 28 / 55 / 2, 145 / 56 / 3, 11 / 57 / 2, 83 / 58 / 3, 190 / 59 / 2, 136 / 60 / 2, 100 / 61 / 2, 6 / 62 / 3, 36 / 63 / 2, 66 / 64 / 3, 153 / 65 / 2, 64 / 66 / 2, 89 / 67 / 2, 127 / 68 / 3, 5 / 69 / 2, 78 / 70 / 2, 167 / 71 / 3, 33 / 72 / 2, 224 / 73 / 3, 61 / 74 / 2, 71 / 75 / 2, 45 / 76 / 3, 221 / 77 / 2, 188 / 78 / 3, 231 / 79 / 2, 160 / 80 / 2, 137 / 81 / 3, 235 / 82 / 2, 156 / 83 / 3, 42 / 84 / 2, 159 / 85 / 2, 236 / 86 / 3, 244 / 87 / 2, 99 / 88 / 2, 112 / 89 / 2, 98 / 90 / 2, 92 / 91 / 2, 90 / 92 / 2, 182 / 93 / 2, 191 / 94 / 2, 93 / 95 / 3, 51 / 96 / 2, 118 / 97 / 2, 154 / 98 / 2, 84 / 99 / 2, 125 / 100 / 3, 86 / 101 / 2, 158 / 102 / 3, 192 / 103 / 2, 16 / 104 / 2, 40 / 105 / 2, 169 / 106 / 2, 189 / 107 / 2, 3 / 108 / 2, 106 / 109 / 2, 104 / 110 / 4, 151 / 111 / 2, 163 / 112 / 2, 23 / 113 / 3, 37 / 114 / 2, 140 / 115 / 4, 117 / 116 / 2, 63 / 117 / 2, 121 / 118 / 3, 7 / 120 / 2, 130 / 121 / 3, 135 / 122 / 2, 17 / 123 / 3, 195 / 124 / 2, 237 / 125 / 2, 15 / 126 / 3, 10 / 127 / 2, 107 / 128 / 2, 74 / 129 / 2, 171 / 130 / 2, 230 / 131 / 2, 72 / 132 / 2, 60 / 133 / 2, 180 / 134 / 3, 201 / 135 / 2, 47 / 136 / 2, 219 / 137 / 2, 14 / 138 / 4, 56 / 139 / 2, 168 / 140 / 2, 157 / 141 / 3, 62 / 142 / 2, 225 / 143 / 2, 178 / 144 / 2, 148 / 145 / 2, 22 / 146 / 2, 4 / 147 / 3, 58 / 148 / 2, 35 / 149 / 3, 9 / 150 / 2, 147 / 151 / 4, 204 / 152 / 2, 110 / 153 / 2, 75 / 154 / 4, 48 / 155 / 2, 207 / 156 / 2, 132 / 157 / 3, 174 / 158 / 2, 162 / 159 / 2, 128 / 160 / 4, 172 / 161 / 2, 149 / 162 / 2, 26 / 163 / 4, 144 / 164 / 2, 228 / 165 / 2, 205 / 166 / 2, 49 / 167 / 2, 105 / 168 / 4, 186 / 169 / 2, 240 / 170 / 2, 80 / 171 / 4, 44 / 172 / 2, 13 / 173 / 2, 73 / 174 / 3, 20 / 175 / 2, 248 / 176 / 2, 196 / 177 / 3, 187 / 178 / 2, 146 / 179 / 2, 46 / 180 / 4, 239 / 181 / 2, 108 / 182 / 2, 164 / 183 / 3, 1 / 184 / 2, 211 / 185 / 3, 199 / 186 / 2, 223 / 187 / 3, 215 / 188 / 2, 165 / 189 / 3, 142 / 190 / 2, 101 / 191 / 3, 210 / 192 / 2, 123 / 194 / 2, 206 / 195 / 2, 88 / 196 / 3, 52 / 197 / 2, 87 / 198 / 2, 41 / 199 / 2, 203 / 200 / 4, 249 / 201 / 2, 222 / 202 / 2, 197 / 203 / 3, 227 / 204 / 2, 193 / 205 / 5, 232 / 206 / 2, 103 / 207 / 2, 96 / 208 / 2, 2 / 209 / 3, 65 / 210 / 2, 122 / 211 / 2, 31 / 212 / 3, 97 / 213 / 2, 194 / 214 / 3, 114 / 215 / 2, 155 / 216 / 2, 200 / 217 / 2, 217 / 218 / 2, 79 / 219 / 2, 59 / 220 / 2, 95 / 221 / 2, 183 / 222 / 2, 111 / 223 / 2, 243 / 224 / 3, 34 / 225 / 2, 245 / 226 / 2, 131 / 227 / 2, 81 / 228 / 3, 247 / 229 / 2, 129 / 230 / 2, 113 / 231 / 4, 8 / 232 / 2, 181 / 233 / 2, 202 / 234 / 4, 209 / 235 / 2, 19 / 236 / 3, 24 / 237 / 2, 238 / 238 / 3, 218 / 239 / 2, 76 / 240 / 2, 119 / 241 / 3, 213 / 242 / 2, 68 / 243 / 2, 21 / 244 / 2, 176 / 245 / 3, 30 / 246 / 2, 85 / 247 / 3, 216 / 248 / 2, 198 / 249 / 2
uniform-alpha_1-8-n5.txt, 1, 1, 5, 245.206, 17, 12, 3, 4,4 / 1 / 2, 1 / 2 / 3, 3 / 3 / 2, 2 / 4 / 2
uniform-alpha_1-8-n500.txt, 1, 1, 500, 1805.21, 3632, 3132, 8, 458,328 / 1 / 3, 28 / 2 / 2, 100 / 3 / 3, 250 / 4 / 2, 424 / 5 / 2, 7 / 6 / 5, 188 / 7 / 2, 98 / 8 / 2, 48 / 9 / 3, 461 / 10 / 2, 411 / 11 / 2, 347 / 12 / 2, 441 / 13 / 2, 139 / 14 / 2, 329 / 15 / 3, 478 / 16 / 2, 16 / 17 / 3, 463 / 18 / 2, 113 / 19 / 3, 198 / 20 / 2, 488 / 21 / 3, 221 / 22 / 2, 480 / 23 / 2, 346 / 24 / 3, 359 / 26 / 3, 115 / 27 / 2, 195 / 28 / 2, 446 / 29 / 3, 439 / 30 / 2, 240 / 31 / 5, 357 / 32 / 2, 210 / 33 / 2, 382 / 34 / 2, 413 / 35 / 4, 144 / 36 / 2, 232 / 37 / 2, 169 / 38 / 3, 305 / 39 / 2, 341 / 40 / 2, 468 / 41 / 2, 317 / 42 / 2, 194 / 43 / 2, 36 / 46 / 3, 225 / 47 / 2, 465 / 48 / 3, 84 / 49 / 2, 179 / 50 / 3, 226 / 51 / 2, 120 / 52 / 2, 369 / 53 / 4, 172 / 54 / 2, 90 / 55 / 2, 148 / 56 / 2, 333 / 57 / 3, 77 / 58 / 2, 391 / 59 / 5, 178 / 60 / 2, 314 / 61 / 2, 216 / 62 / 2, 233 / 63 / 2, 138 / 64 / 2, 154 / 65 / 2, 71 / 66 / 3, 53 / 67 / 2, 35 / 68 / 4, 262 / 69 / 2, 264 / 70 / 2, 259 / 71 / 2, 353 / 72 / 3, 304 / 73 / 2, 59 / 74 / 4, 101 / 75 / 2, 202 / 76 / 2, 497 / 77 / 2, 150 / 78 / 2, 158 / 79 / 2, 401 / 80 / 3, 283 / 81 / 2, 102 / 82 / 3, 211 / 83 / 2, 327 / 84 / 3, 444 / 85 / 2, 376 / 86 / 2, 405 / 87 / 2, 26 / 88 / 2, 160 / 89 / 2, 228 / 91 / 3, 130 / 92 / 2, 277 / 93 / 3, 13 / 94 / 2, 173 / 95 / 2, 469 / 96 / 3, 57 / 97 / 2, 39 / 99 / 2, 354 / 100 / 8, 51 / 101 / 2, 123 / 104 / 2, 261 / 105 / 2, 310 / 106 / 2, 437 / 108 / 2, 320 / 109 / 2, 95 / 110 / 2, 93 / 111 / 2, 55 / 112 / 4, 399 / 113 / 2, 322 / 115 / 3, 197 / 116 / 2, 76 / 117 / 4, 289 / 118 / 2, 356 / 119 / 3, 274 / 120 / 2, 181 / 121 / 2, 338 / 122 / 2, 471 / 123 / 3, 386 / 124 / 2, 131 / 125 / 2, 161 / 128 / 3, 298 / 129 / 2, 379 / 130 / 3, 438 / 131 / 2, 203 / 132 / 3, 452 / 133 / 2, 107 / 134 / 2, 75 / 135 / 3, 116 / 136 / 2, 237 / 137 / 5, 165 / 138 / 2, 171 / 139 / 3, 22 / 140 / 2, 434 / 141 / 3, 445 / 142 / 2, 301 / 143 / 3, 63 / 146 / 2, 285 / 147 / 2, 86 / 148 / 8, 308 / 149 / 2, 422 / 150 / 3, 99 / 151 / 2, 493 / 152 / 2, 66 / 153 / 3, 215 / 154 / 2, 155 / 155 / 2, 282 / 156 / 3, 245 / 157 / 2, 258 / 158 / 2, 184 / 159 / 2, 475 / 160 / 2, 451 / 161 / 2, 42 / 162 / 3, 484 / 163 / 2, 124 / 164 / 3, 470 / 165 / 2, 299 / 166 / 3, 343 / 167 / 2, 9 / 168 / 2, 316 / 169 / 3, 297 / 170 / 2, 342 / 171 / 3, 121 / 172 / 2, 117 / 173 / 2, 208 / 174 / 4, 80 / 175 / 2, 368 / 176 / 2, 312 / 177 / 3, 61 / 180 / 3, 275 / 181 / 2, 330 / 182 / 3, 45 / 183 / 2, 141 / 184 / 3, 220 / 185 / 2, 50 / 186 / 2, 306 / 187 / 3, 246 / 188 / 2, 385 / 189 / 2, 494 / 190 / 2, 431 / 191 / 5, 295 / 192 / 2, 91 / 193 / 2, 114 / 194 / 2, 454 / 195 / 4, 157 / 196 / 2, 373 / 197 / 2, 44 / 198 / 4, 409 / 199 / 2, 119 / 201 / 2, 88 / 202 / 4, 402 / 203 / 2, 186 / 205 / 2, 229 / 206 / 2, 408 / 207 / 2, 234 / 208 / 2, 404 / 209 / 2, 56 / 210 / 4, 263 / 211 / 2, 149 / 212 / 3, 151 / 213 / 2, 324 / 214 / 2, 276 / 215 / 4, 482 / 216 / 2, 496 / 218 / 4, 189 / 219 / 2, 459 / 220 / 2, 209 / 221 / 2, 64 / 222 / 2, 388 / 223 / 3, 479 / 224 / 2, 416 / 225 / 3, 72 / 226 / 2, 176 / 227 / 3, 326 / 228 / 2, 196 / 229 / 2, 65 / 230 / 5, 481 / 231 / 2, 126 / 232 / 2, 490 / 233 / 2, 249 / 234 / 3, 287 / 237 / 3, 218 / 238 / 2, 450 / 239 / 2, 129 / 240 / 4, 345 / 241 / 2, 498 / 242 / 2, 177 / 243 / 3, 303 / 244 / 2, 125 / 245 / 3, 162 / 246 / 2, 321 / 247 / 2, 74 / 248 / 2, 213 / 249 / 2, 334 / 250 / 2, 384 / 253 / 2, 325 / 254 / 3, 206 / 255 / 2, 212 / 256 / 3, 268 / 259 / 2, 428 / 260 / 3, 67 / 261 / 2, 486 / 262 / 2, 79 / 263 / 2, 453 / 264 / 2, 190 / 265 / 4, 257 / 266 / 2, 127 / 267 / 2, 128 / 268 / 4, 344 / 269 / 2, 230 / 271 / 2, 73 / 272 / 2, 270 / 273 / 3, 185 / 274 / 2, 375 / 275 / 2, 47 / 276 / 3, 449 / 277 / 2, 315 / 278 / 3, 460 / 279 / 2, 110 / 280 / 3, 89 / 281 / 2, 23 / 282 / 3, 238 / 283 / 2, 135 / 284 / 2, 266 / 285 / 2, 256 / 286 / 2, 430 / 287 / 2, 205 / 288 / 3, 166 / 289 / 2, 420 / 290 / 5, 112 / 291 / 2, 43 / 292 / 2, 37 / 293 / 2, 191 / 294 / 5, 426 / 295 / 2, 363 / 296 / 3, 49 / 297 / 2, 34 / 299 / 2, 146 / 300 / 2, 279 / 301 / 3, 436 / 302 / 2, 247 / 303 / 2, 392 / 304 / 2, 273 / 305 / 5, 293 / 306 / 2, 302 / 307 / 2, 269 / 308 / 2, 147 / 309 / 3, 323 / 310 / 2, 109 / 311 / 2, 271 / 312 / 2, 311 / 313 / 2, 423 / 314 / 2, 231 / 315 / 3, 174 / 316 / 2, 366 / 317 / 4, 447 / 318 / 2, 239 / 319 / 2, 294 / 320 / 3, 105 / 321 / 2, 492 / 322 / 3, 284 / 323 / 2, 244 / 324 / 2, 235 / 325 / 2, 291 / 326 / 3, 5 / 327 / 2, 364 / 328 / 7, 251 / 329 / 2, 118 / 330 / 2, 350 / 331 / 2, 499 / 332 / 3, 70 / 333 / 2, 406 / 334 / 3, 340 / 336 / 2, 58 / 337 / 4, 164 / 338 / 2, 168 / 339 / 2, 462 / 340 / 2, 255 / 341 / 2, 400 / 342 / 3, 85 / 343 / 2, 339 / 346 / 2, 8 / 347 / 3, 17 / 348 / 2, 241 / 349 / 3, 153 / 350 / 2, 390 / 351 / 2, 78 / 352 / 3, 374 / 353 / 2, 12 / 354 / 3, 351 / 355 / 2, 180 / 356 / 2, 296 / 357 / 4, 286 / 358 / 2, 223 / 359 / 2, 491 / 360 / 3, 199 / 361 / 2, 360 / 362 / 3, 395 / 363 / 2, 358 / 364 / 3, 348 / 365 / 2, 371 / 366 / 2, 281 / 367 / 3, 145 / 368 / 2, 187 / 369 / 2, 457 / 370 / 2, 349 / 371 / 4, 20 / 374 / 4, 132 / 375 / 2, 152 / 376 / 3, 253 / 377 / 2, 414 / 378 / 3, 137 / 379 / 2, 81 / 380 / 2, 82 / 381 / 2, 292 / 382 / 2, 104 / 383 / 3, 332 / 384 / 2, 10 / 385 / 2, 19 / 386 / 2, 106 / 387 / 2, 367 / 388 / 2, 477 / 389 / 2, 300 / 390 / 2, 4 / 391 / 2, 280 / 392 / 2, 352 / 393 / 2, 170 / 394 / 2, 387 / 395 / 2, 260 / 396 / 3, 97 / 397 / 2, 278 / 398 / 3, 41 / 399 / 2, 227 / 400 / 2, 472 / 401 / 2, 68 / 402 / 2, 201 / 403 / 2, 458 / 405 / 4, 483 / 406 / 2, 133 / 407 / 2, 398 / 408 / 3, 52 / 409 / 2, 167 / 410 / 3, 265 / 411 / 2, 183 / 413 / 3, 103 / 414 / 2, 3 / 415 / 2, 435 / 416 / 2, 442 / 417 / 2, 318 / 418 / 2, 309 / 419 / 2, 24 / 420 / 2, 335 / 421 / 2, 425 / 422 / 2, 96 / 423 / 2, 448 / 424 / 2, 288 / 425 / 2, 336 / 429 / 3, 30 / 430 / 2, 429 / 431 / 3, 27 / 432 / 2, 163 / 433 / 2, 380 / 434 / 3, 378 / 435 / 2, 69 / 436 / 2, 394 / 437 / 3, 407 / 438 / 2, 2 / 439 / 3, 433 / 442 / 3, 207 / 443 / 2, 111 / 444 / 3, 415 / 445 / 2, 467 / 446 / 2, 267 / 447 / 2, 92 / 448 / 2, 224 / 449 / 2, 21 / 450 / 2, 455 / 451 / 3, 383 / 452 / 2, 432 / 453 / 3, 159 / 454 / 2, 474 / 455 / 2, 466 / 456 / 3, 204 / 457 / 2, 214 / 459 / 3, 87 / 460 / 2, 222 / 461 / 2, 412 / 462 / 2, 370 / 463 / 3, 443 / 464 / 2, 182 / 465 / 3, 319 / 466 / 2, 122 / 467 / 2, 381 / 468 / 3, 254 / 469 / 2, 252 / 470 / 2, 397 / 471 / 3, 136 / 472 / 2, 365 / 473 / 2, 156 / 474 / 2, 473 / 475 / 3, 495 / 476 / 2, 217 / 477 / 2, 18 / 478 / 2, 487 / 479 / 2, 419 / 480 / 2, 25 / 481 / 2, 200 / 482 / 3, 393 / 483 / 2, 142 / 484 / 2, 331 / 485 / 3, 192 / 486 / 2, 243 / 487 / 2, 193 / 488 / 3, 94 / 489 / 2, 418 / 490 / 2, 489 / 493 / 3, 11 / 494 / 2, 290 / 495 / 2, 62 / 496 / 2, 362 / 497 / 2, 219 / 498 / 2, 60 / 499 / 2
uniform-alpha_1-80-n50.txt, 1, 1, 50, 572.854, 375, 325, 5, 49,7 / 1 / 2, 48 / 2 / 3, 6 / 3 / 2, 35 / 4 / 3, 27 / 5 / 2, 25 / 6 / 2, 20 / 7 / 2, 15 / 8 / 3, 26 / 9 / 2, 36 / 10 / 2, 14 / 11 / 3, 2 / 12 / 2, 29 / 13 / 2, 18 / 14 / 4, 31 / 15 / 2, 9 / 16 / 2, 10 / 17 / 4, 21 / 18 / 2, 47 / 19 / 3, 8 / 20 / 2, 4 / 21 / 2, 40 / 22 / 3, 3 / 23 / 2, 16 / 24 / 2, 17 / 25 / 3, 42 / 26 / 2, 1 / 27 / 3, 5 / 28 / 2, 37 / 29 / 3, 11 / 30 / 2, 12 / 31 / 2, 41 / 32 / 4, 44 / 33 / 2, 45 / 34 / 2, 23 / 35 / 2, 19 / 36 / 5, 33 / 37 / 2, 30 / 38 / 3, 24 / 39 / 2, 38 / 40 / 2, 39 / 41 / 2, 34 / 42 / 4, 43 / 43 / 2, 49 / 44 / 2, 22 / 45 / 3, 13 / 46 / 2, 28 / 47 / 3, 32 / 48 / 2, 46 / 49 / 4
uniform-alpha_1-81-n75.txt, 1, 1, 75, 725.13, 545, 470, 6, 73,2 / 1 / 2, 41 / 2 / 2, 8 / 3 / 3, 52 / 4 / 2, 12 / 5 / 2, 39 / 6 / 3, 50 / 7 / 2, 22 / 8 / 3, 42 / 9 / 2, 9 / 10 / 2, 62 / 11 / 4, 36 / 12 / 2, 45 / 13 / 2, 3 / 14 / 3, 60 / 15 / 2, 15 / 16 / 3, 53 / 17 / 2, 56 / 18 / 2, 64 / 19 / 3, 51 / 20 / 2, 68 / 21 / 4, 71 / 22 / 2, 73 / 23 / 2, 20 / 24 / 3, 1 / 25 / 2, 66 / 26 / 2, 69 / 27 / 3, 48 / 28 / 2, 46 / 29 / 3, 55 / 30 / 2, 17 / 31 / 2, 18 / 32 / 2, 19 / 33 / 6, 40 / 34 / 2, 25 / 35 / 2, 34 / 36 / 3, 11 / 37 / 2, 58 / 38 / 4, 65 / 39 / 2, 5 / 40 / 2, 47 / 41 / 3, 38 / 42 / 2, 24 / 43 / 2, 32 / 44 / 3, 57 / 45 / 2, 59 / 46 / 2, 29 / 47 / 3, 54 / 48 / 2, 35 / 49 / 2, 26 / 50 / 2, 13 / 51 / 2, 27 / 52 / 2, 10 / 53 / 2, 61 / 54 / 3, 70 / 55 / 2, 14 / 56 / 2, 23 / 57 / 2, 63 / 58 / 2, 7 / 59 / 2, 44 / 60 / 2, 30 / 61 / 2, 49 / 63 / 2, 21 / 64 / 2, 43 / 65 / 3, 33 / 66 / 2, 74 / 67 / 2, 4 / 68 / 3, 28 / 69 / 2, 72 / 70 / 3, 31 / 71 / 2, 67 / 72 / 2, 37 / 73 / 2, 16 / 74 / 2
uniform-alpha_1-82-n75.txt, 1, 1, 75, 649.377, 522, 447, 6, 72,64 / 1 / 2, 23 / 2 / 3, 69 / 3 / 2, 40 / 4 / 3, 66 / 5 / 2, 32 / 6 / 2, 29 / 7 / 2, 58 / 10 / 2, 27 / 11 / 6, 24 / 12 / 2, 54 / 13 / 2, 72 / 14 / 2, 3 / 15 / 2, 55 / 16 / 2, 67 / 17 / 3, 20 / 18 / 2, 45 / 19 / 2, 2 / 20 / 3, 50 / 21 / 2, 48 / 22 / 2, 10 / 23 / 2, 35 / 24 / 2, 73 / 25 / 4, 46 / 26 / 2, 53 / 27 / 2, 39 / 28 / 2, 36 / 29 / 3, 37 / 30 / 2, 16 / 31 / 3, 18 / 32 / 2, 47 / 33 / 3, 52 / 34 / 2, 41 / 35 / 3, 5 / 36 / 2, 26 / 37 / 3, 38 / 38 / 2, 44 / 39 / 2, 33 / 40 / 4, 70 / 41 / 2, 56 / 42 / 2, 14 / 43 / 4, 9 / 44 / 2, 30 / 45 / 2, 11 / 46 / 3, 61 / 47 / 2, 68 / 48 / 3, 15 / 49 / 2, 71 / 50 / 3, 8 / 51 / 2, 6 / 52 / 3, 31 / 53 / 2, 7 / 54 / 2, 62 / 55 / 2, 34 / 56 / 4, 28 / 57 / 2, 43 / 58 / 3, 12 / 59 / 2, 1 / 60 / 2, 65 / 61 / 2, 42 / 62 / 2, 60 / 63 / 2, 57 / 64 / 3, 4 / 65 / 2, 74 / 66 / 3, 13 / 67 / 2, 25 / 68 / 2, 49 / 69 / 2, 19 / 70 / 2, 51 / 71 / 2, 17 / 72 / 3, 21 / 73 / 2, 63 / 74 / 3
uniform-alpha_1-83-n75.txt, 1, 1, 75, 784.564, 505, 430, 4, 71,52 / 1 / 4, 70 / 2 / 2, 55 / 3 / 2, 12 / 4 / 3, 49 / 5 / 2, 24 / 6 / 2, 47 / 7 / 4, 53 / 9 / 2, 30 / 10 / 3, 71 / 11 / 2, 26 / 12 / 2, 22 / 13 / 2, 58 / 14 / 3, 23 / 15 / 2, 7 / 16 / 3, 37 / 17 / 2, 28 / 18 / 2, 14 / 19 / 2, 62 / 20 / 2, 25 / 21 / 3, 29 / 22 / 2, 36 / 23 / 2, 4 / 24 / 2, 16 / 25 / 4, 63 / 26 / 2, 21 / 27 / 2, 44 / 28 / 2, 39 / 29 / 2, 46 / 30 / 4, 3 / 31 / 2, 5 / 32 / 2, 74 / 33 / 2, 18 / 34 / 3, 57 / 35 / 2, 41 / 36 / 2, 35 / 37 / 2, 43 / 38 / 4, 72 / 39 / 2, 68 / 40 / 2, 10 / 43 / 2, 64 / 44 / 4, 9 / 45 / 2, 59 / 46 / 2, 61 / 47 / 4, 67 / 48 / 2, 31 / 49 / 2, 40 / 50 / 2, 2 / 51 / 4, 54 / 52 / 2, 60 / 53 / 2, 66 / 54 / 2, 48 / 55 / 2, 17 / 56 / 2, 34 / 57 / 2, 8 / 58 / 3, 42 / 59 / 2, 69 / 60 / 4, 51 / 61 / 2, 11 / 62 / 3, 15 / 63 / 2, 32 / 64 / 3, 1 / 65 / 2, 38 / 66 / 3, 27 / 67 / 2, 50 / 68 / 2, 6 / 69 / 2, 65 / 70 / 2, 73 / 71 / 2, 45 / 72 / 2, 13 / 73 / 2, 56 / 74 / 3
uniform-alpha_1-84-n75.txt, 1, 1, 75, 722.217, 523, 448, 4, 74,53 / 1 / 2, 16 / 2 / 2, 61 / 3 / 2, 9 / 4 / 2, 37 / 5 / 2, 36 / 6 / 3, 30 / 7 / 2, 69 / 8 / 2, 38 / 9 / 2, 60 / 10 / 3, 55 / 11 / 2, 26 / 12 / 2, 40 / 13 / 3, 28 / 14 / 2, 63 / 15 / 3, 58 / 16 / 2, 24 / 17 / 2, 71 / 18 / 3, 72 / 19 / 2, 54 / 20 / 2, 22 / 21 / 3, 8 / 22 / 2, 27 / 23 / 2, 59 / 24 / 2, 49 / 25 / 2, 34 / 26 / 2, 20 / 27 / 3, 52 / 28 / 2, 19 / 29 / 2, 47 / 30 / 2, 64 / 31 / 4, 5 / 32 / 2, 14 / 33 / 2, 42 / 34 / 2, 23 / 35 / 3, 48 / 36 / 2, 73 / 37 / 2, 65 / 38 / 2, 29 / 39 / 3, 1 / 40 / 2, 50 / 41 / 2, 74 / 42 / 4, 66 / 43 / 2, 3 / 44 / 3, 43 / 45 / 2, 17 / 46 / 2, 51 / 47 / 3, 35 / 48 / 2, 70 / 49 / 2, 18 / 50 / 2, 31 / 51 / 2, 2 / 52 / 3, 46 / 53 / 2, 12 / 54 / 4, 7 / 55 / 2, 15 / 56 / 2, 62 / 57 / 3, 67 / 58 / 2, 44 / 59 / 2, 56 / 60 / 4, 13 / 61 / 2, 39 / 62 / 2, 57 / 63 / 2, 11 / 64 / 2, 32 / 65 / 4, 4 / 66 / 2, 33 / 67 / 2, 68 / 68 / 4, 41 / 69 / 2, 45 / 70 / 3, 10 / 71 / 2, 6 / 72 / 2, 25 / 73 / 3, 21 / 74 / 2
uniform-alpha_1-85-n75.txt, 1, 1, 75, 760.852, 542, 467, 7, 72,44 / 1 / 2, 35 / 2 / 4, 21 / 3 / 2, 5 / 4 / 2, 54 / 5 / 3, 2 / 6 / 2, 38 / 7 / 2, 10 / 8 / 2, 48 / 9 / 3, 16 / 10 / 2, 18 / 11 / 2, 50 / 12 / 7, 33 / 13 / 2, 4 / 14 / 2, 12 / 15 / 2, 43 / 16 / 2, 27 / 17 / 2, 63 / 18 / 4, 62 / 19 / 2, 29 / 21 / 2, 37 / 22 / 2, 40 / 23 / 3, 14 / 24 / 2, 64 / 25 / 2, 65 / 26 / 2, 47 / 27 / 3, 73 / 28 / 2, 49 / 29 / 3, 60 / 30 / 2, 32 / 31 / 3, 1 / 32 / 2, 23 / 33 / 2, 15 / 34 / 2, 57 / 35 / 3, 36 / 36 / 2, 39 / 37 / 5, 45 / 38 / 2, 31 / 39 / 2, 34 / 40 / 2, 42 / 41 / 2, 69 / 42 / 2, 74 / 43 / 2, 66 / 44 / 2, 56 / 45 / 2, 53 / 46 / 3, 72 / 47 / 2, 7 / 49 / 2, 58 / 50 / 3, 19 / 51 / 2, 11 / 52 / 2, 30 / 53 / 2, 52 / 54 / 2, 24 / 55 / 2, 3 / 56 / 2, 28 / 57 / 2, 6 / 58 / 3, 51 / 59 / 2, 71 / 60 / 2, 20 / 61 / 2, 8 / 62 / 2, 41 / 63 / 3, 70 / 64 / 2, 17 / 65 / 3, 59 / 66 / 2, 55 / 67 / 2, 67 / 68 / 2, 22 / 69 / 2, 68 / 70 / 3, 26 / 71 / 2, 25 / 72 / 3, 46 / 73 / 2, 61 / 74 / 4
uniform-alpha_1-86-n75.txt, 1, 1, 75, 806.777, 515, 440, 5, 73,12 / 1 / 3, 59 / 2 / 2, 15 / 3 / 3, 16 / 4 / 2, 60 / 5 / 2, 20 / 6 / 3, 58 / 7 / 2, 55 / 8 / 2, 57 / 9 / 3, 27 / 10 / 2, 10 / 11 / 3, 25 / 12 / 2, 72 / 13 / 2, 67 / 14 / 4, 70 / 15 / 2, 50 / 16 / 2, 22 / 17 / 2, 36 / 18 / 2, 62 / 19 / 2, 52 / 20 / 2, 24 / 21 / 2, 69 / 22 / 4, 74 / 23 / 2, 2 / 24 / 2, 19 / 25 / 3, 3 / 26 / 2, 18 / 27 / 3, 48 / 28 / 2, 68 / 29 / 3, 73 / 31 / 2, 44 / 32 / 3, 45 / 33 / 2, 8 / 34 / 4, 9 / 35 / 2, 29 / 36 / 2, 23 / 37 / 3, 14 / 38 / 2, 28 / 39 / 3, 54 / 40 / 2, 30 / 41 / 2, 6 / 42 / 3, 1 / 43 / 2, 65 / 44 / 3, 63 / 45 / 2, 51 / 46 / 3, 38 / 47 / 2, 42 / 48 / 3, 7 / 49 / 2, 31 / 50 / 3, 33 / 51 / 2, 66 / 52 / 2, 39 / 53 / 4, 5 / 54 / 2, 47 / 55 / 2, 53 / 56 / 4, 13 / 57 / 2, 49 / 58 / 3, 26 / 59 / 2, 71 / 60 / 2, 35 / 61 / 2, 4 / 62 / 2, 40 / 63 / 2, 17 / 64 / 5, 11 / 65 / 2, 37 / 66 / 3, 64 / 67 / 2, 56 / 68 / 2, 61 / 69 / 3, 43 / 70 / 2, 32 / 71 / 2, 21 / 72 / 4, 46 / 73 / 2, 34 / 74 / 3
uniform-alpha_1-87-n75.txt, 1, 1, 75, 775.813, 502, 427, 4, 74,33 / 1 / 4, 63 / 2 / 2, 42 / 3 / 3, 26 / 4 / 2, 51 / 5 / 2, 52 / 6 / 2, 47 / 7 / 2, 29 / 8 / 2, 65 / 9 / 2, 15 / 10 / 4, 46 / 11 / 2, 56 / 12 / 2, 22 / 13 / 3, 74 / 14 / 2, 37 / 15 / 3, 49 / 16 / 2, 13 / 17 / 3, 66 / 18 / 2, 2 / 19 / 2, 40 / 20 / 3, 58 / 21 / 2, 19 / 22 / 3, 17 / 23 / 2, 64 / 24 / 2, 39 / 25 / 2, 28 / 26 / 3, 4 / 27 / 2, 54 / 28 / 2, 7 / 29 / 3, 30 / 30 / 2, 53 / 31 / 3, 34 / 32 / 2, 48 / 33 / 2, 20 / 34 / 4, 43 / 35 / 2, 71 / 36 / 2, 72 / 37 / 2, 69 / 38 / 3, 11 / 39 / 2, 25 / 40 / 2, 12 / 41 / 2, 31 / 42 / 2, 67 / 43 / 2, 38 / 44 / 2, 6 / 45 / 2, 70 / 46 / 4, 61 / 47 / 2, 3 / 48 / 2, 5 / 49 / 3, 23 / 50 / 2, 60 / 51 / 4, 45 / 52 / 2, 62 / 53 / 2, 57 / 54 / 2, 41 / 55 / 2, 18 / 56 / 2, 73 / 57 / 2, 50 / 58 / 2, 35 / 59 / 2, 10 / 60 / 4, 9 / 61 / 2, 16 / 62 / 2, 55 / 63 / 2, 59 / 64 / 3, 21 / 65 / 2, 14 / 66 / 2, 36 / 67 / 2, 1 / 68 / 3, 27 / 69 / 2, 68 / 70 / 2, 8 / 71 / 4, 24 / 72 / 2, 44 / 73 / 3, 32 / 74 / 2
uniform-alpha_1-88-n75.txt, 1, 1, 75, 762.182, 549, 474, 5, 74,55 / 1 / 3, 10 / 2 / 2, 47 / 3 / 4, 73 / 4 / 2, 53 / 5 / 2, 48 / 6 / 4, 52 / 7 / 2, 35 / 8 / 2, 29 / 9 / 2, 59 / 10 / 4, 70 / 11 / 2, 66 / 12 / 3, 23 / 13 / 2, 21 / 14 / 5, 56 / 15 / 2, 18 / 16 / 3, 37 / 17 / 2, 44 / 18 / 2, 16 / 19 / 2, 14 / 20 / 3, 61 / 21 / 2, 8 / 22 / 4, 43 / 23 / 2, 20 / 24 / 2, 12 / 25 / 3, 64 / 26 / 2, 69 / 27 / 2, 1 / 28 / 2, 5 / 29 / 4, 68 / 30 / 2, 25 / 31 / 2, 24 / 32 / 2, 4 / 33 / 2, 27 / 34 / 2, 2 / 35 / 2, 71 / 36 / 2, 72 / 37 / 2, 30 / 38 / 2, 6 / 39 / 3, 65 / 40 / 2, 36 / 41 / 2, 15 / 42 / 2, 3 / 43 / 2, 60 / 44 / 5, 13 / 45 / 2, 54 / 46 / 2, 26 / 47 / 3, 17 / 48 / 2, 39 / 49 / 2, 42 / 50 / 2, 9 / 51 / 2, 7 / 52 / 2, 40 / 53 / 2, 63 / 54 / 2, 31 / 55 / 3, 22 / 56 / 2, 74 / 57 / 2, 46 / 58 / 5, 34 / 59 / 2, 58 / 60 / 3, 50 / 61 / 2, 67 / 62 / 4, 45 / 63 / 2, 28 / 64 / 2, 62 / 65 / 2, 32 / 66 / 2, 57 / 67 / 2, 41 / 68 / 3, 38 / 69 / 2, 51 / 70 / 2, 11 / 71 / 2, 33 / 72 / 3, 19 / 73 / 2, 49 / 74 / 2
uniform-alpha_1-89-n75.txt, 1, 1, 75, 692.159, 574, 499, 6, 66,3 / 1 / 5, 38 / 2 / 2, 44 / 5 / 3, 6 / 6 / 2, 25 / 7 / 4, 8 / 8 / 2, 69 / 9 / 2, 9 / 10 / 4, 56 / 11 / 2, 14 / 12 / 2, 24 / 13 / 2, 63 / 14 / 5, 2 / 17 / 3, 4 / 18 / 2, 51 / 19 / 3, 29 / 20 / 2, 15 / 21 / 3, 60 / 22 / 2, 18 / 23 / 3, 33 / 24 / 2, 36 / 25 / 2, 50 / 26 / 2, 10 / 27 / 3, 72 / 28 / 2, 12 / 29 / 3, 26 / 30 / 2, 11 / 31 / 2, 61 / 32 / 3, 74 / 35 / 3, 55 / 36 / 2, 64 / 37 / 3, 27 / 38 / 2, 70 / 39 / 3, 58 / 40 / 2, 30 / 41 / 3, 40 / 42 / 2, 19 / 43 / 2, 49 / 44 / 4, 41 / 45 / 2, 1 / 46 / 2, 22 / 47 / 2, 37 / 48 / 4, 23 / 50 / 2, 62 / 51 / 4, 20 / 52 / 2, 66 / 53 / 2, 65 / 54 / 6, 34 / 55 / 2, 46 / 56 / 3, 7 / 57 / 2, 45 / 58 / 3, 31 / 59 / 2, 73 / 60 / 2, 17 / 61 / 3, 39 / 62 / 2, 47 / 64 / 2, 5 / 65 / 4, 28 / 66 / 2, 59 / 67 / 2, 53 / 68 / 5, 52 / 69 / 2, 67 / 70 / 2, 54 / 71 / 4, 42 / 72 / 2, 21 / 73 / 2, 68 / 74 / 3
uniform-alpha_1-9-n250.txt, 1, 1, 250, 1370.78, 1754, 1504, 6, 231,157 / 1 / 3, 246 / 2 / 2, 69 / 3 / 3, 249 / 4 / 2, 28 / 5 / 2, 196 / 6 / 2, 58 / 9 / 4, 34 / 10 / 2, 172 / 11 / 2, 206 / 12 / 2, 198 / 13 / 4, 78 / 14 / 2, 96 / 15 / 2, 233 / 16 / 3, 5 / 17 / 2, 50 / 19 / 2, 19 / 20 / 3, 41 / 21 / 2, 89 / 22 / 2, 247 / 23 / 2, 70 / 24 / 3, 135 / 25 / 2, 150 / 26 / 3, 184 / 29 / 3, 194 / 30 / 2, 165 / 31 / 3, 248 / 32 / 2, 15 / 33 / 3, 66 / 34 / 2, 168 / 35 / 2, 117 / 36 / 2, 129 / 37 / 4, 108 / 38 / 2, 238 / 39 / 2, 113 / 40 / 4, 11 / 41 / 2, 236 / 42 / 3, 106 / 44 / 5, 225 / 45 / 2, 189 / 46 / 2, 118 / 47 / 2, 121 / 48 / 5, 179 / 49 / 2, 205 / 50 / 2, 187 / 51 / 2, 44 / 52 / 3, 128 / 53 / 2, 100 / 54 / 2, 229 / 55 / 2, 32 / 56 / 2, 232 / 57 / 2, 180 / 58 / 2, 59 / 59 / 2, 46 / 60 / 3, 209 / 61 / 2, 76 / 62 / 3, 73 / 63 / 2, 199 / 64 / 3, 95 / 66 / 3, 174 / 68 / 3, 167 / 69 / 2, 77 / 70 / 2, 222 / 71 / 2, 83 / 72 / 3, 18 / 73 / 2, 166 / 74 / 3, 191 / 75 / 2, 110 / 76 / 3, 220 / 78 / 2, 68 / 79 / 2, 103 / 80 / 5, 155 / 81 / 2, 123 / 82 / 2, 125 / 83 / 2, 149 / 84 / 3, 115 / 85 / 2, 37 / 86 / 2, 86 / 87 / 2, 22 / 88 / 2, 7 / 89 / 4, 29 / 90 / 2, 185 / 91 / 3, 207 / 92 / 2, 63 / 93 / 2, 21 / 94 / 3, 90 / 95 / 2, 173 / 96 / 2, 35 / 97 / 2, 237 / 98 / 3, 36 / 99 / 2, 116 / 100 / 2, 171 / 101 / 2, 24 / 102 / 2, 245 / 103 / 2, 201 / 104 / 2, 105 / 105 / 2, 136 / 106 / 3, 72 / 107 / 2, 241 / 108 / 2, 67 / 109 / 3, 156 / 110 / 2, 99 / 111 / 3, 163 / 112 / 2, 219 / 113 / 3, 243 / 114 / 2, 49 / 115 / 2, 192 / 116 / 2, 42 / 117 / 2, 170 / 118 / 3, 101 / 121 / 3, 43 / 122 / 2, 84 / 123 / 2, 158 / 124 / 2, 176 / 125 / 2, 134 / 126 / 2, 144 / 127 / 6, 92 / 128 / 2, 221 / 129 / 2, 147 / 130 / 3, 188 / 131 / 2, 137 / 132 / 4, 213 / 133 / 2, 182 / 134 / 2, 126 / 135 / 3, 60 / 136 / 2, 17 / 137 / 3, 212 / 138 / 2, 244 / 139 / 3, 48 / 140 / 2, 159 / 141 / 3, 203 / 142 / 2, 186 / 143 / 2, 132 / 144 / 2, 169 / 145 / 3, 20 / 146 / 2, 30 / 147 / 3, 9 / 148 / 2, 210 / 149 / 3, 111 / 150 / 2, 216 / 151 / 2, 195 / 152 / 3, 142 / 153 / 2, 160 / 154 / 3, 39 / 155 / 2, 224 / 156 / 2, 74 / 157 / 3, 162 / 158 / 2, 81 / 159 / 2, 40 / 160 / 3, 82 / 161 / 2, 91 / 162 / 3, 177 / 163 / 2, 94 / 164 / 3, 97 / 165 / 2, 183 / 166 / 2, 217 / 167 / 3, 223 / 168 / 2, 114 / 169 / 2, 124 / 170 / 2, 16 / 171 / 2, 178 / 172 / 2, 62 / 173 / 2, 71 / 174 / 2, 2 / 175 / 2, 193 / 176 / 3, 141 / 177 / 2, 242 / 178 / 2, 51 / 179 / 3, 1 / 180 / 2, 227 / 181 / 3, 88 / 184 / 3, 234 / 185 / 2, 87 / 186 / 3, 138 / 187 / 2, 64 / 188 / 2, 145 / 189 / 2, 208 / 190 / 3, 45 / 191 / 2, 214 / 192 / 3, 54 / 193 / 2, 154 / 194 / 3, 93 / 195 / 2, 31 / 196 / 6, 133 / 197 / 2, 175 / 198 / 2, 109 / 199 / 2, 85 / 200 / 3, 27 / 201 / 2, 119 / 202 / 2, 202 / 203 / 4, 12 / 204 / 2, 107 / 205 / 3, 98 / 206 / 2, 112 / 208 / 2, 235 / 209 / 2, 47 / 210 / 2, 181 / 211 / 3, 13 / 212 / 2, 52 / 213 / 2, 230 / 214 / 4, 55 / 216 / 2, 65 / 217 / 3, 190 / 218 / 2, 152 / 219 / 3, 56 / 220 / 2, 143 / 221 / 2, 10 / 222 / 2, 4 / 223 / 2, 120 / 224 / 2, 14 / 225 / 2, 211 / 226 / 3, 228 / 227 / 2, 53 / 228 / 3, 215 / 229 / 2, 127 / 230 / 3, 79 / 231 / 2, 151 / 232 / 3, 239 / 233 / 2, 26 / 234 / 4, 23 / 235 / 2, 146 / 236 / 2, 148 / 237 / 2, 153 / 238 / 4, 226 / 239 / 2, 8 / 242 / 5, 102 / 243 / 2, 139 / 244 / 2, 80 / 245 / 2, 104 / 247 / 2, 240 / 248 / 4, 218 / 249 / 2
uniform-alpha_1-9-n5.txt, 1, 1, 5, 232.434, 18, 13, 3, 4,2 / 1 / 3, 3 / 2 / 2, 1 / 3 / 3, 4 / 4 / 2
uniform-alpha_1-9-n500.txt, 1, 1, 500, 1835.32, 3478, 2978, 6, 458,90 / 1 / 2, 345 / 2 / 3, 38 / 3 / 2, 99 / 4 / 2, 125 / 5 / 2, 160 / 6 / 3, 411 / 7 / 2, 127 / 8 / 2, 395 / 9 / 3, 438 / 10 / 2, 236 / 11 / 4, 343 / 12 / 2, 194 / 13 / 2, 243 / 14 / 3, 177 / 17 / 2, 321 / 18 / 2, 363 / 19 / 2, 442 / 20 / 2, 155 / 21 / 2, 93 / 22 / 2, 422 / 23 / 2, 483 / 24 / 2, 139 / 25 / 2, 207 / 26 / 3, 479 / 27 / 2, 266 / 28 / 3, 290 / 29 / 2, 471 / 30 / 2, 493 / 31 / 2, 44 / 32 / 2, 149 / 33 / 3, 28 / 34 / 2, 423 / 35 / 2, 454 / 36 / 2, 60 / 37 / 3, 205 / 38 / 2, 275 / 39 / 2, 262 / 40 / 4, 348 / 41 / 2, 274 / 42 / 3, 339 / 43 / 2, 486 / 44 / 2, 231 / 45 / 3, 25 / 46 / 2, 461 / 47 / 2, 324 / 48 / 3, 341 / 49 / 2, 300 / 50 / 3, 5 / 51 / 2, 132 / 52 / 4, 31 / 53 / 2, 54 / 54 / 2, 498 / 55 / 2, 491 / 56 / 2, 80 / 57 / 2, 163 / 58 / 2, 186 / 59 / 3, 217 / 60 / 2, 75 / 61 / 2, 58 / 62 / 4, 369 / 63 / 2, 371 / 64 / 3, 110 / 65 / 2, 181 / 66 / 3, 117 / 67 / 2, 175 / 68 / 2, 52 / 69 / 2, 224 / 70 / 3, 394 / 71 / 2, 199 / 72 / 3, 196 / 73 / 2, 47 / 74 / 2, 376 / 75 / 3, 218 / 76 / 2, 430 / 77 / 2, 30 / 78 / 2, 86 / 79 / 2, 480 / 80 / 3, 379 / 81 / 2, 362 / 82 / 3, 3 / 83 / 2, 239 / 84 / 2, 367 / 85 / 3, 66 / 88 / 3, 8 / 91 / 4, 118 / 92 / 2, 441 / 93 / 2, 246 / 94 / 2, 79 / 95 / 2, 15 / 96 / 2, 219 / 97 / 2, 17 / 98 / 3, 307 / 99 / 2, 168 / 100 / 2, 129 / 101 / 2, 359 / 102 / 3, 410 / 103 / 2, 346 / 104 / 2, 235 / 107 / 4, 377 / 108 / 2, 318 / 109 / 2, 316 / 110 / 4, 143 / 111 / 2, 165 / 112 / 2, 59 / 113 / 3, 495 / 114 / 2, 306 / 115 / 3, 357 / 116 / 2, 279 / 117 / 4, 84 / 118 / 2, 81 / 119 / 3, 35 / 120 / 2, 374 / 121 / 3, 381 / 122 / 2, 142 / 123 / 3, 200 / 124 / 2, 292 / 125 / 3, 104 / 126 / 2, 228 / 127 / 3, 333 / 128 / 2, 180 / 129 / 2, 97 / 130 / 3, 53 / 131 / 2, 289 / 132 / 2, 167 / 133 / 2, 490 / 134 / 2, 415 / 135 / 2, 145 / 136 / 2, 204 / 137 / 2, 41 / 138 / 2, 257 / 139 / 2, 4 / 140 / 3, 85 / 141 / 2, 429 / 142 / 2, 420 / 143 / 2, 182 / 144 / 5, 34 / 145 / 2, 87 / 146 / 3, 111 / 147 / 2, 404 / 148 / 2, 62 / 149 / 3, 152 / 150 / 2, 222 / 151 / 5, 388 / 152 / 2, 465 / 153 / 3, 116 / 156 / 2, 474 / 157 / 3, 63 / 158 / 2, 477 / 159 / 3, 46 / 160 / 2, 188 / 161 / 3, 375 / 162 / 2, 64 / 163 / 2, 223 / 164 / 4, 390 / 165 / 2, 27 / 170 / 3, 183 / 171 / 2, 36 / 172 / 2, 398 / 173 / 2, 417 / 174 / 3, 331 / 175 / 2, 2 / 176 / 2, 151 / 177 / 2, 65 / 178 / 2, 364 / 179 / 3, 270 / 180 / 2, 448 / 181 / 2, 468 / 182 / 2, 18 / 183 / 3, 76 / 184 / 2, 184 / 185 / 2, 254 / 186 / 2, 445 / 187 / 2, 40 / 188 / 2, 271 / 189 / 2, 114 / 190 / 3, 298 / 191 / 2, 140 / 192 / 2, 386 / 193 / 3, 294 / 195 / 2, 419 / 196 / 4, 115 / 197 / 2, 120 / 199 / 2, 412 / 200 / 3, 276 / 201 / 2, 176 / 202 / 3, 385 / 203 / 2, 387 / 205 / 2, 413 / 206 / 3, 354 / 207 / 2, 314 / 208 / 2, 130 / 209 / 2, 320 / 210 / 3, 489 / 211 / 2, 20 / 212 / 2, 433 / 213 / 2, 179 / 214 / 2, 225 / 215 / 2, 278 / 216 / 2, 260 / 217 / 2, 32 / 218 / 2, 496 / 219 / 2, 13 / 220 / 2, 299 / 221 / 2, 405 / 222 / 2, 449 / 223 / 2, 161 / 224 / 2, 77 / 225 / 2, 250 / 226 / 2, 249 / 227 / 2, 261 / 228 / 2, 259 / 229 / 4, 214 / 230 / 2, 291 / 231 / 2, 94 / 232 / 4, 401 / 233 / 2, 72 / 235 / 4, 221 / 236 / 2, 447 / 237 / 3, 400 / 238 / 2, 242 / 239 / 2, 29 / 240 / 3, 154 / 241 / 2, 141 / 242 / 2, 251 / 243 / 2, 459 / 244 / 3, 263 / 247 / 2, 215 / 248 / 2, 344 / 249 / 2, 310 / 250 / 2, 96 / 251 / 3, 212 / 252 / 2, 303 / 253 / 3, 21 / 254 / 2, 211 / 255 / 2, 48 / 256 / 3, 462 / 257 / 2, 7 / 258 / 2, 311 / 259 / 2, 131 / 260 / 2, 391 / 261 / 3, 233 / 262 / 2, 464 / 263 / 2, 156 / 264 / 3, 98 / 265 / 2, 202 / 266 / 3, 482 / 267 / 2, 472 / 268 / 2, 88 / 269 / 2, 189 / 270 / 3, 407 / 271 / 2, 334 / 272 / 2, 209 / 273 / 3, 244 / 274 / 2, 487 / 275 / 3, 469 / 276 / 2, 335 / 277 / 3, 281 / 279 / 3, 280 / 280 / 2, 10 / 281 / 2, 444 / 282 / 3, 285 / 283 / 2, 406 / 284 / 2, 201 / 285 / 3, 232 / 287 / 2, 399 / 288 / 6, 229 / 289 / 2, 265 / 292 / 3, 238 / 293 / 2, 89 / 294 / 2, 273 / 295 / 4, 393 / 296 / 2, 258 / 297 / 2, 397 / 298 / 2, 358 / 299 / 2, 6 / 300 / 4, 312 / 301 / 2, 123 / 302 / 2, 457 / 303 / 3, 19 / 305 / 2, 191 / 306 / 2, 455 / 307 / 2, 45 / 308 / 2, 11 / 309 / 2, 172 / 310 / 3, 485 / 311 / 2, 484 / 312 / 3, 466 / 313 / 2, 220 / 316 / 4, 138 / 317 / 2, 106 / 318 / 2, 409 / 319 / 2, 234 / 320 / 4, 352 / 321 / 2, 197 / 322 / 2, 101 / 323 / 3, 245 / 325 / 4, 216 / 326 / 2, 402 / 327 / 2, 82 / 328 / 2, 497 / 329 / 2, 122 / 330 / 2, 12 / 331 / 3, 432 / 332 / 2, 230 / 333 / 2, 435 / 334 / 3, 67 / 335 / 2, 360 / 336 / 2, 372 / 337 / 3, 322 / 338 / 2, 100 / 339 / 2, 458 / 340 / 2, 473 / 341 / 3, 392 / 342 / 2, 71 / 343 / 2, 421 / 344 / 2, 16 / 345 / 4, 287 / 346 / 2, 253 / 347 / 2, 427 / 348 / 2, 61 / 349 / 3, 389 / 350 / 2, 284 / 351 / 2, 33 / 352 / 2, 327 / 353 / 2, 256 / 357 / 4, 187 / 358 / 2, 113 / 359 / 2, 49 / 360 / 2, 319 / 361 / 2, 342 / 362 / 2, 355 / 363 / 2, 308 / 364 / 3, 475 / 365 / 2, 9 / 366 / 4, 338 / 367 / 2, 492 / 368 / 2, 135 / 369 / 4, 446 / 370 / 2, 301 / 371 / 2, 193 / 372 / 2, 396 / 373 / 2, 467 / 374 / 2, 153 / 375 / 3, 255 / 376 / 2, 323 / 377 / 2, 336 / 378 / 2, 356 / 379 / 2, 23 / 380 / 2, 329 / 381 / 2, 252 / 382 / 2, 248 / 383 / 2, 267 / 384 / 2, 337 / 385 / 3, 169 / 386 / 2, 144 / 387 / 2, 456 / 388 / 2, 128 / 389 / 2, 373 / 390 / 2, 452 / 391 / 2, 297 / 392 / 2, 148 / 393 / 3, 293 / 394 / 2, 95 / 395 / 3, 384 / 396 / 2, 241 / 397 / 2, 347 / 398 / 3, 305 / 399 / 2, 380 / 400 / 2, 296 / 401 / 3, 240 / 402 / 2, 133 / 403 / 2, 150 / 404 / 3, 70 / 405 / 2, 134 / 406 / 2, 105 / 407 / 5, 453 / 408 / 2, 382 / 409 / 3, 112 / 410 / 2, 353 / 411 / 3, 166 / 412 / 2, 494 / 413 / 2, 277 / 414 / 2, 171 / 415 / 2, 37 / 416 / 3, 332 / 417 / 2, 203 / 418 / 2, 264 / 419 / 5, 414 / 420 / 2, 476 / 421 / 2, 226 / 422 / 2, 146 / 423 / 4, 315 / 424 / 2, 24 / 425 / 2, 227 / 426 / 2, 288 / 427 / 2, 434 / 428 / 2, 73 / 429 / 5, 103 / 430 / 2, 91 / 431 / 3, 137 / 433 / 3, 213 / 434 / 2, 39 / 435 / 2, 174 / 436 / 4, 309 / 437 / 2, 173 / 439 / 2, 463 / 440 / 3, 268 / 441 / 2, 190 / 442 / 3, 206 / 445 / 3, 425 / 446 / 2, 295 / 447 / 5, 51 / 448 / 2, 185 / 449 / 2, 26 / 452 / 2, 119 / 453 / 4, 57 / 454 / 2, 436 / 455 / 2, 451 / 456 / 2, 68 / 457 / 2, 157 / 458 / 2, 170 / 459 / 2, 317 / 460 / 3, 350 / 461 / 2, 431 / 462 / 2, 83 / 463 / 3, 368 / 464 / 2, 302 / 465 / 2, 481 / 466 / 2, 164 / 467 / 2, 22 / 468 / 4, 74 / 469 / 2, 56 / 470 / 2, 178 / 471 / 4, 428 / 472 / 2, 326 / 473 / 3, 210 / 474 / 2, 272 / 475 / 4, 304 / 476 / 2, 92 / 477 / 3, 208 / 478 / 2, 121 / 479 / 3, 108 / 482 / 2, 286 / 483 / 4, 14 / 486 / 4, 370 / 487 / 2, 237 / 488 / 2, 366 / 489 / 4, 440 / 490 / 2, 460 / 491 / 3, 365 / 492 / 2, 78 / 493 / 2, 439 / 494 / 4, 330 / 495 / 2, 418 / 496 / 2, 437 / 497 / 2, 408 / 498 / 5, 488 / 499 / 2
uniform-alpha_1-90-n75.txt, 1, 1, 75, 753.797, 581, 506, 8, 72,49 / 1 / 2, 45 / 2 / 4, 40 / 3 / 2, 61 / 4 / 2, 38 / 5 / 2, 7 / 6 / 2, 50 / 7 / 2, 53 / 8 / 3, 9 / 9 / 2, 42 / 10 / 2, 35 / 11 / 6, 55 / 12 / 2, 57 / 13 / 2, 47 / 14 / 3, 18 / 15 / 2, 22 / 16 / 2, 48 / 17 / 2, 72 / 18 / 8, 37 / 19 / 2, 68 / 20 / 2, 4 / 21 / 4, 17 / 22 / 2, 41 / 23 / 2, 65 / 24 / 4, 58 / 25 / 2, 25 / 26 / 2, 44 / 27 / 3, 30 / 28 / 2, 39 / 29 / 3, 51 / 30 / 2, 31 / 31 / 3, 15 / 32 / 2, 27 / 33 / 2, 60 / 34 / 2, 32 / 35 / 2, 8 / 36 / 3, 5 / 37 / 2, 54 / 38 / 2, 52 / 39 / 6, 33 / 40 / 2, 16 / 41 / 3, 66 / 42 / 2, 24 / 43 / 2, 69 / 44 / 2, 64 / 45 / 3, 70 / 46 / 2, 19 / 47 / 2, 20 / 48 / 2, 73 / 49 / 3, 56 / 50 / 2, 46 / 51 / 2, 3 / 52 / 3, 23 / 53 / 2, 29 / 54 / 3, 26 / 55 / 2, 14 / 56 / 2, 13 / 57 / 3, 6 / 58 / 2, 74 / 59 / 3, 43 / 60 / 2, 59 / 61 / 2, 11 / 62 / 2, 67 / 63 / 2, 2 / 64 / 2, 21 / 65 / 3, 28 / 67 / 3, 63 / 68 / 2, 34 / 69 / 3, 71 / 70 / 2, 12 / 71 / 2, 36 / 73 / 2, 1 / 74 / 6
uniform-alpha_1-91-n100.txt, 1, 1, 100, 833.381, 670, 570, 5, 99,11 / 1 / 4, 87 / 2 / 2, 52 / 3 / 3, 60 / 4 / 2, 26 / 5 / 2, 19 / 6 / 2, 48 / 7 / 2, 4 / 8 / 3, 38 / 9 / 2, 82 / 10 / 2, 65 / 11 / 3, 69 / 12 / 2, 5 / 13 / 3, 78 / 14 / 2, 14 / 15 / 3, 70 / 16 / 2, 49 / 17 / 2, 64 / 18 / 2, 75 / 19 / 3, 1 / 20 / 2, 42 / 21 / 2, 98 / 22 / 4, 66 / 23 / 2, 36 / 24 / 2, 67 / 25 / 2, 56 / 26 / 3, 29 / 27 / 2, 73 / 28 / 2, 17 / 29 / 3, 97 / 30 / 2, 30 / 31 / 3, 12 / 32 / 2, 18 / 33 / 3, 24 / 34 / 2, 46 / 35 / 3, 58 / 36 / 2, 28 / 37 / 2, 41 / 38 / 3, 83 / 39 / 2, 86 / 40 / 2, 53 / 41 / 3, 63 / 42 / 2, 34 / 43 / 2, 22 / 44 / 2, 50 / 45 / 5, 92 / 46 / 2, 90 / 47 / 2, 43 / 48 / 2, 79 / 49 / 3, 33 / 50 / 2, 59 / 51 / 3, 21 / 52 / 2, 76 / 53 / 2, 45 / 54 / 2, 3 / 55 / 2, 54 / 56 / 2, 74 / 57 / 2, 9 / 58 / 2, 20 / 59 / 3, 39 / 60 / 2, 61 / 61 / 2, 10 / 62 / 3, 95 / 63 / 2, 27 / 64 / 2, 91 / 65 / 3, 25 / 66 / 2, 55 / 67 / 2, 99 / 68 / 3, 6 / 69 / 2, 44 / 70 / 4, 35 / 71 / 2, 89 / 72 / 2, 85 / 73 / 3, 8 / 74 / 2, 68 / 75 / 3, 62 / 76 / 2, 84 / 77 / 4, 13 / 78 / 2, 88 / 79 / 3, 57 / 80 / 2, 40 / 81 / 2, 23 / 82 / 2, 47 / 83 / 3, 96 / 84 / 2, 81 / 85 / 2, 32 / 86 / 2, 77 / 87 / 2, 71 / 88 / 2, 37 / 89 / 2, 31 / 90 / 2, 16 / 91 / 2, 93 / 92 / 2, 7 / 93 / 3, 80 / 94 / 2, 2 / 95 / 3, 51 / 96 / 2, 15 / 97 / 3, 94 / 98 / 2, 72 / 99 / 2
uniform-alpha_1-92-n100.txt, 1, 1, 100, 783.357, 707, 607, 6, 97,86 / 1 / 3, 92 / 2 / 2, 56 / 3 / 2, 51 / 4 / 3, 6 / 5 / 2, 59 / 6 / 3, 46 / 7 / 2, 98 / 8 / 2, 49 / 9 / 4, 57 / 10 / 2, 2 / 11 / 3, 91 / 12 / 2, 72 / 13 / 2, 82 / 14 / 2, 52 / 15 / 2, 13 / 16 / 2, 20 / 17 / 3, 68 / 18 / 2, 70 / 19 / 3, 27 / 20 / 2, 88 / 21 / 2, 28 / 22 / 2, 16 / 23 / 2, 8 / 24 / 2, 48 / 25 / 2, 85 / 26 / 3, 29 / 27 / 2, 42 / 28 / 3, 45 / 29 / 2, 12 / 30 / 2, 73 / 31 / 3, 25 / 33 / 6, 23 / 34 / 2, 37 / 35 / 3, 55 / 36 / 2, 94 / 37 / 3, 19 / 38 / 2, 65 / 39 / 2, 61 / 40 / 3, 77 / 41 / 2, 40 / 42 / 2, 36 / 43 / 2, 79 / 44 / 2, 78 / 45 / 3, 22 / 46 / 2, 62 / 47 / 2, 14 / 48 / 2, 93 / 49 / 2, 58 / 50 / 3, 10 / 51 / 2, 9 / 52 / 2, 67 / 53 / 2, 97 / 54 / 3, 71 / 55 / 2, 66 / 56 / 2, 17 / 57 / 3, 43 / 58 / 2, 99 / 59 / 2, 5 / 60 / 4, 76 / 61 / 2, 30 / 62 / 3, 74 / 63 / 2, 35 / 64 / 2, 81 / 65 / 2, 31 / 66 / 2, 47 / 67 / 2, 83 / 68 / 3, 33 / 69 / 2, 21 / 70 / 2, 64 / 71 / 2, 1 / 72 / 2, 3 / 73 / 2, 69 / 74 / 2, 4 / 75 / 2, 75 / 76 / 2, 41 / 77 / 3, 63 / 78 / 2, 95 / 79 / 2, 84 / 80 / 3, 89 / 81 / 2, 39 / 82 / 3, 26 / 83 / 2, 11 / 84 / 3, 80 / 86 / 2, 90 / 87 / 4, 38 / 88 / 2, 87 / 89 / 2, 18 / 90 / 4, 60 / 91 / 2, 34 / 92 / 3, 53 / 93 / 2, 24 / 94 / 2, 44 / 95 / 2, 15 / 96 / 3, 7 / 97 / 2, 32 / 98 / 4, 54 / 99 / 2
uniform-alpha_1-93-n100.txt, 1, 1, 100, 814.641, 749, 649, 6, 98,68 / 1 / 2, 4 / 2 / 4, 63 / 3 / 2, 15 / 4 / 2, 83 / 5 / 2, 48 / 6 / 3, 42 / 8 / 2, 9 / 9 / 2, 81 / 10 / 3, 87 / 11 / 2, 38 / 12 / 2, 8 / 13 / 2, 76 / 14 / 3, 31 / 15 / 2, 88 / 16 / 3, 98 / 17 / 2, 77 / 18 / 3, 27 / 19 / 2, 45 / 20 / 3, 28 / 21 / 2, 70 / 22 / 2, 35 / 23 / 2, 51 / 24 / 2, 75 / 25 / 2, 52 / 26 / 2, 64 / 27 / 3, 69 / 28 / 2, 82 / 29 / 3, 66 / 30 / 2, 57 / 31 / 3, 24 / 32 / 2, 18 / 33 / 2, 17 / 34 / 2, 86 / 35 / 3, 58 / 36 / 2, 91 / 37 / 3, 6 / 38 / 2, 49 / 39 / 3, 20 / 40 / 2, 41 / 41 / 3, 67 / 42 / 2, 92 / 43 / 3, 74 / 44 / 2, 61 / 45 / 2, 23 / 46 / 2, 96 / 47 / 3, 46 / 48 / 2, 95 / 49 / 2, 29 / 50 / 2, 93 / 51 / 2, 53 / 52 / 5, 90 / 53 / 2, 11 / 54 / 3, 84 / 55 / 2, 80 / 56 / 3, 34 / 57 / 2, 1 / 58 / 3, 97 / 59 / 2, 50 / 60 / 2, 85 / 61 / 5, 13 / 62 / 2, 65 / 63 / 2, 14 / 64 / 3, 10 / 65 / 2, 56 / 66 / 3, 71 / 67 / 2, 73 / 68 / 3, 2 / 69 / 2, 39 / 70 / 2, 16 / 71 / 4, 22 / 72 / 2, 40 / 73 / 2, 54 / 74 / 3, 12 / 75 / 2, 79 / 76 / 2, 32 / 77 / 3, 5 / 78 / 2, 26 / 79 / 2, 99 / 80 / 2, 3 / 81 / 2, 59 / 82 / 3, 60 / 83 / 2, 7 / 84 / 2, 37 / 85 / 6, 94 / 86 / 2, 43 / 87 / 2, 44 / 88 / 2, 62 / 89 / 2, 21 / 90 / 4, 78 / 91 / 2, 25 / 92 / 2, 19 / 93 / 2, 47 / 94 / 2, 33 / 95 / 2, 89 / 96 / 3, 72 / 97 / 2, 36 / 98 / 3, 55 / 99 / 2
uniform-alpha_1-94-n100.txt, 1, 1, 100, 816.296, 699, 599, 5, 98,43 / 1 / 5, 97 / 2 / 2, 68 / 3 / 3, 87 / 4 / 2, 4 / 5 / 4, 37 / 6 / 2, 23 / 7 / 2, 45 / 8 / 2, 2 / 9 / 2, 30 / 10 / 2, 79 / 11 / 2, 65 / 12 / 3, 14 / 13 / 2, 80 / 14 / 2, 69 / 15 / 2, 90 / 16 / 2, 16 / 17 / 2, 50 / 18 / 3, 73 / 19 / 2, 85 / 20 / 3, 21 / 21 / 2, 1 / 22 / 3, 66 / 23 / 2, 92 / 24 / 2, 22 / 25 / 2, 95 / 26 / 2, 10 / 27 / 3, 86 / 28 / 2, 59 / 29 / 3, 52 / 30 / 2, 81 / 31 / 3, 77 / 32 / 2, 46 / 33 / 2, 41 / 34 / 2, 47 / 35 / 2, 42 / 36 / 2, 17 / 37 / 2, 18 / 38 / 3, 88 / 39 / 2, 58 / 40 / 2, 93 / 41 / 4, 74 / 42 / 2, 60 / 44 / 3, 29 / 45 / 2, 96 / 46 / 2, 48 / 47 / 3, 34 / 48 / 2, 8 / 49 / 3, 62 / 50 / 2, 56 / 51 / 2, 9 / 52 / 3, 19 / 53 / 2, 13 / 54 / 2, 55 / 55 / 2, 70 / 56 / 2, 64 / 57 / 2, 67 / 58 / 3, 71 / 59 / 2, 28 / 60 / 3, 26 / 61 / 2, 99 / 62 / 2, 40 / 63 / 4, 51 / 64 / 2, 94 / 65 / 2, 98 / 66 / 3, 35 / 67 / 2, 12 / 68 / 3, 33 / 69 / 2, 83 / 70 / 3, 54 / 71 / 2, 72 / 72 / 2, 39 / 73 / 2, 15 / 74 / 3, 84 / 75 / 2, 57 / 76 / 3, 53 / 77 / 2, 63 / 78 / 4, 44 / 79 / 2, 91 / 80 / 3, 24 / 81 / 2, 32 / 82 / 5, 36 / 83 / 2, 82 / 84 / 2, 49 / 85 / 2, 31 / 86 / 2, 61 / 87 / 2, 20 / 88 / 4, 3 / 89 / 2, 5 / 90 / 2, 25 / 91 / 3, 76 / 92 / 2, 78 / 93 / 2, 89 / 94 / 4, 7 / 95 / 2, 6 / 96 / 3, 38 / 97 / 2, 27 / 98 / 3, 11 / 99 / 2
uniform-alpha_1-95-n100.txt, 1, 1, 100, 812.517, 665, 565, 6, 97,29 / 1 / 6, 94 / 2 / 2, 74 / 3 / 2, 34 / 4 / 4, 26 / 5 / 2, 83 / 6 / 2, 7 / 7 / 2, 98 / 8 / 2, 24 / 9 / 2, 44 / 10 / 3, 3 / 11 / 2, 51 / 12 / 2, 72 / 13 / 2, 1 / 14 / 3, 22 / 16 / 3, 49 / 17 / 2, 73 / 18 / 2, 66 / 19 / 2, 36 / 20 / 3, 23 / 21 / 2, 56 / 22 / 2, 54 / 23 / 4, 68 / 24 / 2, 40 / 25 / 2, 80 / 26 / 2, 70 / 27 / 2, 99 / 28 / 2, 61 / 29 / 2, 55 / 30 / 2, 14 / 31 / 3, 11 / 32 / 2, 19 / 33 / 3, 78 / 34 / 2, 4 / 35 / 2, 86 / 36 / 3, 89 / 37 / 2, 20 / 38 / 2, 92 / 39 / 4, 12 / 40 / 2, 38 / 41 / 2, 2 / 42 / 3, 25 / 43 / 2, 64 / 44 / 2, 75 / 45 / 2, 58 / 46 / 2, 82 / 47 / 3, 33 / 48 / 2, 79 / 49 / 2, 62 / 50 / 2, 15 / 51 / 3, 17 / 52 / 2, 46 / 53 / 2, 48 / 54 / 2, 16 / 55 / 2, 96 / 56 / 3, 93 / 57 / 2, 8 / 58 / 2, 97 / 59 / 2, 5 / 60 / 2, 81 / 61 / 2, 84 / 62 / 2, 53 / 63 / 2, 27 / 64 / 2, 77 / 65 / 3, 13 / 66 / 2, 31 / 67 / 3, 30 / 68 / 2, 35 / 69 / 2, 76 / 70 / 3, 9 / 71 / 2, 71 / 72 / 2, 39 / 73 / 3, 87 / 74 / 2, 47 / 75 / 2, 63 / 76 / 4, 57 / 77 / 2, 21 / 78 / 2, 85 / 79 / 2, 45 / 81 / 2, 65 / 82 / 2, 42 / 83 / 3, 37 / 84 / 2, 60 / 85 / 2, 90 / 86 / 3, 69 / 87 / 2, 18 / 88 / 2, 43 / 89 / 2, 59 / 90 / 2, 6 / 91 / 5, 88 / 92 / 2, 95 / 93 / 2, 41 / 94 / 2, 52 / 95 / 2, 67 / 96 / 4, 91 / 97 / 2, 10 / 98 / 3, 50 / 99 / 2
uniform-alpha_1-96-n100.txt, 1, 1, 100, 828.077, 712, 612, 5, 99,50 / 1 / 4, 72 / 2 / 2, 6 / 3 / 2, 1 / 4 / 2, 25 / 5 / 2, 49 / 6 / 2, 20 / 7 / 3, 80 / 8 / 2, 38 / 9 / 3, 75 / 10 / 2, 11 / 11 / 3, 74 / 12 / 2, 26 / 13 / 3, 91 / 14 / 2, 67 / 15 / 3, 36 / 16 / 2, 97 / 17 / 3, 99 / 18 / 2, 65 / 19 / 2, 73 / 20 / 4, 82 / 21 / 2, 40 / 22 / 2, 52 / 23 / 4, 30 / 24 / 2, 24 / 25 / 2, 90 / 26 / 2, 35 / 27 / 2, 33 / 28 / 2, 85 / 29 / 3, 88 / 30 / 2, 21 / 31 / 2, 84 / 32 / 3, 14 / 33 / 2, 51 / 34 / 2, 81 / 35 / 4, 10 / 36 / 2, 83 / 37 / 3, 57 / 38 / 2, 8 / 39 / 2, 92 / 40 / 3, 79 / 41 / 2, 22 / 42 / 2, 98 / 43 / 2, 13 / 44 / 2, 70 / 45 / 3, 45 / 46 / 2, 46 / 47 / 3, 2 / 48 / 2, 28 / 49 / 3, 66 / 50 / 2, 31 / 51 / 4, 86 / 52 / 2, 55 / 53 / 3, 61 / 54 / 2, 4 / 55 / 2, 19 / 56 / 3, 39 / 57 / 2, 53 / 58 / 4, 71 / 59 / 2, 77 / 60 / 2, 87 / 61 / 4, 48 / 62 / 2, 18 / 63 / 2, 41 / 64 / 3, 76 / 65 / 2, 32 / 66 / 3, 60 / 67 / 2, 93 / 68 / 4, 43 / 69 / 2, 68 / 70 / 2, 56 / 71 / 2, 12 / 72 / 2, 89 / 73 / 2, 94 / 74 / 2, 37 / 75 / 2, 15 / 76 / 4, 62 / 77 / 2, 27 / 78 / 2, 29 / 79 / 3, 54 / 80 / 2, 78 / 81 / 2, 5 / 82 / 3, 34 / 83 / 2, 44 / 84 / 2, 59 / 85 / 3, 3 / 86 / 2, 69 / 87 / 2, 17 / 88 / 2, 64 / 89 / 2, 96 / 90 / 5, 95 / 91 / 2, 7 / 92 / 3, 63 / 93 / 2, 58 / 94 / 2, 47 / 95 / 2, 42 / 96 / 2, 23 / 97 / 3, 16 / 98 / 2, 9 / 99 / 2
uniform-alpha_1-97-n100.txt, 1, 1, 100, 895.175, 667, 567, 5, 96,14 / 1 / 5, 98 / 2 / 2, 82 / 3 / 2, 8 / 4 / 2, 40 / 5 / 2, 50 / 6 / 2, 27 / 7 / 2, 95 / 8 / 2, 58 / 9 / 2, 9 / 10 / 2, 71 / 11 / 3, 91 / 12 / 2, 64 / 13 / 3, 17 / 14 / 2, 11 / 15 / 3, 16 / 16 / 2, 85 / 17 / 2, 68 / 18 / 3, 63 / 19 / 2, 43 / 20 / 2, 75 / 21 / 2, 86 / 22 / 2, 57 / 23 / 2, 20 / 24 / 2, 5 / 25 / 2, 36 / 26 / 3, 60 / 27 / 2, 37 / 28 / 3, 51 / 29 / 2, 65 / 30 / 2, 35 / 31 / 4, 79 / 32 / 2, 3 / 33 / 3, 7 / 34 / 2, 32 / 35 / 2, 96 / 36 / 2, 29 / 37 / 3, 94 / 38 / 2, 69 / 39 / 3, 46 / 40 / 2, 10 / 41 / 2, 1 / 42 / 2, 31 / 43 / 2, 78 / 44 / 2, 97 / 45 / 3, 93 / 46 / 2, 15 / 47 / 2, 83 / 48 / 2, 80 / 49 / 2, 70 / 50 / 2, 41 / 51 / 2, 6 / 52 / 2, 77 / 53 / 5, 45 / 54 / 2, 25 / 55 / 2, 18 / 56 / 3, 87 / 57 / 2, 49 / 58 / 2, 2 / 59 / 3, 39 / 60 / 2, 30 / 61 / 3, 66 / 62 / 2, 4 / 63 / 2, 90 / 64 / 2, 38 / 65 / 2, 72 / 66 / 2, 54 / 67 / 3, 74 / 68 / 2, 84 / 69 / 2, 88 / 70 / 3, 59 / 71 / 2, 47 / 72 / 3, 56 / 74 / 3, 33 / 75 / 2, 34 / 76 / 2, 76 / 77 / 2, 67 / 78 / 2, 13 / 79 / 2, 24 / 80 / 3, 61 / 81 / 2, 48 / 82 / 2, 26 / 83 / 2, 42 / 84 / 4, 12 / 85 / 2, 53 / 88 / 2, 62 / 89 / 2, 99 / 90 / 5, 28 / 91 / 2, 52 / 92 / 3, 73 / 93 / 2, 89 / 94 / 2, 21 / 95 / 3, 44 / 96 / 2, 92 / 97 / 3, 22 / 98 / 2, 23 / 99 / 3
uniform-alpha_1-98-n100.txt, 1, 1, 100, 821.947, 834, 734, 7, 95,54 / 1 / 2, 82 / 2 / 3, 46 / 3 / 2, 44 / 4 / 7, 11 / 5 / 2, 32 / 6 / 2, 94 / 7 / 3, 8 / 8 / 2, 60 / 9 / 2, 95 / 10 / 7, 52 / 11 / 2, 50 / 12 / 2, 41 / 13 / 3, 70 / 14 / 2, 43 / 15 / 2, 47 / 16 / 2, 17 / 17 / 3, 2 / 20 / 3, 35 / 21 / 2, 19 / 22 / 2, 91 / 23 / 2, 81 / 24 / 5, 61 / 25 / 2, 33 / 27 / 2, 84 / 28 / 3, 22 / 29 / 2, 40 / 30 / 3, 64 / 31 / 2, 76 / 32 / 3, 97 / 33 / 2, 38 / 34 / 2, 42 / 35 / 3, 87 / 36 / 2, 73 / 37 / 3, 26 / 38 / 2, 63 / 39 / 2, 59 / 40 / 2, 55 / 41 / 6, 21 / 42 / 2, 10 / 43 / 2, 9 / 44 / 2, 92 / 45 / 2, 12 / 46 / 2, 24 / 47 / 2, 68 / 48 / 2, 36 / 49 / 2, 28 / 50 / 3, 83 / 51 / 2, 57 / 52 / 2, 48 / 53 / 2, 6 / 54 / 2, 71 / 55 / 2, 85 / 56 / 2, 90 / 57 / 2, 5 / 58 / 2, 29 / 60 / 2, 31 / 61 / 4, 18 / 62 / 2, 30 / 63 / 3, 93 / 64 / 2, 14 / 65 / 3, 77 / 66 / 2, 99 / 67 / 3, 1 / 68 / 2, 7 / 69 / 6, 56 / 70 / 2, 16 / 71 / 2, 74 / 72 / 3, 34 / 73 / 2, 65 / 74 / 2, 3 / 75 / 3, 62 / 76 / 2, 20 / 77 / 6, 98 / 78 / 2, 88 / 79 / 2, 69 / 80 / 2, 37 / 81 / 2, 89 / 82 / 3, 67 / 83 / 2, 80 / 84 / 2, 15 / 85 / 2, 66 / 86 / 2, 51 / 87 / 2, 86 / 88 / 2, 23 / 89 / 3, 96 / 90 / 2, 45 / 91 / 2, 49 / 92 / 2, 25 / 93 / 2, 39 / 94 / 2, 4 / 95 / 4, 58 / 96 / 2, 79 / 97 / 2, 13 / 98 / 4, 78 / 99 / 2
uniform-alpha_1-99-n100.txt, 1, 1, 100, 824.498, 744, 644, 5, 96,55 / 1 / 5, 87 / 2 / 2, 5 / 3 / 2, 38 / 5 / 3, 41 / 6 / 2, 45 / 7 / 3, 52 / 8 / 2, 11 / 9 / 2, 30 / 10 / 2, 48 / 11 / 3, 51 / 12 / 2, 79 / 13 / 3, 95 / 14 / 2, 68 / 15 / 3, 47 / 16 / 2, 59 / 17 / 5, 26 / 18 / 2, 31 / 19 / 2, 54 / 20 / 3, 57 / 21 / 2, 81 / 22 / 3, 28 / 23 / 2, 56 / 24 / 2, 20 / 25 / 3, 29 / 27 / 3, 18 / 28 / 2, 96 / 29 / 2, 46 / 30 / 2, 14 / 31 / 5, 37 / 32 / 2, 39 / 33 / 3, 35 / 34 / 2, 44 / 35 / 2, 32 / 36 / 4, 97 / 37 / 2, 85 / 38 / 3, 8 / 39 / 2, 83 / 40 / 3, 74 / 41 / 2, 4 / 42 / 3, 15 / 43 / 2, 16 / 44 / 3, 76 / 46 / 2, 64 / 47 / 2, 70 / 48 / 2, 50 / 49 / 3, 67 / 50 / 2, 36 / 51 / 2, 71 / 52 / 2, 77 / 53 / 2, 72 / 54 / 2, 88 / 55 / 2, 13 / 56 / 2, 93 / 57 / 2, 21 / 58 / 5, 53 / 59 / 2, 90 / 60 / 2, 42 / 61 / 2, 49 / 62 / 2, 69 / 63 / 3, 91 / 64 / 2, 99 / 65 / 2, 24 / 66 / 2, 17 / 67 / 2, 65 / 68 / 2, 92 / 69 / 4, 22 / 70 / 2, 33 / 71 / 3, 3 / 72 / 2, 58 / 73 / 5, 82 / 74 / 2, 60 / 75 / 2, 78 / 76 / 4, 66 / 77 / 2, 84 / 78 / 2, 12 / 79 / 2, 40 / 80 / 3, 73 / 81 / 2, 7 / 82 / 2, 86 / 83 / 4, 62 / 84 / 2, 80 / 85 / 2, 98 / 86 / 3, 1 / 87 / 2, 27 / 88 / 2, 6 / 89 / 4, 19 / 90 / 2, 23 / 91 / 2, 63 / 92 / 2, 25 / 93 / 2, 10 / 94 / 2, 2 / 95 / 2, 43 / 96 / 2, 9 / 97 / 2, 75 / 98 / 2, 34 / 99 / 4
uniform-alpha_3-1-n250.txt, 1, 0.333333, 250, 1216.83, 501, 251, 2, 1,166 / 202 / 2
uniform-alpha_3-1-n375.txt, 1, 0.333333, 375, 1548.45, 751, 376, 2, 1,68 / 39 / 2
uniform-alpha_3-1-n5.txt, 1, 0.333333, 5, 313.233, 9, 4, 1, 0,
uniform-alpha_3-10-n250.txt, 1, 0.333333, 250, 1259.89, 501, 251, 2, 1,185 / 168 / 2
uniform-alpha_3-10-n5.txt, 1, 0.333333, 5, 282.932, 9, 4, 1, 0,
uniform-alpha_3-10-n500.txt, 1, 0.333333, 500, 1820.08, 1003, 503, 2, 2,291 / 267 / 2, 269 / 274 / 2
uniform-alpha_3-100-n100.txt, 1, 0.333333, 100, 855.772, 199, 99, 1, 0,
uniform-alpha_3-101-n175.txt, 1, 0.333333, 175, 1059.47, 349, 174, 1, 0,
uniform-alpha_3-102-n175.txt, 1, 0.333333, 175, 1049.04, 349, 174, 1, 0,
uniform-alpha_3-103-n175.txt, 1, 0.333333, 175, 1044.96, 349, 174, 1, 0,
uniform-alpha_3-104-n175.txt, 1, 0.333333, 175, 1061.46, 353, 178, 2, 2,10 / 53 / 2, 23 / 89 / 2
uniform-alpha_3-105-n175.txt, 1, 0.333333, 175, 1111.16, 353, 178, 2, 2,62 / 93 / 2, 16 / 146 / 2
uniform-alpha_3-106-n175.txt, 1, 0.333333, 175, 1088.8, 351, 176, 2, 1,119 / 116 / 2
uniform-alpha_3-107-n175.txt, 1, 0.333333, 175, 1054.88, 353, 178, 2, 2,167 / 93 / 2, 74 / 120 / 2
uniform-alpha_3-108-n175.txt, 1, 0.333333, 175, 1060.96, 356, 181, 2, 2,156 / 107 / 2, 67 / 134 / 2
uniform-alpha_3-109-n175.txt, 1, 0.333333, 175, 1098.68, 354, 179, 2, 2,89 / 9 / 2, 146 / 32 / 2
uniform-alpha_3-11-n375.txt, 1, 0.333333, 375, 1565.61, 755, 380, 2, 3,74 / 153 / 2, 195 / 283 / 2, 59 / 350 / 2
uniform-alpha_3-11-n500.txt, 1, 0.333333, 500, 1812.93, 1008, 508, 2, 4,191 / 45 / 2, 301 / 416 / 2, 303 / 444 / 2, 326 / 492 / 2
uniform-alpha_3-11-n6.txt, 1, 0.333333, 6, 262.634, 11, 5, 1, 0,
uniform-alpha_3-110-n175.txt, 1, 0.333333, 175, 1022.52, 353, 178, 2, 2,170 / 104 / 2, 54 / 172 / 2
uniform-alpha_3-111-n250.txt, 1, 0.333333, 250, 1259.45, 499, 249, 1, 0,
uniform-alpha_3-112-n250.txt, 1, 0.333333, 250, 1240.52, 499, 249, 1, 0,
uniform-alpha_3-113-n250.txt, 1, 0.333333, 250, 1306.46, 510, 260, 3, 4,147 / 146 / 2, 163 / 185 / 3, 157 / 198 / 2, 180 / 245 / 2
uniform-alpha_3-114-n250.txt, 1, 0.333333, 250, 1262.3, 507, 257, 2, 4,99 / 38 / 2, 113 / 95 / 2, 172 / 153 / 2, 96 / 227 / 2
uniform-alpha_3-115-n250.txt, 1, 0.333333, 250, 1288.29, 501, 251, 2, 1,199 / 50 / 2
uniform-alpha_3-116-n250.txt, 1, 0.333333, 250, 1284.97, 504, 254, 2, 2,127 / 61 / 2, 89 / 178 / 2
uniform-alpha_3-117-n250.txt, 1, 0.333333, 250, 1375.02, 501, 251, 2, 1,24 / 203 / 2
uniform-alpha_3-118-n250.txt, 1, 0.333333, 250, 1255.9, 505, 255, 2, 2,214 / 18 / 2, 41 / 29 / 2
uniform-alpha_3-119-n250.txt, 1, 0.333333, 250, 1281.21, 503, 253, 2, 2,184 / 16 / 2, 54 / 171 / 2
uniform-alpha_3-12-n375.txt, 1, 0.333333, 375, 1547.33, 757, 382, 2, 4,160 / 159 / 2, 230 / 286 / 2, 159 / 320 / 2, 88 / 355 / 2
uniform-alpha_3-12-n500.txt, 1, 0.333333, 500, 1835.02, 1017, 517, 2, 7,353 / 36 / 2, 464 / 224 / 2, 130 / 253 / 2, 462 / 260 / 2, 259 / 345 / 2, 46 / 463 / 2, 123 / 481 / 2
uniform-alpha_3-12-n6.txt, 1, 0.333333, 6, 332.319, 11, 5, 1, 0,
uniform-alpha_3-120-n250.txt, 1, 0.333333, 250, 1264.5, 507, 257, 2, 4,7 / 42 / 2, 50 / 77 / 2, 198 / 90 / 2, 157 / 210 / 2
uniform-alpha_3-13-n375.txt, 1, 0.333333, 375, 1587.79, 758, 383, 2, 4,128 / 83 / 2, 166 / 221 / 2, 200 / 314 / 2, 309 / 342 / 2
uniform-alpha_3-13-n500.txt, 1, 0.333333, 500, 1795.62, 1011, 511, 2, 6,324 / 27 / 2, 95 / 229 / 2, 24 / 242 / 2, 345 / 338 / 2, 100 / 414 / 2, 366 / 478 / 2
uniform-alpha_3-13-n6.txt, 1, 0.333333, 6, 240.425, 11, 5, 1, 0,
uniform-alpha_3-14-n375.txt, 1, 0.333333, 375, 1584.44, 755, 380, 2, 3,366 / 117 / 2, 21 / 139 / 2, 134 / 353 / 2
uniform-alpha_3-14-n500.txt, 1, 0.333333, 500, 1798.56, 1007, 507, 2, 4,56 / 301 / 2, 64 / 338 / 2, 157 / 465 / 2, 348 / 480 / 2
uniform-alpha_3-14-n6.txt, 1, 0.333333, 6, 239.081, 11, 5, 1, 0,
uniform-alpha_3-15-n375.txt, 1, 0.333333, 375, 1504.16, 751, 376, 2, 1,324 / 182 / 2
uniform-alpha_3-15-n6.txt, 1, 0.333333, 6, 213.016, 11, 5, 1, 0,
uniform-alpha_3-16-n375.txt, 1, 0.333333, 375, 1564.97, 757, 382, 2, 4,295 / 43 / 2, 283 / 164 / 2, 255 / 298 / 2, 24 / 322 / 2
uniform-alpha_3-16-n6.txt, 1, 0.333333, 6, 327.468, 11, 5, 1, 0,
uniform-alpha_3-17-n375.txt, 1, 0.333333, 375, 1526.12, 753, 378, 2, 2,107 / 105 / 2, 58 / 368 / 2
uniform-alpha_3-17-n6.txt, 1, 0.333333, 6, 304.326, 11, 5, 1, 0,
uniform-alpha_3-18-n375.txt, 1, 0.333333, 375, 1532.04, 751, 376, 2, 1,30 / 172 / 2
uniform-alpha_3-18-n6.txt, 1, 0.333333, 6, 238.14, 11, 5, 1, 0,
uniform-alpha_3-19-n375.txt, 1, 0.333333, 375, 1562.7, 756, 381, 2, 3,98 / 188 / 2, 165 / 206 / 2, 67 / 277 / 2
uniform-alpha_3-19-n6.txt, 1, 0.333333, 6, 277.659, 13, 7, 2, 1,5 / 3 / 2
uniform-alpha_3-2-n250.txt, 1, 0.333333, 250, 1310.44, 504, 254, 2, 2,134 / 25 / 2, 224 / 111 / 2
uniform-alpha_3-2-n375.txt, 1, 0.333333, 375, 1593.03, 764, 389, 2, 7,9 / 136 / 2, 2 / 164 / 2, 267 / 206 / 2, 236 / 279 / 2, 298 / 289 / 2, 371 / 297 / 2, 243 / 356 / 2
uniform-alpha_3-2-n5.txt, 1, 0.333333, 5, 261.478, 9, 4, 1, 0,
uniform-alpha_3-20-n375.txt, 1, 0.333333, 375, 1543.3, 764, 389, 2, 6,320 / 30 / 2, 102 / 95 / 2, 96 / 128 / 2, 11 / 276 / 2, 351 / 294 / 2, 239 / 372 / 2
uniform-alpha_3-20-n6.txt, 1, 0.333333, 6, 265.6, 13, 7, 2, 1,5 / 3 / 2
uniform-alpha_3-21-n7.txt, 1, 0.333333, 7, 270.69, 13, 6, 1, 0,
uniform-alpha_3-22-n7.txt, 1, 0.333333, 7, 249.958, 13, 6, 1, 0,
uniform-alpha_3-23-n7.txt, 1, 0.333333, 7, 277.201, 13, 6, 1, 0,
uniform-alpha_3-24-n7.txt, 1, 0.333333, 7, 297.721, 13, 6, 1, 0,
uniform-alpha_3-25-n7.txt, 1, 0.333333, 7, 343.322, 13, 6, 1, 0,
uniform-alpha_3-26-n7.txt, 1, 0.333333, 7, 242.938, 13, 6, 1, 0,
uniform-alpha_3-27-n7.txt, 1, 0.333333, 7, 291.596, 15, 8, 2, 1,3 / 5 / 2
uniform-alpha_3-28-n7.txt, 1, 0.333333, 7, 364.48, 13, 6, 1, 0,
uniform-alpha_3-29-n7.txt, 1, 0.333333, 7, 335.334, 13, 6, 1, 0,
uniform-alpha_3-3-n250.txt, 1, 0.333333, 250, 1331, 508, 258, 2, 4,32 / 23 / 2, 108 / 36 / 2, 52 / 56 / 2, 138 / 110 / 2
uniform-alpha_3-3-n375.txt, 1, 0.333333, 375, 1605.67, 753, 378, 2, 2,29 / 201 / 2, 74 / 297 / 2
uniform-alpha_3-3-n5.txt, 1, 0.333333, 5, 258.047, 9, 4, 1, 0,
uniform-alpha_3-30-n7.txt, 1, 0.333333, 7, 238.887, 13, 6, 1, 0,
uniform-alpha_3-31-n8.txt, 1, 0.333333, 8, 315.297, 15, 7, 1, 0,
uniform-alpha_3-32-n8.txt, 1, 0.333333, 8, 277.041, 16, 8, 2, 1,1 / 7 / 2
uniform-alpha_3-33-n8.txt, 1, 0.333333, 8, 246.208, 15, 7, 1, 0,
uniform-alpha_3-34-n8.txt, 1, 0.333333, 8, 331.25, 15, 7, 1, 0,
uniform-alpha_3-35-n8.txt, 1, 0.333333, 8, 254.714, 15, 7, 1, 0,
uniform-alpha_3-36-n8.txt, 1, 0.333333, 8, 347.116, 15, 7, 1, 0,
uniform-alpha_3-37-n8.txt, 1, 0.333333, 8, 306.117, 15, 7, 1, 0,
uniform-alpha_3-38-n8.txt, 1, 0.333333, 8, 333.952, 15, 7, 1, 0,
uniform-alpha_3-39-n8.txt, 1, 0.333333, 8, 297.747, 15, 7, 1, 0,
uniform-alpha_3-4-n250.txt, 1, 0.333333, 250, 1240.85, 501, 251, 2, 1,30 / 196 / 2
uniform-alpha_3-4-n375.txt, 1, 0.333333, 375, 1567.47, 763, 388, 2, 5,338 / 60 / 2, 40 / 125 / 2, 253 / 202 / 2, 12 / 215 / 2, 113 / 325 / 2
uniform-alpha_3-4-n5.txt, 1, 0.333333, 5, 224.592, 9, 4, 1, 0,
uniform-alpha_3-40-n8.txt, 1, 0.333333, 8, 262.318, 15, 7, 1, 0,
uniform-alpha_3-41-n9.txt, 1, 0.333333, 9, 422.069, 17, 8, 1, 0,
uniform-alpha_3-42-n9.txt, 1, 0.333333, 9, 290.198, 17, 8, 1, 0,
uniform-alpha_3-43-n9.txt, 1, 0.333333, 9, 338.252, 19, 10, 2, 1,2 / 2 / 2
uniform-alpha_3-44-n9.txt, 1, 0.333333, 9, 289.015, 17, 8, 1, 0,
uniform-alpha_3-45-n9.txt, 1, 0.333333, 9, 322.979, 17, 8, 1, 0,
uniform-alpha_3-46-n9.txt, 1, 0.333333, 9, 306.315, 17, 8, 1, 0,
uniform-alpha_3-47-n9.txt, 1, 0.333333, 9, 349.988, 17, 8, 1, 0,
uniform-alpha_3-48-n9.txt, 1, 0.333333, 9, 347.294, 17, 8, 1, 0,
uniform-alpha_3-49-n9.txt, 1, 0.333333, 9, 228.611, 17, 8, 1, 0,
uniform-alpha_3-5-n250.txt, 1, 0.333333, 250, 1281.02, 499, 249, 1, 0,
uniform-alpha_3-5-n5.txt, 1, 0.333333, 5, 301.96, 9, 4, 1, 0,
uniform-alpha_3-5-n500.txt, 1, 0.333333, 500, 1823.02, 1006, 506, 2, 3,416 / 181 / 2, 39 / 370 / 2, 485 / 463 / 2
uniform-alpha_3-50-n9.txt, 1, 0.333333, 9, 324.468, 17, 8, 1, 0,
uniform-alpha_3-51-n10.txt, 1, 0.333333, 10, 349.088, 19, 9, 1, 0,
uniform-alpha_3-52-n10.txt, 1, 0.333333, 10, 303.873, 19, 9, 1, 0,
uniform-alpha_3-53-n10.txt, 1, 0.333333, 10, 284.656, 19, 9, 1, 0,
uniform-alpha_3-54-n10.txt, 1, 0.333333, 10, 312.316, 19, 9, 1, 0,
uniform-alpha_3-55-n10.txt, 1, 0.333333, 10, 338.061, 19, 9, 1, 0,
uniform-alpha_3-56-n10.txt, 1, 0.333333, 10, 322.641, 19, 9, 1, 0,
uniform-alpha_3-57-n10.txt, 1, 0.333333, 10, 261.681, 19, 9, 1, 0,
uniform-alpha_3-58-n10.txt, 1, 0.333333, 10, 338.954, 19, 9, 1, 0,
uniform-alpha_3-59-n10.txt, 1, 0.333333, 10, 351.94, 19, 9, 1, 0,
uniform-alpha_3-6-n250.txt, 1, 0.333333, 250, 1297.92, 503, 253, 2, 2,96 / 147 / 2, 35 / 235 / 2
uniform-alpha_3-6-n5.txt, 1, 0.333333, 5, 262.456, 9, 4, 1, 0,
uniform-alpha_3-6-n500.txt, 1, 0.333333, 500, 1789.5, 1015, 515, 2, 7,403 / 45 / 2, 425 / 101 / 2, 452 / 196 / 2, 375 / 209 / 2, 114 / 352 / 2, 44 / 358 / 2, 148 / 492 / 2
uniform-alpha_3-60-n10.txt, 1, 0.333333, 10, 280.236, 19, 9, 1, 0,
uniform-alpha_3-61-n20.txt, 1, 0.333333, 20, 356.225, 41, 21, 2, 1,9 / 3 / 2
uniform-alpha_3-62-n20.txt, 1, 0.333333, 20, 375.668, 39, 19, 1, 0,
uniform-alpha_3-63-n20.txt, 1, 0.333333, 20, 394.501, 41, 21, 2, 1,9 / 5 / 2
uniform-alpha_3-64-n20.txt, 1, 0.333333, 20, 370.01, 39, 19, 1, 0,
uniform-alpha_3-65-n20.txt, 1, 0.333333, 20, 399.773, 41, 21, 2, 1,14 / 13 / 2
uniform-alpha_3-66-n20.txt, 1, 0.333333, 20, 439.889, 39, 19, 1, 0,
uniform-alpha_3-67-n20.txt, 1, 0.333333, 20, 403.611, 39, 19, 1, 0,
uniform-alpha_3-68-n20.txt, 1, 0.333333, 20, 448.944, 39, 19, 1, 0,
uniform-alpha_3-69-n20.txt, 1, 0.333333, 20, 387.704, 39, 19, 1, 0,
uniform-alpha_3-7-n250.txt, 1, 0.333333, 250, 1255.82, 501, 251, 2, 1,33 / 47 / 2
uniform-alpha_3-7-n5.txt, 1, 0.333333, 5, 291.804, 9, 4, 1, 0,
uniform-alpha_3-7-n500.txt, 1, 0.333333, 500, 1751.08, 1005, 505, 2, 3,71 / 233 / 2, 310 / 244 / 2, 94 / 354 / 2
uniform-alpha_3-70-n20.txt, 1, 0.333333, 20, 479.711, 41, 21, 2, 1,11 / 6 / 2
uniform-alpha_3-71-n50.txt, 1, 0.333333, 50, 615.125, 102, 52, 2, 1,34 / 13 / 2
uniform-alpha_3-72-n50.txt, 1, 0.333333, 50, 646.92, 99, 49, 1, 0,
uniform-alpha_3-73-n50.txt, 1, 0.333333, 50, 624.124, 99, 49, 1, 0,
uniform-alpha_3-74-n50.txt, 1, 0.333333, 50, 638.121, 99, 49, 1, 0,
uniform-alpha_3-75-n50.txt, 1, 0.333333, 50, 646.491, 99, 49, 1, 0,
uniform-alpha_3-76-n50.txt, 1, 0.333333, 50, 598.572, 101, 51, 2, 1,17 / 48 / 2
uniform-alpha_3-77-n50.txt, 1, 0.333333, 50, 631.835, 99, 49, 1, 0,
uniform-alpha_3-78-n50.txt, 1, 0.333333, 50, 601.854, 101, 51, 2, 1,34 / 23 / 2
uniform-alpha_3-79-n50.txt, 1, 0.333333, 50, 568.61, 99, 49, 1, 0,
uniform-alpha_3-8-n250.txt, 1, 0.333333, 250, 1311.65, 503, 253, 2, 2,85 / 239 / 2, 198 / 244 / 2
uniform-alpha_3-8-n5.txt, 1, 0.333333, 5, 245.206, 9, 4, 1, 0,
uniform-alpha_3-8-n500.txt, 1, 0.333333, 500, 1831.85, 1007, 507, 2, 2,35 / 55 / 2, 325 / 415 / 2
uniform-alpha_3-80-n50.txt, 1, 0.333333, 50, 592.35, 99, 49, 1, 0,
uniform-alpha_3-81-n75.txt, 1, 0.333333, 75, 720.89, 151, 76, 2, 1,68 / 22 / 2
uniform-alpha_3-82-n75.txt, 1, 0.333333, 75, 671.06, 149, 74, 1, 0,
uniform-alpha_3-83-n75.txt, 1, 0.333333, 75, 720.784, 149, 74, 1, 0,
uniform-alpha_3-84-n75.txt, 1, 0.333333, 75, 733.981, 151, 76, 2, 1,72 / 14 / 2
uniform-alpha_3-85-n75.txt, 1, 0.333333, 75, 775.714, 151, 76, 2, 1,69 / 45 / 2
uniform-alpha_3-86-n75.txt, 1, 0.333333, 75, 736.708, 149, 74, 1, 0,
uniform-alpha_3-87-n75.txt, 1, 0.333333, 75, 779.093, 153, 78, 2, 2,23 / 31 / 2, 7 / 42 / 2
uniform-alpha_3-88-n75.txt, 1, 0.333333, 75, 763.121, 151, 76, 2, 1,60 / 44 / 2
uniform-alpha_3-89-n75.txt, 1, 0.333333, 75, 677.982, 149, 74, 1, 0,
uniform-alpha_3-9-n250.txt, 1, 0.333333, 250, 1292.96, 507, 257, 2, 4,134 / 47 / 2, 202 / 174 / 2, 185 / 196 / 2, 7 / 199 / 2
uniform-alpha_3-9-n5.txt, 1, 0.333333, 5, 241.297, 9, 4, 1, 0,
uniform-alpha_3-9-n500.txt, 1, 0.333333, 500, 1815.01, 1004, 504, 2, 2,462 / 139 / 2, 14 / 209 / 2
uniform-alpha_3-90-n75.txt, 1, 0.333333, 75, 742.985, 152, 77, 2, 1,45 / 3 / 2
uniform-alpha_3-91-n100.txt, 1, 0.333333, 100, 884.68, 201, 101, 2, 1,78 / 66 / 2
uniform-alpha_3-92-n100.txt, 1, 0.333333, 100, 794.024, 199, 99, 1, 0,
uniform-alpha_3-93-n100.txt, 1, 0.333333, 100, 836.683, 203, 103, 2, 2,92 / 63 / 2, 27 / 76 / 2
uniform-alpha_3-94-n100.txt, 1, 0.333333, 100, 830.526, 201, 101, 2, 1,15 / 79 / 2
uniform-alpha_3-95-n100.txt, 1, 0.333333, 100, 815.048, 201, 101, 2, 1,7 / 97 / 2
uniform-alpha_3-96-n100.txt, 1, 0.333333, 100, 808.636, 201, 101, 2, 1,66 / 34 / 2
uniform-alpha_3-97-n100.txt, 1, 0.333333, 100, 860.514, 199, 99, 1, 0,
uniform-alpha_3-98-n100.txt, 1, 0.333333, 100, 850.519, 199, 99, 1, 0,
uniform-alpha_3-99-n100.txt, 1, 0.333333, 100, 814.006, 201, 101, 2, 1,29 / 66 / 2
